id,destination,origin,year,migrants,fem,male
0,2,9,1990,8107,3531,4576
1,2,169,1990,40537,17658,22879
2,2,171,1990,2027,883,1144
3,51,56,1990,40087,22823,17264
4,51,57,1990,11287,5714,5573
5,51,26,1990,2489,856,1633
6,51,60,1990,678,377,301
7,141,68,1990,2086,924,1162
8,141,69,1990,6544,2850,3694
9,141,16,1990,918,563,355
10,141,57,1990,3143,1376,1767
11,141,18,1990,2286,1050,1236
12,141,19,1990,1420,579,841
13,141,20,1990,1564,844,720
14,141,143,1990,1982,859,1123
15,141,36,1990,6287,3959,2328
16,141,23,1990,3068,1115,1953
17,141,128,1990,926,473,453
18,141,145,1990,9127,3984,5143
19,141,25,1990,3550,1584,1966
20,141,50,1990,2060,865,1195
21,141,28,1990,2593,1071,1522
22,52,103,1990,86,40,46
23,52,67,1990,241,112,129
24,52,106,1990,68,32,36
25,52,39,1990,84,39,45
26,52,68,1990,4135,1923,2212
27,52,69,1990,347,162,185
28,52,57,1990,109,51,58
29,52,144,1990,296,137,159
30,52,73,1990,190,88,102
31,52,61,1990,3957,1840,2117
32,52,65,1990,27103,12605,14498
33,52,49,1990,54,25,29
34,52,74,1990,64,30,34
35,52,50,1990,1043,486,557
36,52,114,1990,78,36,42
37,134,153,1990,3569,1649,1920
38,134,136,1990,12,6,6
39,134,137,1990,410,220,190
40,134,137,1990,12178,5767,6411
41,134,157,1990,131,68,63
42,134,125,1990,97,44,53
43,134,150,1990,345,163,182
44,134,61,1990,5298,1919,3379
45,134,126,1990,46,24,22
46,134,140,1990,3112,1503,1609
47,134,115,1990,2437,1154,1283
48,134,132,1990,119,69,50
49,75,83,1990,308,107,201
50,75,110,1990,181,73,108
51,75,86,1990,220,92,128
52,75,87,1990,135,40,95
53,75,90,1990,426,145,281
54,75,50,1990,197,127,70
55,76,78,1990,5,3,2
56,76,79,1990,204,106,98
57,76,95,1990,8,4,4
58,76,172,1990,57,30,27
59,76,81,1990,12,6,6
60,76,82,1990,2442,1268,1174
61,76,83,1990,621,323,298
62,76,120,1990,1,1,0
63,76,68,1990,32,17,15
64,76,109,1990,4,2,2
65,76,69,1990,45,23,22
66,76,156,1990,10,5,5
67,76,84,1990,115,60,55
68,76,110,1990,1660,862,798
69,76,85,1990,11,6,5
70,76,99,1990,3,2,1
71,76,5,1990,32,17,15
72,76,57,1990,49,25,24
73,76,86,1990,386,201,185
74,76,177,1990,2,1,1
75,76,20,1990,46,24,22
76,76,100,1990,3,2,1
77,76,87,1990,844,438,406
78,76,73,1990,17,9,8
79,76,77,1990,7,4,3
80,76,162,1990,35,18,17
81,76,9,1990,7,4,3
82,76,88,1990,30,16,14
83,76,90,1990,469,244,225
84,76,75,1990,17,9,8
85,76,91,1990,392,204,188
86,76,92,1990,478,248,230
87,76,115,1990,19,10,9
88,76,65,1990,5,3,2
89,76,113,1990,9,5,4
90,76,25,1990,142,74,68
91,76,93,1990,356,185,171
92,76,94,1990,4,2,2
93,76,142,1990,12,6,6
94,76,50,1990,623,324,299
95,103,2,1990,20,19,1
96,103,51,1990,148,62,86
97,103,141,1990,229,93,136
98,103,52,1990,1,0,1
99,103,134,1990,20,13,7
100,103,66,1990,4256,2479,1777
101,103,13,1990,28,9,19
102,103,11,1990,1236,639,597
103,103,79,1990,16,16,0
104,103,67,1990,1151,566,585
105,103,105,1990,34359,19386,14973
106,103,95,1990,12,10,2
107,103,30,1990,975,402,573
108,103,29,1990,669,385,284
109,103,153,1990,51,32,19
110,103,10,1990,6,0,6
111,103,106,1990,223528,106262,117266
112,103,172,1990,4268,2119,2149
113,103,107,1990,2702,1507,1195
114,103,137,1990,92,44,48
115,103,96,1990,462,239,223
116,103,54,1990,2171,1147,1024
117,103,81,1990,1427,799,628
118,103,14,1990,103,58,45
119,103,31,1990,3946,2537,1409
120,103,39,1990,540,294,246
121,103,82,1990,9,9,0
122,103,83,1990,265,138,127
123,103,108,1990,999,490,509
124,103,97,1990,182,94,88
125,103,120,1990,71,41,30
126,103,40,1990,109,71,38
127,103,42,1990,156,112,44
128,103,68,1990,6463,3484,2979
129,103,69,1990,15674,8332,7342
130,103,55,1990,32,21,11
131,103,56,1990,3197,1848,1349
132,103,84,1990,25,25,0
133,103,98,1990,116,23,93
134,103,157,1990,1,1,0
135,103,85,1990,75,9,66
136,103,99,1990,141,73,68
137,103,173,1990,9,0,9
138,103,32,1990,3297,1818,1479
139,103,43,1990,18,16,2
140,103,5,1990,215,121,94
141,103,6,1990,302,151,151
142,103,16,1990,81,49,32
143,103,44,1990,143,69,74
144,103,17,1990,1466,733,733
145,103,57,1990,336040,172221,163819
146,103,86,1990,27,0,27
147,103,177,1990,5812,2897,2915
148,103,18,1990,160,59,101
149,103,121,1990,6,4,2
150,103,176,1990,31,0,31
151,103,20,1990,3248,1616,1632
152,103,46,1990,270,181,89
153,103,143,1990,113,45,68
154,103,70,1990,170,62,108
155,103,47,1990,1980,1288,692
156,103,71,1990,213,159,54
157,103,122,1990,14,14,0
158,103,58,1990,4,3,1
159,103,100,1990,2332,1121,1211
160,103,72,1990,23,22,1
161,103,144,1990,466,283,183
162,103,125,1990,25,25,0
163,103,150,1990,4,0,4
164,103,73,1990,943,424,519
165,103,77,1990,1,1,0
166,103,101,1990,145,68,77
167,103,162,1990,93,68,25
168,103,48,1990,129,31,98
169,103,9,1990,10,0,10
170,103,102,1990,376,134,242
171,103,111,1990,257243,144462,112781
172,103,112,1990,16366,6645,9721
173,103,33,1990,29520,15316,14204
174,103,61,1990,13551,6330,7221
175,103,88,1990,210,104,106
176,103,35,1990,3713,2176,1537
177,103,36,1990,5016,2891,2125
178,103,62,1990,37,5,32
179,103,23,1990,175,68,107
180,103,1,1990,11,4,7
181,103,64,1990,1783,953,830
182,103,128,1990,4,0,4
183,103,115,1990,278,152,126
184,103,133,1990,3,3,0
185,103,65,1990,229535,127897,101638
186,103,145,1990,18,0,18
187,103,113,1990,11,10,1
188,103,49,1990,566,245,321
189,103,74,1990,2175,995,1180
190,103,25,1990,4931,2402,2529
191,103,93,1990,75,27,48
192,103,146,1990,99,34,65
193,103,26,1990,2498,1390,1108
194,103,130,1990,1,1,0
195,103,38,1990,3583,2048,1535
196,103,60,1990,13164,6718,6446
197,103,142,1990,522,244,278
198,103,50,1990,2391,1422,969
199,103,131,1990,1,0,1
200,103,152,1990,26,22,4
201,103,114,1990,136906,70241,66665
202,103,132,1990,1,0,1
203,11,12,1990,464459,268918,195541
204,11,29,1990,1280,900,380
205,11,15,1990,1646,1082,564
206,11,69,1990,660,379,281
207,11,56,1990,5612,3370,2242
208,11,6,1990,9654,5651,4003
209,11,16,1990,0,0,0
210,11,167,1990,787,608,179
211,11,20,1990,1129,689,440
212,11,36,1990,62218,42083,20135
213,11,25,1990,3225,1925,1300
214,11,26,1990,1956,1451,505
215,11,170,1990,820,584,236
216,11,38,1990,10066,6358,3708
217,11,171,1990,1150,862,288
218,77,172,1990,247,93,154
219,77,107,1990,1849,1171,678
220,77,82,1990,143,98,45
221,77,83,1990,2042,1512,530
222,77,84,1990,294,241,53
223,77,110,1990,107,55,52
224,77,85,1990,320,282,38
225,77,5,1990,39,14,25
226,77,86,1990,162,138,24
227,77,73,1990,2096,1022,1074
228,77,101,1990,19,10,9
229,77,112,1990,141,58,83
230,77,61,1990,177,87,90
231,77,92,1990,225,140,85
232,77,113,1990,721,342,379
233,77,26,1990,115,5,110
234,66,2,1990,4748,1554,3194
235,66,51,1990,1733,870,863
236,66,141,1990,711,170,541
237,66,52,1990,1,0,1
238,66,134,1990,188,85,103
239,66,76,1990,4,4,0
240,66,103,1990,839,416,423
241,66,11,1990,1681,828,853
242,66,77,1990,0,0,0
243,66,12,1990,592,286,306
244,66,78,1990,13,6,7
245,66,13,1990,12,6,6
246,66,3,1990,1508,501,1007
247,66,79,1990,12,6,6
248,66,29,1990,918,678,240
249,66,67,1990,1418,739,679
250,66,95,1990,22,11,11
251,66,151,1990,44,14,30
252,66,4,1990,14,6,8
253,66,53,1990,92349,46208,46141
254,66,147,1990,15,8,7
255,66,105,1990,2857,1849,1008
256,66,30,1990,8666,4878,3788
257,66,152,1990,67,30,37
258,66,116,1990,53,22,31
259,66,153,1990,22,13,9
260,66,135,1990,360,133,227
261,66,80,1990,0,0,0
262,66,136,1990,7,3,4
263,66,106,1990,693,368,325
264,66,172,1990,9703,5332,4371
265,66,173,1990,154,79,75
266,66,174,1990,9,6,3
267,66,107,1990,864,520,344
268,66,117,1990,0,0,0
269,66,137,1990,252,112,140
270,66,96,1990,99,61,38
271,66,54,1990,43774,23301,20473
272,66,81,1990,485,337,148
273,66,14,1990,178,83,95
274,66,31,1990,30293,18639,11654
275,66,176,1990,1550,968,582
276,66,137,1990,386,173,213
277,66,39,1990,782,444,338
278,66,118,1990,4,1,3
279,66,82,1990,28,20,8
280,66,83,1990,1722,1223,499
281,66,108,1990,364,204,160
282,66,142,1990,8202,3003,5199
283,66,97,1990,38,22,16
284,66,138,1990,6,3,3
285,66,119,1990,57,32,25
286,66,40,1990,206,152,54
287,66,148,1990,13,8,5
288,66,120,1990,703,412,291
289,66,41,1990,0,0,0
290,66,42,1990,880,638,242
291,66,68,1990,4939,2703,2236
292,66,139,1990,14,5,9
293,66,155,1990,346,36,310
294,66,15,1990,1827,878,949
295,66,69,1990,100832,60583,40249
296,66,156,1990,1363,578,785
297,66,55,1990,0,0,0
298,66,56,1990,2205,794,1411
299,66,84,1990,8,5,3
300,66,98,1990,206,101,105
301,66,157,1990,166,35,131
302,66,158,1990,38,4,34
303,66,110,1990,10,8,2
304,66,85,1990,35,20,15
305,66,99,1990,54,32,22
306,66,32,1990,14405,9636,4769
307,66,43,1990,104,57,47
308,66,5,1990,7478,3109,4369
309,66,6,1990,8535,3708,4827
310,66,16,1990,3043,1146,1897
311,66,44,1990,544,241,303
312,66,17,1990,1412,617,795
313,66,57,1990,18566,10742,7824
314,66,86,1990,115,66,49
315,66,177,1990,1636,1153,483
316,66,18,1990,412,126,286
317,66,167,1990,608,378,230
318,66,121,1990,542,366,176
319,66,19,1990,140,50,90
320,66,168,1990,357,236,121
321,66,46,1990,445,307,138
322,66,20,1990,1015,406,609
323,66,149,1990,3,3,0
324,66,159,1990,150,25,125
325,66,143,1990,254,104,150
326,66,70,1990,208,127,81
327,66,47,1990,501,332,169
328,66,71,1990,420,196,224
329,66,122,1990,42,30,12
330,66,123,1990,21,10,11
331,66,7,1990,5,1,4
332,66,160,1990,54,15,39
333,66,58,1990,60,34,26
334,66,161,1990,19,1,18
335,66,124,1990,63,33,30
336,66,100,1990,832,484,348
337,66,72,1990,14,8,6
338,66,59,1990,12031,6112,5919
339,66,144,1990,1061,480,581
340,66,125,1990,37,21,16
341,66,150,1990,101,61,40
342,66,8,1990,323,116,207
343,66,73,1990,4668,2389,2279
344,66,101,1990,115,69,46
345,66,162,1990,4673,1434,3239
346,66,60,1990,12075,5451,6624
347,66,48,1990,533,325,208
348,66,21,1990,17,8,9
349,66,9,1990,2651,918,1733
350,66,102,1990,34,21,13
351,66,111,1990,125,72,53
352,66,112,1990,930,621,309
353,66,33,1990,33851,19589,14262
354,66,61,1990,949,393,556
355,66,88,1990,3,2,1
356,66,22,1990,15,6,9
357,66,35,1990,24968,15560,9408
358,66,36,1990,17059,9568,7491
359,66,126,1990,117,52,65
360,66,90,1990,1,1,0
361,66,91,1990,8,3,5
362,66,92,1990,6,3,3
363,66,62,1990,1,1,0
364,66,140,1990,1,1,0
365,66,23,1990,263,109,154
366,66,164,1990,184,60,124
367,66,63,1990,107506,54804,52702
368,66,127,1990,24,14,10
369,66,165,1990,147,35,112
370,66,37,1990,14965,9624,5341
371,66,64,1990,12724,7820,4904
372,66,128,1990,670,264,406
373,66,115,1990,1538,859,679
374,66,65,1990,2271,1229,1042
375,66,10,1990,540,246,294
376,66,145,1990,350,92,258
377,66,113,1990,11,5,6
378,66,49,1990,1956,1142,814
379,66,74,1990,8704,4698,4006
380,66,25,1990,1828,682,1146
381,66,169,1990,157,88,69
382,66,166,1990,120,45,75
383,66,93,1990,38,23,15
384,66,146,1990,2033,613,1420
385,66,26,1990,88108,41468,46640
386,66,170,1990,77,51,26
387,66,130,1990,150,71,79
388,66,38,1990,4534,3197,1337
389,66,27,1990,97,51,46
390,66,50,1990,6067,2820,3247
391,66,131,1990,86,42,44
392,66,114,1990,155,85,70
393,66,171,1990,415,231,184
394,66,1,1990,1842,980,862
395,66,28,1990,52,21,31
396,66,132,1990,63,37,26
397,66,133,1990,165,83,82
398,12,2,1990,254,79,175
399,12,11,1990,202586,107644,94942
400,12,29,1990,626,512,114
401,12,40,1990,662,375,287
402,12,15,1990,69766,38895,30871
403,12,69,1990,389,234,155
404,12,6,1990,2088,825,1263
405,12,167,1990,4940,3103,1837
406,12,168,1990,3487,1940,1547
407,12,36,1990,39234,28517,10717
408,12,169,1990,340,217,123
409,12,26,1990,2894,800,2094
410,12,170,1990,2352,1418,934
411,12,38,1990,3842,3025,817
412,12,171,1990,23232,12977,10255
413,78,76,1990,13,6,7
414,78,103,1990,8,4,4
415,78,66,1990,15,11,4
416,78,79,1990,234,85,149
417,78,67,1990,8,5,3
418,78,147,1990,0,0,0
419,78,105,1990,36,20,16
420,78,95,1990,31,21,10
421,78,30,1990,0,0,0
422,78,80,1990,9,6,3
423,78,10,1990,24,11,13
424,78,106,1990,9,4,5
425,78,172,1990,67,24,43
426,78,107,1990,28,20,8
427,78,96,1990,10,5,5
428,78,81,1990,48,31,17
429,78,39,1990,8,3,5
430,78,82,1990,35,20,15
431,78,83,1990,44,22,22
432,78,108,1990,10,7,3
433,78,97,1990,5,5,0
434,78,40,1990,0,0,0
435,78,68,1990,38,13,25
436,78,69,1990,161,81,80
437,78,156,1990,23,11,12
438,78,56,1990,72,30,42
439,78,84,1990,28,13,15
440,78,98,1990,7,6,1
441,78,110,1990,419,206,213
442,78,85,1990,10894,4080,6814
443,78,99,1990,7,2,5
444,78,173,1990,46,18,28
445,78,5,1990,160,70,90
446,78,44,1990,55,20,35
447,78,57,1990,78,26,52
448,78,86,1990,2792,2046,746
449,78,177,1990,5,2,3
450,78,121,1990,6,3,3
451,78,100,1990,21,12,9
452,78,73,1990,36,18,18
453,78,101,1990,9,5,4
454,78,162,1990,30,10,20
455,78,48,1990,13,3,10
456,78,9,1990,15,7,8
457,78,102,1990,17,11,6
458,78,112,1990,43,16,27
459,78,33,1990,12,6,6
460,78,61,1990,1,1,0
461,78,35,1990,0,0,0
462,78,36,1990,4,3,1
463,78,90,1990,13,7,6
464,78,91,1990,25,15,10
465,78,92,1990,20,5,15
466,78,115,1990,21,9,12
467,78,133,1990,0,0,0
468,78,65,1990,32,11,21
469,78,148,1990,0,0,0
470,78,49,1990,11,7,4
471,78,74,1990,85,32,53
472,78,93,1990,278,145,133
473,78,94,1990,2080,1188,892
474,78,130,1990,0,0,0
475,78,38,1990,0,0,0
476,78,142,1990,9,5,4
477,78,50,1990,1964,921,1043
478,78,114,1990,2,2,0
479,13,2,1990,215,61,154
480,13,3,1990,20442,2049,18393
481,13,10,1990,5863,4319,1544
482,13,136,1990,140,40,100
483,13,120,1990,357,102,255
484,13,119,1990,508,145,363
485,13,68,1990,57,28,29
486,13,5,1990,60505,14165,46340
487,13,18,1990,3442,1372,2070
488,13,19,1990,1728,497,1231
489,13,20,1990,728,207,521
490,13,144,1990,257,73,184
491,13,8,1990,228,65,163
492,13,73,1990,174,108,66
493,13,162,1990,187,53,134
494,13,9,1990,20949,5000,15949
495,13,22,1990,8,7,1
496,13,23,1990,61,24,37
497,13,128,1990,340,97,243
498,13,129,1990,522,196,326
499,13,145,1990,4235,1589,2646
500,13,25,1990,1777,506,1271
501,13,27,1990,771,458,313
502,13,146,1990,155,44,111
503,13,26,1990,1291,368,923
504,13,142,1990,21908,8359,13549
505,13,50,1990,1614,674,940
506,13,28,1990,5876,1675,4201
507,3,13,1990,89,40,49
508,3,105,1990,552,253,299
509,3,172,1990,140163,64474,75689
510,3,5,1990,13339,6135,7204
511,3,177,1990,9042,4159,4883
512,3,8,1990,9670,4448,5222
513,3,48,1990,4240,1950,2290
514,3,1,1990,40088,18440,21648
515,3,50,1990,9090,4181,4909
516,79,76,1990,226,153,73
517,79,78,1990,55,30,25
518,79,95,1990,0,0,0
519,79,172,1990,0,0,0
520,79,81,1990,0,0,0
521,79,82,1990,451,313,138
522,79,84,1990,565,374,191
523,79,110,1990,2557,1553,1004
524,79,85,1990,0,0,0
525,79,5,1990,441,219,222
526,79,86,1990,622,425,197
527,79,90,1990,0,0,0
528,79,91,1990,3317,2095,1222
529,79,92,1990,3676,2148,1528
530,79,113,1990,0,0,0
531,79,93,1990,1750,1077,673
532,79,50,1990,2988,1641,1347
533,29,2,1990,140,34,106
534,29,141,1990,27,3,24
535,29,12,1990,15651,6692,8959
536,29,103,1990,76,36,40
537,29,66,1990,44,23,21
538,29,11,1990,6645,2688,3957
539,29,67,1990,28,8,20
540,29,105,1990,69,37,32
541,29,30,1990,30,11,19
542,29,81,1990,22,1,21
543,29,31,1990,83,44,39
544,29,39,1990,130,44,86
545,29,120,1990,11,0,11
546,29,40,1990,3429,1720,1709
547,29,42,1990,1185,475,710
548,29,15,1990,9868,4214,5654
549,29,69,1990,32,11,21
550,29,56,1990,164,89,75
551,29,32,1990,291,142,149
552,29,5,1990,24,3,21
553,29,6,1990,25,3,22
554,29,44,1990,16,9,7
555,29,17,1990,192,81,111
556,29,57,1990,10,1,9
557,29,167,1990,81148,42432,38716
558,29,18,1990,13,0,13
559,29,176,1990,97,53,44
560,29,168,1990,6071,3165,2906
561,29,20,1990,32,0,32
562,29,46,1990,11085,5948,5137
563,29,47,1990,18380,10284,8096
564,29,48,1990,49,19,30
565,29,9,1990,24,0,24
566,29,33,1990,235,102,133
567,29,35,1990,10,4,6
568,29,36,1990,791522,441924,349598
569,29,63,1990,16,4,12
570,29,37,1990,25,14,11
571,29,1,1990,182,75,107
572,29,65,1990,31,12,19
573,29,49,1990,190,68,122
574,29,74,1990,22,9,13
575,29,25,1990,40,0,40
576,29,169,1990,6587,3251,3336
577,29,27,1990,15,6,9
578,29,26,1990,11,0,11
579,29,170,1990,6339,3277,3062
580,29,38,1990,261845,136498,125347
581,29,50,1990,340,162,178
582,29,114,1990,21,14,7
583,29,171,1990,17154,8947,8207
584,29,28,1990,14,2,12
585,67,2,1990,93,47,46
586,67,51,1990,2157,1055,1102
587,67,141,1990,26077,10988,15089
588,67,52,1990,0,0,0
589,67,134,1990,1282,618,664
590,67,76,1990,0,0,0
591,67,103,1990,1156,620,536
592,67,11,1990,7,3,4
593,67,66,1990,1293,604,689
594,67,12,1990,8,4,4
595,67,78,1990,13,6,7
596,67,13,1990,55,0,55
597,67,3,1990,554,184,370
598,67,79,1990,20,16,4
599,67,29,1990,150,97,53
600,67,95,1990,0,0,0
601,67,151,1990,1748,611,1137
602,67,4,1990,158,59,99
603,67,53,1990,308,152,156
604,67,147,1990,24,12,12
605,67,105,1990,1585,884,701
606,67,30,1990,996,611,385
607,67,152,1990,488,189,299
608,67,116,1990,1251,550,701
609,67,153,1990,459,294,165
610,67,135,1990,2109,999,1110
611,67,80,1990,0,0,0
612,67,136,1990,202,86,116
613,67,106,1990,4908,2270,2638
614,67,172,1990,4851,2104,2747
615,67,107,1990,1897,1049,848
616,67,117,1990,0,0,0
617,67,137,1990,6195,2167,4028
618,67,96,1990,136,70,66
619,67,54,1990,48,25,23
620,67,81,1990,335,221,114
621,67,14,1990,77,45,32
622,67,31,1990,37,18,19
623,67,176,1990,1679,996,683
624,67,137,1990,45711,22180,23531
625,67,39,1990,2030,1091,939
626,67,118,1990,76,37,39
627,67,82,1990,97,48,49
628,67,83,1990,1804,1246,558
629,67,108,1990,1603,982,621
630,67,142,1990,1638,486,1152
631,67,97,1990,276,162,114
632,67,138,1990,2142,749,1393
633,67,119,1990,1,0,1
634,67,40,1990,58,32,26
635,67,148,1990,0,0,0
636,67,120,1990,3433,1201,2232
637,67,42,1990,473,256,217
638,67,68,1990,109361,57840,51521
639,67,139,1990,308,148,160
640,67,155,1990,194,69,125
641,67,15,1990,184,93,91
642,67,69,1990,55851,27263,28588
643,67,156,1990,2921,1401,1520
644,67,55,1990,0,0,0
645,67,56,1990,19584,8941,10643
646,67,84,1990,0,0,0
647,67,98,1990,5732,2348,3384
648,67,157,1990,795,248,547
649,67,158,1990,124,67,57
650,67,110,1990,92,69,23
651,67,85,1990,1799,862,937
652,67,99,1990,96,64,32
653,67,32,1990,1309,591,718
654,67,43,1990,117,63,54
655,67,5,1990,5343,2027,3316
656,67,6,1990,3157,1303,1854
657,67,16,1990,70,35,35
658,67,44,1990,1630,902,728
659,67,17,1990,4093,1727,2366
660,67,57,1990,176201,81609,94592
661,67,86,1990,264,167,97
662,67,177,1990,3001,1429,1572
663,67,18,1990,467,158,309
664,67,167,1990,16,8,8
665,67,121,1990,536,314,222
666,67,19,1990,136,58,78
667,67,168,1990,8,4,4
668,67,46,1990,75,47,28
669,67,20,1990,4357,1462,2895
670,67,149,1990,8,5,3
671,67,159,1990,371,111,260
672,67,143,1990,216,84,132
673,67,70,1990,3,2,1
674,67,47,1990,76,49,27
675,67,71,1990,12908,5413,7495
676,67,122,1990,1049,772,277
677,67,123,1990,29,11,18
678,67,7,1990,2,2,0
679,67,160,1990,270,125,145
680,67,58,1990,259,135,124
681,67,161,1990,875,186,689
682,67,124,1990,2939,1942,997
683,67,100,1990,1647,1030,617
684,67,72,1990,77,31,46
685,67,59,1990,10,4,6
686,67,144,1990,295459,140636,154823
687,67,125,1990,189,144,45
688,67,150,1990,29,16,13
689,67,8,1990,59,30,29
690,67,73,1990,55946,26623,29323
691,67,101,1990,138,95,43
692,67,162,1990,1443,556,887
693,67,60,1990,81,37,44
694,67,48,1990,763,343,420
695,67,21,1990,2,2,0
696,67,9,1990,3767,1006,2761
697,67,102,1990,108,71,37
698,67,111,1990,166,113,53
699,67,112,1990,1877,1189,688
700,67,33,1990,5537,2977,2560
701,67,61,1990,12386,5824,6562
702,67,22,1990,0,0,0
703,67,35,1990,1941,1140,801
704,67,36,1990,190,91,99
705,67,126,1990,2580,1034,1546
706,67,90,1990,0,0,0
707,67,91,1990,0,0,0
708,67,92,1990,0,0,0
709,67,62,1990,13,3,10
710,67,140,1990,35,22,13
711,67,23,1990,146,86,60
712,67,164,1990,1644,665,979
713,67,63,1990,197,92,105
714,67,127,1990,56,35,21
715,67,165,1990,1891,661,1230
716,67,37,1990,106,64,42
717,67,64,1990,23,10,13
718,67,128,1990,2103,735,1368
719,67,115,1990,2761,1549,1212
720,67,65,1990,41437,21105,20332
721,67,10,1990,238,128,110
722,67,145,1990,175,74,101
723,67,113,1990,274,193,81
724,67,49,1990,1593,748,845
725,67,74,1990,5458,2481,2977
726,67,25,1990,1712,695,1017
727,67,169,1990,6,2,4
728,67,166,1990,1610,563,1047
729,67,93,1990,0,0,0
730,67,146,1990,17755,6161,11594
731,67,26,1990,188809,93688,95121
732,67,170,1990,1,0,1
733,67,130,1990,208,93,115
734,67,38,1990,527,345,182
735,67,27,1990,0,0,0
736,67,50,1990,20477,9446,11031
737,67,131,1990,228,111,117
738,67,114,1990,337,155,182
739,67,171,1990,10,5,5
740,67,1,1990,2690,1382,1308
741,67,28,1990,110,36,74
742,67,132,1990,221,114,107
743,67,133,1990,174,96,78
744,95,172,1990,551,211,340
745,95,97,1990,6691,2989,3702
746,95,69,1990,45,16,29
747,95,98,1990,12650,6146,6504
748,95,85,1990,35,16,19
749,95,99,1990,2764,1243,1521
750,95,173,1990,47,22,25
751,95,5,1990,247,109,138
752,95,86,1990,445,185,260
753,95,20,1990,35,9,26
754,95,100,1990,3025,1323,1702
755,95,162,1990,30,5,25
756,95,50,1990,306,111,195
757,151,136,1990,143,66,77
758,151,137,1990,393,184,209
759,151,68,1990,370,180,190
760,151,156,1990,2107,1010,1097
761,151,160,1990,265,127,138
762,151,162,1990,15728,6324,9404
763,151,166,1990,16968,11178,5790
764,151,152,1990,3507,1441,2066
765,4,3,1990,24,8,16
766,4,10,1990,15,7,8
767,4,172,1990,422,197,225
768,4,39,1990,18,6,12
769,4,68,1990,14,7,7
770,4,69,1990,12,5,7
771,4,5,1990,20841,3524,17317
772,4,57,1990,6,2,4
773,4,177,1990,59,21,38
774,4,8,1990,334,114,220
775,4,73,1990,9,3,6
776,4,9,1990,10,0,10
777,4,49,1990,11,5,6
778,4,74,1990,11,2,9
779,4,50,1990,17,9,8
780,53,66,1990,310,169,141
781,53,54,1990,21218,10875,10343
782,53,68,1990,259,143,116
783,53,69,1990,816,441,375
784,53,32,1990,233,166,67
785,53,57,1990,165,96,69
786,53,59,1990,3727,1912,1815
787,53,35,1990,624,517,107
788,53,36,1990,271,217,54
789,53,63,1990,16974,8700,8274
790,53,37,1990,4681,2389,2292
791,53,64,1990,2796,1719,1077
792,53,60,1990,2468,1284,1184
793,147,134,1990,551,262,289
794,147,10,1990,398,187,211
795,147,172,1990,874,30,844
796,147,137,1990,526,245,281
797,147,39,1990,102,47,55
798,147,69,1990,332,148,184
799,147,5,1990,1967,886,1081
800,147,44,1990,185,82,103
801,147,57,1990,161,56,105
802,147,121,1990,122,54,68
803,147,149,1990,505,256,249
804,147,122,1990,100,40,60
805,147,123,1990,713,269,444
806,147,124,1990,292,120,172
807,147,125,1990,184,85,99
808,147,150,1990,286,128,158
809,147,73,1990,188,75,113
810,147,162,1990,108,46,62
811,147,48,1990,116,49,67
812,147,9,1990,145,63,82
813,147,61,1990,137,52,85
814,147,127,1990,45,0,45
815,147,115,1990,5780,1989,3791
816,147,133,1990,4905,1977,2928
817,147,148,1990,108,46,62
818,147,49,1990,129,49,80
819,147,130,1990,295,137,158
820,147,50,1990,3289,1441,1848
821,147,131,1990,460,203,257
822,147,132,1990,1991,892,1099
823,105,2,1990,0,0,0
824,105,141,1990,0,0,0
825,105,52,1990,0,0,0
826,105,134,1990,4868,2431,2437
827,105,103,1990,28350,13172,15178
828,105,66,1990,4756,2582,2174
829,105,78,1990,0,0,0
830,105,13,1990,0,0,0
831,105,3,1990,0,0,0
832,105,11,1990,0,0,0
833,105,79,1990,0,0,0
834,105,67,1990,1887,866,1021
835,105,53,1990,0,0,0
836,105,95,1990,0,0,0
837,105,30,1990,409,219,190
838,105,116,1990,0,0,0
839,105,29,1990,0,0,0
840,105,135,1990,0,0,0
841,105,153,1990,0,0,0
842,105,106,1990,22243,9307,12936
843,105,172,1990,8532,3967,4565
844,105,107,1990,2223,1126,1097
845,105,137,1990,0,0,0
846,105,137,1990,0,0,0
847,105,96,1990,388,121,267
848,105,54,1990,0,0,0
849,105,81,1990,442,251,191
850,105,31,1990,1535,673,862
851,105,151,1990,0,0,0
852,105,39,1990,525,264,261
853,105,82,1990,0,0,0
854,105,83,1990,277,192,85
855,105,108,1990,614,212,402
856,105,97,1990,405,70,335
857,105,138,1990,0,0,0
858,105,120,1990,0,0,0
859,105,40,1990,0,0,0
860,105,42,1990,169,85,84
861,105,68,1990,8096,3390,4706
862,105,109,1990,742,358,384
863,105,139,1990,0,0,0
864,105,15,1990,0,0,0
865,105,69,1990,25679,12605,13074
866,105,156,1990,0,0,0
867,105,56,1990,3523,1267,2256
868,105,84,1990,0,0,0
869,105,98,1990,53,38,15
870,105,157,1990,0,0,0
871,105,110,1990,1093,612,481
872,105,85,1990,254,135,119
873,105,99,1990,280,72,208
874,105,32,1990,5282,3070,2212
875,105,43,1990,0,0,0
876,105,5,1990,697,278,419
877,105,6,1990,0,0,0
878,105,16,1990,0,0,0
879,105,44,1990,109,43,66
880,105,17,1990,2137,774,1363
881,105,57,1990,70081,32072,38009
882,105,86,1990,24,0,24
883,105,177,1990,86768,41426,45342
884,105,167,1990,0,0,0
885,105,18,1990,0,0,0
886,105,121,1990,0,0,0
887,105,176,1990,0,0,0
888,105,19,1990,0,0,0
889,105,20,1990,17987,7107,10880
890,105,46,1990,0,0,0
891,105,159,1990,0,0,0
892,105,143,1990,0,0,0
893,105,70,1990,0,0,0
894,105,47,1990,0,0,0
895,105,71,1990,0,0,0
896,105,122,1990,0,0,0
897,105,123,1990,0,0,0
898,105,7,1990,0,0,0
899,105,160,1990,0,0,0
900,105,58,1990,0,0,0
901,105,100,1990,792,312,480
902,105,72,1990,0,0,0
903,105,59,1990,0,0,0
904,105,144,1990,0,0,0
905,105,125,1990,987,235,752
906,105,21,1990,0,0,0
907,105,150,1990,0,0,0
908,105,8,1990,0,0,0
909,105,73,1990,3535,1380,2155
910,105,101,1990,329,129,200
911,105,162,1990,0,0,0
912,105,48,1990,230,48,182
913,105,9,1990,127,28,99
914,105,102,1990,974,407,567
915,105,111,1990,21394,11319,10075
916,105,112,1990,5716,2322,3394
917,105,33,1990,13225,6920,6305
918,105,61,1990,274924,129178,145746
919,105,158,1990,0,0,0
920,105,35,1990,6604,3373,3231
921,105,36,1990,11249,6327,4922
922,105,126,1990,0,0,0
923,105,90,1990,0,0,0
924,105,91,1990,0,0,0
925,105,92,1990,0,0,0
926,105,62,1990,0,0,0
927,105,140,1990,0,0,0
928,105,23,1990,0,0,0
929,105,164,1990,0,0,0
930,105,63,1990,0,0,0
931,105,127,1990,0,0,0
932,105,165,1990,0,0,0
933,105,37,1990,0,0,0
934,105,1,1990,0,0,0
935,105,64,1990,0,0,0
936,105,115,1990,0,0,0
937,105,133,1990,0,0,0
938,105,65,1990,59188,26984,32204
939,105,113,1990,120,69,51
940,105,49,1990,457,126,331
941,105,74,1990,2886,1290,1596
942,105,25,1990,4434,2163,2271
943,105,169,1990,0,0,0
944,105,166,1990,0,0,0
945,105,93,1990,0,0,0
946,105,27,1990,0,0,0
947,105,146,1990,0,0,0
948,105,26,1990,1031,480,551
949,105,170,1990,0,0,0
950,105,130,1990,0,0,0
951,105,38,1990,0,0,0
952,105,60,1990,0,0,0
953,105,142,1990,4192,1932,2260
954,105,50,1990,3849,1763,2086
955,105,131,1990,0,0,0
956,105,152,1990,0,0,0
957,105,114,1990,23363,10681,12682
958,105,171,1990,0,0,0
959,30,2,1990,222,77,145
960,30,51,1990,103,49,54
961,30,141,1990,32,9,23
962,30,52,1990,0,0,0
963,30,134,1990,4,0,4
964,30,75,1990,10,3,7
965,30,76,1990,1,0,1
966,30,103,1990,7,4,3
967,30,11,1990,1207,602,605
968,30,77,1990,1,0,1
969,30,66,1990,26,12,14
970,30,12,1990,8,4,4
971,30,78,1990,1,0,1
972,30,13,1990,1,0,1
973,30,3,1990,22,4,18
974,30,79,1990,1,1,0
975,30,29,1990,89,72,17
976,30,67,1990,14,3,11
977,30,95,1990,0,0,0
978,30,151,1990,2,0,2
979,30,4,1990,1,0,1
980,30,53,1990,18,7,11
981,30,147,1990,7,2,5
982,30,105,1990,8,4,4
983,30,152,1990,3,1,2
984,30,116,1990,4,2,2
985,30,153,1990,2,0,2
986,30,135,1990,1,0,1
987,30,80,1990,0,0,0
988,30,136,1990,1,0,1
989,30,106,1990,3,1,2
990,30,172,1990,362,151,211
991,30,107,1990,1,1,0
992,30,137,1990,10,1,9
993,30,96,1990,1,0,1
994,30,54,1990,15,7,8
995,30,81,1990,50,14,36
996,30,14,1990,103,51,52
997,30,31,1990,162,106,56
998,30,176,1990,1,0,1
999,30,137,1990,3,1,2
1000,30,39,1990,10,3,7
1001,30,118,1990,1,0,1
1002,30,82,1990,0,0,0
1003,30,83,1990,5,3,2
1004,30,108,1990,1,0,1
1005,30,142,1990,30,7,23
1006,30,97,1990,1,1,0
1007,30,119,1990,1,0,1
1008,30,40,1990,4,3,1
1009,30,148,1990,1,1,0
1010,30,120,1990,26,2,24
1011,30,42,1990,10,6,4
1012,30,68,1990,63,23,40
1013,30,139,1990,3,2,1
1014,30,155,1990,2,1,1
1015,30,15,1990,77,38,39
1016,30,69,1990,252,138,114
1017,30,156,1990,4,1,3
1018,30,55,1990,2,1,1
1019,30,56,1990,1246,469,777
1020,30,98,1990,1,1,0
1021,30,157,1990,4,1,3
1022,30,158,1990,1,0,1
1023,30,110,1990,1,0,1
1024,30,85,1990,1,0,1
1025,30,99,1990,0,0,0
1026,30,32,1990,70,40,30
1027,30,43,1990,1,0,1
1028,30,5,1990,163,30,133
1029,30,6,1990,98,12,86
1030,30,16,1990,171,53,118
1031,30,44,1990,4,2,2
1032,30,45,1990,0,0,0
1033,30,17,1990,58,17,41
1034,30,57,1990,113,31,82
1035,30,86,1990,1,1,0
1036,30,177,1990,26,13,13
1037,30,18,1990,83,9,74
1038,30,167,1990,89,63,26
1039,30,121,1990,2,1,1
1040,30,19,1990,9,1,8
1041,30,168,1990,10,7,3
1042,30,46,1990,10,9,1
1043,30,20,1990,266,59,207
1044,30,159,1990,1,0,1
1045,30,143,1990,34,12,22
1046,30,70,1990,1,0,1
1047,30,47,1990,9,8,1
1048,30,71,1990,2,1,1
1049,30,122,1990,0,0,0
1050,30,123,1990,0,0,0
1051,30,7,1990,1,0,1
1052,30,160,1990,0,0,0
1053,30,58,1990,1,1,0
1054,30,161,1990,1,0,1
1055,30,124,1990,0,0,0
1056,30,100,1990,2,1,1
1057,30,72,1990,1,1,0
1058,30,59,1990,7,3,4
1059,30,144,1990,19,4,15
1060,30,125,1990,6,2,4
1061,30,150,1990,1,0,1
1062,30,8,1990,1,0,1
1063,30,73,1990,12,4,8
1064,30,101,1990,15,1,14
1065,30,162,1990,31,3,28
1066,30,60,1990,1018,449,569
1067,30,48,1990,4,1,3
1068,30,21,1990,0,0,0
1069,30,9,1990,23,1,22
1070,30,102,1990,4,1,3
1071,30,111,1990,0,0,0
1072,30,112,1990,7,1,6
1073,30,33,1990,423,295,128
1074,30,61,1990,3,0,3
1075,30,22,1990,2,0,2
1076,30,35,1990,143,88,55
1077,30,36,1990,6899,5340,1559
1078,30,126,1990,0,0,0
1079,30,62,1990,1,1,0
1080,30,23,1990,1,0,1
1081,30,164,1990,1,1,0
1082,30,63,1990,562,295,267
1083,30,127,1990,0,0,0
1084,30,165,1990,0,0,0
1085,30,37,1990,63,51,12
1086,30,64,1990,8,4,4
1087,30,128,1990,1,0,1
1088,30,115,1990,9,6,3
1089,30,65,1990,18,8,10
1090,30,10,1990,2,0,2
1091,30,145,1990,12,1,11
1092,30,113,1990,0,0,0
1093,30,49,1990,15,6,9
1094,30,74,1990,15,8,7
1095,30,25,1990,473,85,388
1096,30,169,1990,5,4,1
1097,30,166,1990,0,0,0
1098,30,93,1990,0,0,0
1099,30,146,1990,18,1,17
1100,30,26,1990,743,274,469
1101,30,170,1990,7,7,0
1102,30,94,1990,1,0,1
1103,30,130,1990,1,0,1
1104,30,38,1990,1671,1225,446
1105,30,27,1990,1,0,1
1106,30,50,1990,59,14,45
1107,30,131,1990,7,0,7
1108,30,114,1990,2,2,0
1109,30,171,1990,24,17,7
1110,30,1,1990,346,102,244
1111,30,28,1990,28,6,22
1112,30,132,1990,3,1,2
1113,30,133,1990,4,1,3
1114,152,151,1990,2054,1028,1026
1115,152,156,1990,24542,16008,8534
1116,152,160,1990,37576,21430,16146
1117,152,162,1990,2542,1365,1177
1118,152,164,1990,1983,906,1077
1119,152,166,1990,6131,4328,1803
1120,116,67,1990,642,327,315
1121,116,137,1990,36654,18691,17963
1122,116,68,1990,321,164,157
1123,116,121,1990,186,82,104
1124,116,126,1990,221943,113171,108772
1125,116,130,1990,1833,935,898
1126,116,131,1990,11912,6074,5838
1127,153,134,1990,1588,798,790
1128,153,103,1990,5,4,1
1129,153,67,1990,14,7,7
1130,153,105,1990,77,39,38
1131,153,172,1990,30,16,14
1132,153,81,1990,69,36,33
1133,153,68,1990,102,52,50
1134,153,139,1990,11,5,6
1135,153,155,1990,7,4,3
1136,153,69,1990,25,12,13
1137,153,156,1990,55,29,26
1138,153,157,1990,60,30,30
1139,153,57,1990,201,89,112
1140,153,177,1990,2,2,0
1141,153,71,1990,5,4,1
1142,153,160,1990,9,5,4
1143,153,100,1990,4,2,2
1144,153,125,1990,51,29,22
1145,153,73,1990,62,29,33
1146,153,162,1990,84,43,41
1147,153,112,1990,4,2,2
1148,153,61,1990,1132,566,566
1149,153,158,1990,539,229,310
1150,153,36,1990,55,29,26
1151,153,140,1990,2475,1324,1151
1152,153,164,1990,141,64,77
1153,153,165,1990,19,11,8
1154,153,65,1990,30,16,14
1155,153,74,1990,18,9,9
1156,153,38,1990,28,14,14
1157,153,50,1990,14,7,7
1158,135,134,1990,0,0,0
1159,135,136,1990,95527,48377,47150
1160,135,137,1990,0,0,0
1161,135,137,1990,0,0,0
1162,135,151,1990,0,0,0
1163,135,138,1990,0,0,0
1164,135,68,1990,11808,5431,6377
1165,135,139,1990,0,0,0
1166,135,69,1990,0,0,0
1167,135,56,1990,0,0,0
1168,135,157,1990,0,0,0
1169,135,57,1990,0,0,0
1170,135,159,1990,0,0,0
1171,135,160,1990,0,0,0
1172,135,73,1990,0,0,0
1173,135,162,1990,105140,44537,60603
1174,135,164,1990,0,0,0
1175,135,50,1990,0,0,0
1176,80,103,1990,3,1,2
1177,80,66,1990,15,2,13
1178,80,78,1990,58,27,31
1179,80,79,1990,64,17,47
1180,80,67,1990,3,1,2
1181,80,105,1990,21,11,10
1182,80,95,1990,110,51,59
1183,80,107,1990,72,26,46
1184,80,96,1990,87,25,62
1185,80,81,1990,232,106,126
1186,80,39,1990,5,1,4
1187,80,83,1990,20,4,16
1188,80,42,1990,2,1,1
1189,80,68,1990,11,4,7
1190,80,69,1990,42,13,29
1191,80,84,1990,4,1,3
1192,80,110,1990,60,30,30
1193,80,85,1990,5,1,4
1194,80,99,1990,747,390,357
1195,80,5,1990,44,20,24
1196,80,6,1990,2,0,2
1197,80,44,1990,79,38,41
1198,80,17,1990,3,2,1
1199,80,57,1990,28,3,25
1200,80,86,1990,3767,2147,1620
1201,80,177,1990,6,1,5
1202,80,121,1990,10,7,3
1203,80,100,1990,12,6,6
1204,80,73,1990,11,1,10
1205,80,101,1990,238,133,105
1206,80,162,1990,2,0,2
1207,80,9,1990,34,12,22
1208,80,102,1990,42,19,23
1209,80,112,1990,4,2,2
1210,80,88,1990,14,7,7
1211,80,91,1990,2,1,1
1212,80,92,1990,9,1,8
1213,80,115,1990,11,5,6
1214,80,133,1990,5,1,4
1215,80,65,1990,8,4,4
1216,80,74,1990,24,5,19
1217,80,93,1990,112,53,59
1218,80,50,1990,1040,469,571
1219,80,131,1990,4,4,0
1220,80,132,1990,2,0,2
1221,136,135,1990,30992,14261,16731
1222,136,137,1990,715,329,386
1223,136,137,1990,98,45,53
1224,136,68,1990,886,408,478
1225,136,139,1990,292,134,158
1226,136,143,1990,1096,504,592
1227,136,162,1990,14822,6821,8001
1228,136,145,1990,9529,4385,5144
1229,106,103,1990,32696,16484,16212
1230,106,105,1990,4332,2293,2039
1231,106,172,1990,1124,471,653
1232,106,107,1990,1554,866,688
1233,106,81,1990,518,271,247
1234,106,83,1990,124,68,56
1235,106,108,1990,2163,1151,1012
1236,106,68,1990,2147,1072,1075
1237,106,69,1990,5379,2723,2656
1238,106,85,1990,36,12,24
1239,106,57,1990,4422,1918,2504
1240,106,100,1990,746,381,365
1241,106,111,1990,641,351,290
1242,106,112,1990,7052,3469,3583
1243,106,65,1990,9710,4520,5190
1244,106,114,1990,1393,671,722
1245,172,3,1990,470,307,163
1246,172,105,1990,3057,1350,1707
1247,172,10,1990,765,551,214
1248,172,173,1990,622,266,356
1249,172,5,1990,1137,486,651
1250,172,177,1990,1150,470,680
1251,172,174,1990,3099,1348,1751
1252,172,9,1990,460,192,268
1253,172,112,1990,557,246,311
1254,172,36,1990,274,117,157
1255,172,1,1990,285788,140029,145759
1256,172,50,1990,1198,450,748
1257,107,103,1990,2359,1075,1284
1258,107,105,1990,1728,975,753
1259,107,106,1990,1859,985,874
1260,107,172,1990,1233,524,709
1261,107,96,1990,691,370,321
1262,107,81,1990,1296,540,756
1263,107,83,1990,361,188,173
1264,107,108,1990,11870,5647,6223
1265,107,97,1990,297,148,149
1266,107,68,1990,1905,875,1030
1267,107,69,1990,2679,1207,1472
1268,107,98,1990,264,159,105
1269,107,99,1990,265,139,126
1270,107,57,1990,2660,971,1689
1271,107,177,1990,515,215,300
1272,107,100,1990,1908,963,945
1273,107,73,1990,425,191,234
1274,107,102,1990,2073,1111,962
1275,107,112,1990,2896,1292,1604
1276,107,36,1990,493,271,222
1277,107,65,1990,5631,2523,3108
1278,107,74,1990,663,250,413
1279,107,50,1990,991,450,541
1280,107,114,1990,360,158,202
1281,117,68,1990,543,233,310
1282,117,121,1990,87,47,40
1283,117,122,1990,10810,5803,5007
1284,117,131,1990,163,84,79
1285,137,134,1990,10334,5427,4907
1286,137,135,1990,3464,1428,2036
1287,137,136,1990,3239,1136,2103
1288,137,172,1990,283,23,260
1289,137,137,1990,67316,36580,30736
1290,137,81,1990,164,115,49
1291,137,151,1990,4357,2273,2084
1292,137,138,1990,485,225,260
1293,137,68,1990,8574,4078,4496
1294,137,139,1990,970,505,465
1295,137,69,1990,178,97,81
1296,137,20,1990,358,138,220
1297,137,160,1990,4678,2219,2459
1298,137,161,1990,965,226,739
1299,137,61,1990,442,190,252
1300,137,36,1990,790,486,304
1301,137,126,1990,0,0,0
1302,137,164,1990,3468,885,2583
1303,137,166,1990,747,409,338
1304,137,134,1990,468462,242957,225505
1305,137,116,1990,20203,10478,9725
1306,137,137,1990,3647,1824,1823
1307,137,126,1990,22972,11914,11058
1308,137,129,1990,113409,58816,54593
1309,137,145,1990,15895,8244,7651
1310,137,130,1990,18418,9552,8866
1311,96,2,1990,25,14,11
1312,96,51,1990,2,1,1
1313,96,141,1990,44,25,19
1314,96,134,1990,4,3,1
1315,96,12,1990,2,1,1
1316,96,103,1990,1041,528,513
1317,96,66,1990,80,26,54
1318,96,78,1990,10,3,7
1319,96,13,1990,1,0,1
1320,96,3,1990,13,12,1
1321,96,11,1990,6,2,4
1322,96,79,1990,8,2,6
1323,96,67,1990,200,85,115
1324,96,4,1990,3,1,2
1325,96,105,1990,346,183,163
1326,96,95,1990,202,104,98
1327,96,30,1990,39,22,17
1328,96,29,1990,5,2,3
1329,96,135,1990,8,5,3
1330,96,80,1990,8,2,6
1331,96,10,1990,1,0,1
1332,96,106,1990,1490,733,757
1333,96,172,1990,252,93,159
1334,96,107,1990,4372,2212,2160
1335,96,137,1990,7,2,5
1336,96,137,1990,2,2,0
1337,96,54,1990,21,9,12
1338,96,81,1990,4504,2156,2348
1339,96,14,1990,2,1,1
1340,96,151,1990,1,1,0
1341,96,39,1990,48,19,29
1342,96,82,1990,3,3,0
1343,96,83,1990,553,349,204
1344,96,108,1990,736,330,406
1345,96,97,1990,56257,28459,27798
1346,96,120,1990,2,1,1
1347,96,40,1990,2,2,0
1348,96,42,1990,18,10,8
1349,96,68,1990,539,236,303
1350,96,109,1990,6,3,3
1351,96,139,1990,1,1,0
1352,96,15,1990,10,6,4
1353,96,69,1990,1268,522,746
1354,96,156,1990,1,0,1
1355,96,55,1990,3,3,0
1356,96,56,1990,28,11,17
1357,96,84,1990,7,2,5
1358,96,98,1990,1977,951,1026
1359,96,110,1990,20,9,11
1360,96,85,1990,48,16,32
1361,96,99,1990,2608,1452,1156
1362,96,173,1990,1504,696,808
1363,96,32,1990,66,31,35
1364,96,43,1990,2,1,1
1365,96,5,1990,35,14,21
1366,96,6,1990,81,18,63
1367,96,16,1990,10,3,7
1368,96,44,1990,24,10,14
1369,96,17,1990,123,43,80
1370,96,57,1990,1408,552,856
1371,96,86,1990,356,185,171
1372,96,177,1990,207,86,121
1373,96,167,1990,5,5,0
1374,96,18,1990,8,2,6
1375,96,121,1990,4,0,4
1376,96,176,1990,21,9,12
1377,96,20,1990,86,32,54
1378,96,46,1990,1,1,0
1379,96,143,1990,12,6,6
1380,96,70,1990,3,1,2
1381,96,47,1990,8,3,5
1382,96,71,1990,9,6,3
1383,96,174,1990,2,1,1
1384,96,122,1990,2,2,0
1385,96,7,1990,1,1,0
1386,96,100,1990,2081,1119,962
1387,96,72,1990,1,0,1
1388,96,87,1990,3,2,1
1389,96,144,1990,17,9,8
1390,96,125,1990,3,2,1
1391,96,21,1990,2,0,2
1392,96,8,1990,7,1,6
1393,96,73,1990,381,149,232
1394,96,77,1990,29,9,20
1395,96,101,1990,99153,49058,50095
1396,96,162,1990,3,1,2
1397,96,48,1990,42,15,27
1398,96,9,1990,6,1,5
1399,96,102,1990,8692,4153,4539
1400,96,111,1990,58,38,20
1401,96,112,1990,2225,1039,1186
1402,96,33,1990,329,169,160
1403,96,61,1990,57,22,35
1404,96,88,1990,268,117,151
1405,96,22,1990,2,1,1
1406,96,35,1990,62,36,26
1407,96,36,1990,519,337,182
1408,96,126,1990,1,1,0
1409,96,90,1990,1,1,0
1410,96,91,1990,2,1,1
1411,96,92,1990,1,0,1
1412,96,23,1990,6,2,4
1413,96,164,1990,1,1,0
1414,96,37,1990,20,7,13
1415,96,1,1990,2,1,1
1416,96,128,1990,1,1,0
1417,96,115,1990,47,26,21
1418,96,133,1990,2,2,0
1419,96,65,1990,1829,791,1038
1420,96,145,1990,1,0,1
1421,96,113,1990,13,6,7
1422,96,148,1990,1,1,0
1423,96,49,1990,97,38,59
1424,96,74,1990,388,164,224
1425,96,25,1990,9,1,8
1426,96,93,1990,26,15,11
1427,96,146,1990,3,2,1
1428,96,26,1990,6,2,4
1429,96,130,1990,8,2,6
1430,96,38,1990,135,87,48
1431,96,60,1990,26,9,17
1432,96,142,1990,19,6,13
1433,96,50,1990,451,183,268
1434,96,131,1990,3,2,1
1435,96,114,1990,252,115,137
1436,96,171,1990,1,1,0
1437,54,51,1990,0,0,0
1438,54,141,1990,0,0,0
1439,54,103,1990,143,97,46
1440,54,66,1990,1265,775,490
1441,54,29,1990,0,0,0
1442,54,67,1990,192,103,89
1443,54,53,1990,312821,163974,148847
1444,54,105,1990,122,77,45
1445,54,30,1990,0,0,0
1446,54,106,1990,122,79,43
1447,54,172,1990,0,0,0
1448,54,107,1990,0,0,0
1449,54,31,1990,0,0,0
1450,54,39,1990,44,28,16
1451,54,142,1990,0,0,0
1452,54,40,1990,0,0,0
1453,54,42,1990,0,0,0
1454,54,68,1990,831,499,332
1455,54,69,1990,5148,3005,2143
1456,54,56,1990,0,0,0
1457,54,32,1990,1666,1156,510
1458,54,5,1990,0,0,0
1459,54,6,1990,0,0,0
1460,54,16,1990,0,0,0
1461,54,44,1990,0,0,0
1462,54,17,1990,0,0,0
1463,54,57,1990,2065,1224,841
1464,54,177,1990,0,0,0
1465,54,18,1990,0,0,0
1466,54,167,1990,0,0,0
1467,54,46,1990,0,0,0
1468,54,20,1990,0,0,0
1469,54,143,1990,0,0,0
1470,54,47,1990,0,0,0
1471,54,71,1990,0,0,0
1472,54,100,1990,0,0,0
1473,54,59,1990,0,0,0
1474,54,144,1990,0,0,0
1475,54,73,1990,232,152,80
1476,54,162,1990,0,0,0
1477,54,60,1990,12962,6071,6891
1478,54,48,1990,0,0,0
1479,54,112,1990,53,39,14
1480,54,33,1990,655,541,114
1481,54,61,1990,0,0,0
1482,54,35,1990,0,0,0
1483,54,36,1990,0,0,0
1484,54,63,1990,0,0,0
1485,54,37,1990,0,0,0
1486,54,64,1990,29943,19261,10682
1487,54,115,1990,0,0,0
1488,54,65,1990,0,0,0
1489,54,145,1990,0,0,0
1490,54,49,1990,279,178,101
1491,54,74,1990,465,248,217
1492,54,25,1990,0,0,0
1493,54,26,1990,0,0,0
1494,54,38,1990,0,0,0
1495,54,50,1990,182,129,53
1496,54,132,1990,0,0,0
1497,81,51,1990,242,109,133
1498,81,141,1990,103,48,55
1499,81,134,1990,218,86,132
1500,81,103,1990,373,181,192
1501,81,30,1990,296,173,123
1502,81,106,1990,393,179,214
1503,81,172,1990,658,151,507
1504,81,107,1990,353,177,176
1505,81,31,1990,406,229,177
1506,81,83,1990,267,149,118
1507,81,108,1990,135,68,67
1508,81,68,1990,328,159,169
1509,81,69,1990,752,364,388
1510,81,84,1990,180,84,96
1511,81,98,1990,153,78,75
1512,81,85,1990,2063,585,1478
1513,81,32,1990,155,90,65
1514,81,57,1990,492,133,359
1515,81,86,1990,656,334,322
1516,81,20,1990,123,54,69
1517,81,100,1990,889,444,445
1518,81,101,1990,595,368,227
1519,81,102,1990,184,121,63
1520,81,112,1990,191,109,82
1521,81,33,1990,211,135,76
1522,81,88,1990,272,145,127
1523,81,35,1990,153,105,48
1524,81,36,1990,4491,2763,1728
1525,81,65,1990,10703,5309,5394
1526,81,38,1990,1367,907,460
1527,81,50,1990,110,44,66
1528,14,2,1990,2,0,2
1529,14,51,1990,69,28,41
1530,14,141,1990,9,4,5
1531,14,103,1990,21,9,12
1532,14,11,1990,292,133,159
1533,14,66,1990,88,49,39
1534,14,12,1990,9,5,4
1535,14,13,1990,27,12,15
1536,14,3,1990,162,3,159
1537,14,29,1990,84,63,21
1538,14,67,1990,65,33,32
1539,14,151,1990,2,0,2
1540,14,53,1990,17,9,8
1541,14,147,1990,2,1,1
1542,14,105,1990,15,9,6
1543,14,30,1990,1531,1030,501
1544,14,116,1990,1,0,1
1545,14,135,1990,14,6,8
1546,14,106,1990,12,7,5
1547,14,172,1990,398,194,204
1548,14,107,1990,31,22,9
1549,14,96,1990,1,1,0
1550,14,54,1990,21,12,9
1551,14,81,1990,9,4,5
1552,14,31,1990,168,106,62
1553,14,176,1990,8,5,3
1554,14,137,1990,170,89,81
1555,14,39,1990,42,23,19
1556,14,118,1990,1,1,0
1557,14,83,1990,3,2,1
1558,14,108,1990,2,1,1
1559,14,142,1990,1290,516,774
1560,14,97,1990,3,1,2
1561,14,119,1990,1,1,0
1562,14,40,1990,7,5,2
1563,14,120,1990,20,12,8
1564,14,42,1990,123,88,35
1565,14,68,1990,228,131,97
1566,14,15,1990,3802,1720,2082
1567,14,69,1990,646,352,294
1568,14,156,1990,21,10,11
1569,14,55,1990,1,0,1
1570,14,56,1990,5898,2487,3411
1571,14,85,1990,1,1,0
1572,14,99,1990,1,0,1
1573,14,32,1990,86,50,36
1574,14,43,1990,8,6,2
1575,14,5,1990,684,270,414
1576,14,6,1990,299,110,189
1577,14,16,1990,78,24,54
1578,14,44,1990,193,123,70
1579,14,17,1990,95,41,54
1580,14,57,1990,120,59,61
1581,14,86,1990,4,2,2
1582,14,177,1990,21,12,9
1583,14,18,1990,110,39,71
1584,14,167,1990,59,35,24
1585,14,121,1990,21,10,11
1586,14,19,1990,58,24,34
1587,14,168,1990,6,3,3
1588,14,46,1990,41,28,13
1589,14,20,1990,685,298,387
1590,14,143,1990,57,23,34
1591,14,47,1990,23,18,5
1592,14,71,1990,3,2,1
1593,14,122,1990,2,1,1
1594,14,123,1990,2,1,1
1595,14,58,1990,8,3,5
1596,14,124,1990,3,1,2
1597,14,100,1990,16,10,6
1598,14,144,1990,16,7,9
1599,14,125,1990,3,2,1
1600,14,150,1990,1,0,1
1601,14,8,1990,14,2,12
1602,14,73,1990,120,68,52
1603,14,101,1990,3,1,2
1604,14,162,1990,76,32,44
1605,14,60,1990,5,3,2
1606,14,48,1990,50,31,19
1607,14,21,1990,16,6,10
1608,14,9,1990,129,9,120
1609,14,102,1990,5,1,4
1610,14,111,1990,2,2,0
1611,14,112,1990,8,5,3
1612,14,33,1990,176,127,49
1613,14,61,1990,16,11,5
1614,14,88,1990,1,0,1
1615,14,22,1990,3,1,2
1616,14,35,1990,1345,922,423
1617,14,36,1990,3235,1828,1407
1618,14,23,1990,58,26,32
1619,14,164,1990,2,1,1
1620,14,63,1990,630,327,303
1621,14,127,1990,2,1,1
1622,14,165,1990,1,0,1
1623,14,37,1990,34,20,14
1624,14,64,1990,4,2,2
1625,14,128,1990,3,1,2
1626,14,115,1990,1235,650,585
1627,14,65,1990,39,27,12
1628,14,10,1990,2457,1899,558
1629,14,145,1990,129,63,66
1630,14,113,1990,1,1,0
1631,14,49,1990,227,143,84
1632,14,74,1990,94,58,36
1633,14,25,1990,810,188,622
1634,14,169,1990,2,1,1
1635,14,93,1990,4,3,1
1636,14,146,1990,9,3,6
1637,14,26,1990,152,77,75
1638,14,170,1990,3,2,1
1639,14,130,1990,5,1,4
1640,14,38,1990,815,528,287
1641,14,27,1990,38,15,23
1642,14,50,1990,9055,4694,4361
1643,14,131,1990,36,18,18
1644,14,114,1990,1,1,0
1645,14,171,1990,18,10,8
1646,14,1,1990,16,13,3
1647,14,28,1990,4,2,2
1648,14,132,1990,34,21,13
1649,14,133,1990,76,43,33
1650,31,2,1990,51,14,37
1651,31,51,1990,44,16,28
1652,31,141,1990,80,11,69
1653,31,52,1990,4,2,2
1654,31,134,1990,33,4,29
1655,31,76,1990,1,0,1
1656,31,103,1990,76,39,37
1657,31,11,1990,227,91,136
1658,31,77,1990,0,0,0
1659,31,66,1990,1811,993,818
1660,31,12,1990,45,20,25
1661,31,78,1990,0,0,0
1662,31,13,1990,6,1,5
1663,31,3,1990,8,1,7
1664,31,79,1990,3,2,1
1665,31,29,1990,322,184,138
1666,31,67,1990,186,81,105
1667,31,95,1990,1,1,0
1668,31,151,1990,7,1,6
1669,31,4,1990,0,0,0
1670,31,53,1990,355,135,220
1671,31,147,1990,0,0,0
1672,31,105,1990,28,11,17
1673,31,30,1990,1154,411,743
1674,31,152,1990,1,1,0
1675,31,116,1990,0,0,0
1676,31,153,1990,3,1,2
1677,31,135,1990,1,1,0
1678,31,80,1990,0,0,0
1679,31,136,1990,2,0,2
1680,31,106,1990,7,3,4
1681,31,172,1990,303,121,182
1682,31,173,1990,6,4,2
1683,31,107,1990,18,7,11
1684,31,117,1990,0,0,0
1685,31,137,1990,16,2,14
1686,31,96,1990,3,1,2
1687,31,54,1990,417,170,247
1688,31,81,1990,123,25,98
1689,31,14,1990,13,3,10
1690,31,176,1990,21,16,5
1691,31,137,1990,8,1,7
1692,31,39,1990,32,12,20
1693,31,118,1990,1,0,1
1694,31,82,1990,0,0,0
1695,31,83,1990,1,1,0
1696,31,108,1990,10,3,7
1697,31,142,1990,39,9,30
1698,31,97,1990,3,1,2
1699,31,138,1990,1,0,1
1700,31,119,1990,1,0,1
1701,31,40,1990,15,9,6
1702,31,148,1990,0,0,0
1703,31,120,1990,19,3,16
1704,31,42,1990,82,41,41
1705,31,68,1990,891,438,453
1706,31,139,1990,0,0,0
1707,31,155,1990,2,1,1
1708,31,15,1990,88,38,50
1709,31,69,1990,2375,1186,1189
1710,31,156,1990,10,2,8
1711,31,55,1990,0,0,0
1712,31,56,1990,445,195,250
1713,31,84,1990,0,0,0
1714,31,98,1990,2,1,1
1715,31,157,1990,6,1,5
1716,31,158,1990,2,0,2
1717,31,110,1990,1,0,1
1718,31,85,1990,5,3,2
1719,31,99,1990,1,0,1
1720,31,32,1990,1526,755,771
1721,31,43,1990,5,2,3
1722,31,5,1990,60,19,41
1723,31,6,1990,47,14,33
1724,31,16,1990,65,13,52
1725,31,44,1990,16,5,11
1726,31,17,1990,35,11,24
1727,31,57,1990,255,80,175
1728,31,86,1990,1,0,1
1729,31,177,1990,48,22,26
1730,31,18,1990,25,3,22
1731,31,167,1990,454,234,220
1732,31,121,1990,11,4,7
1733,31,19,1990,14,5,9
1734,31,168,1990,37,19,18
1735,31,46,1990,32,20,12
1736,31,20,1990,51,9,42
1737,31,149,1990,1,0,1
1738,31,159,1990,2,1,1
1739,31,143,1990,25,7,18
1740,31,70,1990,0,0,0
1741,31,47,1990,41,23,18
1742,31,71,1990,4,1,3
1743,31,122,1990,6,2,4
1744,31,123,1990,5,3,2
1745,31,7,1990,0,0,0
1746,31,160,1990,4,1,3
1747,31,58,1990,2,1,1
1748,31,161,1990,1,0,1
1749,31,124,1990,1,0,1
1750,31,100,1990,19,9,10
1751,31,72,1990,0,0,0
1752,31,59,1990,29,9,20
1753,31,144,1990,26,4,22
1754,31,125,1990,1,0,1
1755,31,150,1990,2,1,1
1756,31,8,1990,4,1,3
1757,31,73,1990,135,47,88
1758,31,101,1990,4,1,3
1759,31,162,1990,17,3,14
1760,31,60,1990,131,26,105
1761,31,48,1990,24,11,13
1762,31,21,1990,0,0,0
1763,31,9,1990,23,4,19
1764,31,102,1990,2,0,2
1765,31,111,1990,8,3,5
1766,31,112,1990,17,3,14
1767,31,33,1990,6082,3818,2264
1768,31,61,1990,10,4,6
1769,31,22,1990,7,4,3
1770,31,35,1990,2945,1469,1476
1771,31,36,1990,3282,1847,1435
1772,31,126,1990,3,1,2
1773,31,90,1990,1,0,1
1774,31,91,1990,0,0,0
1775,31,92,1990,0,0,0
1776,31,62,1990,1,1,0
1777,31,140,1990,0,0,0
1778,31,23,1990,4,1,3
1779,31,164,1990,8,1,7
1780,31,63,1990,1181,488,693
1781,31,127,1990,0,0,0
1782,31,165,1990,1,0,1
1783,31,37,1990,70252,33410,36842
1784,31,64,1990,64,30,34
1785,31,128,1990,1,0,1
1786,31,115,1990,38,18,20
1787,31,65,1990,42,17,25
1788,31,10,1990,8,2,6
1789,31,145,1990,16,4,12
1790,31,113,1990,0,0,0
1791,31,49,1990,52,18,34
1792,31,74,1990,95,39,56
1793,31,25,1990,108,14,94
1794,31,169,1990,16,9,7
1795,31,166,1990,4,1,3
1796,31,93,1990,0,0,0
1797,31,146,1990,39,6,33
1798,31,26,1990,55,14,41
1799,31,170,1990,12,7,5
1800,31,130,1990,4,2,2
1801,31,38,1990,8198,4240,3958
1802,31,27,1990,8,1,7
1803,31,50,1990,351,110,241
1804,31,131,1990,5,1,4
1805,31,114,1990,9,3,6
1806,31,171,1990,44,23,21
1807,31,1,1990,3604,1178,2426
1808,31,28,1990,27,4,23
1809,31,132,1990,5,1,4
1810,31,133,1990,5,2,3
1811,39,2,1990,354,142,212
1812,39,51,1990,5,2,3
1813,39,141,1990,526,131,395
1814,39,52,1990,1,0,1
1815,39,134,1990,48,18,30
1816,39,76,1990,0,0,0
1817,39,103,1990,833,422,411
1818,39,11,1990,400,188,212
1819,39,77,1990,5,1,4
1820,39,66,1990,1275,701,574
1821,39,12,1990,84,57,27
1822,39,78,1990,5,4,1
1823,39,13,1990,67,32,35
1824,39,3,1990,241,163,78
1825,39,79,1990,17,6,11
1826,39,29,1990,125,92,33
1827,39,67,1990,727,394,333
1828,39,95,1990,5,4,1
1829,39,151,1990,14,5,9
1830,39,4,1990,7,1,6
1831,39,53,1990,16411,8067,8344
1832,39,147,1990,34,19,15
1833,39,105,1990,765,481,284
1834,39,30,1990,224,125,99
1835,39,152,1990,2,1,1
1836,39,116,1990,23,13,10
1837,39,153,1990,5,1,4
1838,39,135,1990,31,13,18
1839,39,136,1990,1,0,1
1840,39,106,1990,1070,532,538
1841,39,172,1990,1301,664,637
1842,39,173,1990,492,246,246
1843,39,174,1990,5,3,2
1844,39,107,1990,807,386,421
1845,39,117,1990,18,5,13
1846,39,137,1990,31,17,14
1847,39,96,1990,42,10,32
1848,39,54,1990,504,241,263
1849,39,81,1990,34,14,20
1850,39,14,1990,111,66,45
1851,39,31,1990,189,121,68
1852,39,176,1990,163,100,63
1853,39,137,1990,70,27,43
1854,39,118,1990,14,6,8
1855,39,82,1990,4,2,2
1856,39,83,1990,35,23,12
1857,39,108,1990,159,92,67
1858,39,142,1990,869,288,581
1859,39,97,1990,25,14,11
1860,39,138,1990,0,0,0
1861,39,119,1990,73,41,32
1862,39,40,1990,7,3,4
1863,39,148,1990,37,14,23
1864,39,120,1990,559,209,350
1865,39,41,1990,6430,3982,2448
1866,39,42,1990,3180,2079,1101
1867,39,68,1990,2451,1223,1228
1868,39,109,1990,5,2,3
1869,39,139,1990,5,2,3
1870,39,155,1990,236,65,171
1871,39,15,1990,72,37,35
1872,39,69,1990,22533,12799,9734
1873,39,156,1990,391,116,275
1874,39,56,1990,738,203,535
1875,39,84,1990,3,3,0
1876,39,98,1990,22,11,11
1877,39,157,1990,21,5,16
1878,39,158,1990,9,0,9
1879,39,110,1990,73,50,23
1880,39,85,1990,50,22,28
1881,39,99,1990,34,23,11
1882,39,32,1990,1210,542,668
1883,39,43,1990,2986,1620,1366
1884,39,5,1990,2604,1443,1161
1885,39,6,1990,8022,2548,5474
1886,39,16,1990,2418,715,1703
1887,39,44,1990,895,386,509
1888,39,17,1990,1048,339,709
1889,39,57,1990,2203,633,1570
1890,39,86,1990,74,42,32
1891,39,177,1990,935,582,353
1892,39,18,1990,579,216,363
1893,39,167,1990,38,29,9
1894,39,121,1990,609,320,289
1895,39,19,1990,96,41,55
1896,39,168,1990,2,1,1
1897,39,46,1990,15,9,6
1898,39,20,1990,7758,3127,4631
1899,39,149,1990,31,20,11
1900,39,159,1990,50,30,20
1901,39,143,1990,71,25,46
1902,39,70,1990,10,5,5
1903,39,47,1990,13,8,5
1904,39,71,1990,64,32,32
1905,39,122,1990,14,4,10
1906,39,123,1990,38,19,19
1907,39,7,1990,3,2,1
1908,39,160,1990,5,1,4
1909,39,58,1990,48,21,27
1910,39,161,1990,4,2,2
1911,39,124,1990,83,42,41
1912,39,100,1990,239,142,97
1913,39,72,1990,5,2,3
1914,39,59,1990,1900,903,997
1915,39,144,1990,3004,1180,1824
1916,39,125,1990,65,27,38
1917,39,150,1990,10,7,3
1918,39,8,1990,37,14,23
1919,39,73,1990,2389,1095,1294
1920,39,101,1990,36,19,17
1921,39,162,1990,219,100,119
1922,39,60,1990,1151,565,586
1923,39,48,1990,12613,7865,4748
1924,39,21,1990,1,1,0
1925,39,9,1990,6946,2997,3949
1926,39,102,1990,25,11,14
1927,39,111,1990,28,15,13
1928,39,112,1990,245,142,103
1929,39,33,1990,8085,5050,3035
1930,39,61,1990,441,213,228
1931,39,88,1990,5,3,2
1932,39,22,1990,5,3,2
1933,39,35,1990,877,449,428
1934,39,36,1990,1595,1009,586
1935,39,126,1990,11,5,6
1936,39,90,1990,0,0,0
1937,39,91,1990,3,1,2
1938,39,92,1990,8,1,7
1939,39,62,1990,1,1,0
1940,39,140,1990,0,0,0
1941,39,23,1990,48,23,25
1942,39,164,1990,35,11,24
1943,39,63,1990,5700,2707,2993
1944,39,127,1990,14,10,4
1945,39,165,1990,72,21,51
1946,39,37,1990,105,65,40
1947,39,64,1990,56,32,24
1948,39,128,1990,584,198,386
1949,39,115,1990,604,304,300
1950,39,129,1990,0,0,0
1951,39,65,1990,1525,704,821
1952,39,10,1990,5014,2091,2923
1953,39,145,1990,74,16,58
1954,39,113,1990,20,8,12
1955,39,49,1990,15641,9381,6260
1956,39,74,1990,1388,715,673
1957,39,25,1990,538,256,282
1958,39,169,1990,6,4,2
1959,39,166,1990,32,7,25
1960,39,93,1990,100,51,49
1961,39,146,1990,410,76,334
1962,39,26,1990,19476,8951,10525
1963,39,170,1990,4,3,1
1964,39,130,1990,269,151,118
1965,39,38,1990,605,374,231
1966,39,27,1990,56,18,38
1967,39,50,1990,9126,3971,5155
1968,39,131,1990,439,218,221
1969,39,114,1990,164,81,83
1970,39,171,1990,37,25,12
1971,39,1,1990,5087,2146,2941
1972,39,28,1990,73,32,41
1973,39,132,1990,175,99,76
1974,39,133,1990,149,70,79
1975,118,120,1990,13405,7494,5911
1976,118,128,1990,101216,47098,54118
1977,118,28,1990,289,150,139
1978,82,76,1990,184,87,97
1979,82,78,1990,5,3,2
1980,82,79,1990,61,28,33
1981,82,172,1990,14,5,9
1982,82,81,1990,5,5,0
1983,82,68,1990,29,10,19
1984,82,109,1990,8,7,1
1985,82,69,1990,11,7,4
1986,82,110,1990,69,31,38
1987,82,85,1990,561,287,274
1988,82,5,1990,10,4,6
1989,82,86,1990,47,31,16
1990,82,20,1990,12,3,9
1991,82,87,1990,59,28,31
1992,82,73,1990,4,2,2
1993,82,77,1990,17,11,6
1994,82,162,1990,18,11,7
1995,82,88,1990,6,1,5
1996,82,90,1990,23,14,9
1997,82,75,1990,7,2,5
1998,82,91,1990,102,51,51
1999,82,92,1990,45,20,25
2000,82,113,1990,7,3,4
2001,82,25,1990,6,2,4
2002,82,93,1990,111,46,65
2003,82,50,1990,230,112,118
2004,83,76,1990,266,132,134
2005,83,103,1990,2642,1096,1546
2006,83,66,1990,965,155,810
2007,83,78,1990,91,52,39
2008,83,13,1990,21,3,18
2009,83,67,1990,490,187,303
2010,83,4,1990,9,0,9
2011,83,53,1990,6,0,6
2012,83,105,1990,950,508,442
2013,83,30,1990,357,152,205
2014,83,116,1990,3,3,0
2015,83,135,1990,3,0,3
2016,83,153,1990,3,3,0
2017,83,136,1990,3,0,3
2018,83,106,1990,1891,654,1237
2019,83,172,1990,3613,1552,2061
2020,83,107,1990,4697,2247,2450
2021,83,96,1990,1552,924,628
2022,83,81,1990,6824,2924,3900
2023,83,31,1990,12,6,6
2024,83,39,1990,70,11,59
2025,83,82,1990,24,6,18
2026,83,108,1990,950,511,439
2027,83,97,1990,366,175,191
2028,83,42,1990,45,14,31
2029,83,68,1990,2524,953,1571
2030,83,69,1990,5084,2003,3081
2031,83,56,1990,94,32,62
2032,83,98,1990,475,138,337
2033,83,110,1990,45,14,31
2034,83,85,1990,187210,64417,122793
2035,83,99,1990,433,207,226
2036,83,32,1990,51,20,31
2037,83,5,1990,287,126,161
2038,83,6,1990,70,6,64
2039,83,16,1990,6,0,6
2040,83,44,1990,51,23,28
2041,83,17,1990,185,37,148
2042,83,57,1990,6960,1991,4969
2043,83,86,1990,421,138,283
2044,83,177,1990,1256,565,691
2045,83,167,1990,3,0,3
2046,83,20,1990,717,267,450
2047,83,58,1990,33,20,13
2048,83,100,1990,1737,964,773
2049,83,144,1990,21,9,12
2050,83,73,1990,578,166,412
2051,83,77,1990,330,158,172
2052,83,101,1990,415,207,208
2053,83,162,1990,42,9,33
2054,83,48,1990,67,23,44
2055,83,9,1990,166,26,140
2056,83,102,1990,699,301,398
2057,83,111,1990,61,20,41
2058,83,112,1990,1991,789,1202
2059,83,33,1990,475,405,70
2060,83,61,1990,160,49,111
2061,83,88,1990,8767,4649,4118
2062,83,35,1990,30,14,16
2063,83,36,1990,287,172,115
2064,83,90,1990,76,20,56
2065,83,75,1990,139,57,82
2066,83,23,1990,24,0,24
2067,83,63,1990,180,70,110
2068,83,115,1990,242,98,144
2069,83,65,1990,7354,2611,4743
2070,83,113,1990,103,66,37
2071,83,49,1990,369,284,85
2072,83,74,1990,2140,758,1382
2073,83,25,1990,76,32,44
2074,83,93,1990,100,46,54
2075,83,26,1990,73,34,39
2076,83,94,1990,3,0,3
2077,83,38,1990,121,72,49
2078,83,60,1990,6,0,6
2079,83,50,1990,581,201,380
2080,83,114,1990,1625,958,667
2081,108,2,1990,18,7,11
2082,108,51,1990,8,4,4
2083,108,141,1990,16,4,12
2084,108,134,1990,14,9,5
2085,108,103,1990,1669,705,964
2086,108,66,1990,182,80,102
2087,108,78,1990,16,7,9
2088,108,11,1990,13,6,7
2089,108,67,1990,285,140,145
2090,108,105,1990,968,553,415
2091,108,30,1990,65,35,30
2092,108,135,1990,15,5,10
2093,108,106,1990,5302,2452,2850
2094,108,172,1990,654,264,390
2095,108,107,1990,40238,21832,18406
2096,108,96,1990,313,168,145
2097,108,54,1990,27,10,17
2098,108,81,1990,998,447,551
2099,108,31,1990,105,29,76
2100,108,39,1990,61,19,42
2101,108,83,1990,118,66,52
2102,108,97,1990,174,92,82
2103,108,42,1990,43,27,16
2104,108,68,1990,686,334,352
2105,108,155,1990,11,2,9
2106,108,69,1990,1397,654,743
2107,108,156,1990,13,4,9
2108,108,56,1990,24,5,19
2109,108,98,1990,144,74,70
2110,108,85,1990,32,10,22
2111,108,99,1990,157,86,71
2112,108,173,1990,33,14,19
2113,108,32,1990,72,44,28
2114,108,5,1990,76,25,51
2115,108,6,1990,64,19,45
2116,108,16,1990,12,1,11
2117,108,44,1990,67,28,39
2118,108,17,1990,174,67,107
2119,108,57,1990,1252,500,752
2120,108,86,1990,13,7,6
2121,108,177,1990,245,103,142
2122,108,18,1990,24,5,19
2123,108,176,1990,162,73,89
2124,108,20,1990,148,52,96
2125,108,100,1990,656,360,296
2126,108,144,1990,16,6,10
2127,108,73,1990,276,122,154
2128,108,101,1990,131,64,67
2129,108,162,1990,17,1,16
2130,108,48,1990,79,40,39
2131,108,9,1990,18,2,16
2132,108,102,1990,321,157,164
2133,108,111,1990,81,38,43
2134,108,112,1990,2567,1260,1307
2135,108,33,1990,104,52,52
2136,108,61,1990,122,46,76
2137,108,88,1990,167,81,86
2138,108,35,1990,101,56,45
2139,108,36,1990,498,318,180
2140,108,23,1990,30,11,19
2141,108,37,1990,17,9,8
2142,108,1,1990,16,7,9
2143,108,115,1990,41,12,29
2144,108,65,1990,2013,965,1048
2145,108,49,1990,117,55,62
2146,108,74,1990,654,222,432
2147,108,25,1990,22,6,16
2148,108,93,1990,15,9,6
2149,108,38,1990,134,76,58
2150,108,60,1990,29,10,19
2151,108,142,1990,28,9,19
2152,108,50,1990,719,338,381
2153,108,114,1990,320,119,201
2154,142,2,1990,237,43,194
2155,142,51,1990,111,37,74
2156,142,141,1990,543,360,183
2157,142,134,1990,23,11,12
2158,142,76,1990,14,7,7
2159,142,12,1990,24,2,22
2160,142,103,1990,322,128,194
2161,142,66,1990,716,386,330
2162,142,78,1990,11,10,1
2163,142,13,1990,382,229,153
2164,142,3,1990,112,23,89
2165,142,11,1990,179,115,64
2166,142,67,1990,672,335,337
2167,142,53,1990,23,11,12
2168,142,105,1990,137,82,55
2169,142,30,1990,71,36,35
2170,142,116,1990,47,5,42
2171,142,29,1990,246,141,105
2172,142,135,1990,135,17,118
2173,142,10,1990,249,98,151
2174,142,136,1990,305,107,198
2175,142,106,1990,21,13,8
2176,142,172,1990,479,85,394
2177,142,107,1990,65,6,59
2178,142,117,1990,431,50,381
2179,142,137,1990,26,3,23
2180,142,137,1990,99,37,62
2181,142,54,1990,124,16,108
2182,142,14,1990,98,45,53
2183,142,31,1990,250,136,114
2184,142,151,1990,46,2,44
2185,142,39,1990,279,139,140
2186,142,108,1990,9,7,2
2187,142,97,1990,160,95,65
2188,142,120,1990,567,340,227
2189,142,119,1990,358,178,180
2190,142,40,1990,14,6,8
2191,142,42,1990,189,117,72
2192,142,68,1990,3089,1425,1664
2193,142,118,1990,243,92,151
2194,142,155,1990,36,7,29
2195,142,69,1990,9692,4394,5298
2196,142,156,1990,214,46,168
2197,142,55,1990,7,3,4
2198,142,56,1990,1306,746,560
2199,142,98,1990,7,5,2
2200,142,157,1990,182,10,172
2201,142,32,1990,123,66,57
2202,142,5,1990,801,314,487
2203,142,6,1990,134,61,73
2204,142,16,1990,1359,870,489
2205,142,44,1990,111,66,45
2206,142,17,1990,995,410,585
2207,142,57,1990,4657,2122,2535
2208,142,177,1990,1455,704,751
2209,142,167,1990,142,92,50
2210,142,18,1990,3386,1618,1768
2211,142,121,1990,131,30,101
2212,142,176,1990,117,48,69
2213,142,19,1990,2103,892,1211
2214,142,168,1990,48,11,37
2215,142,20,1990,2317,1301,1016
2216,142,159,1990,40,3,37
2217,142,143,1990,2936,1325,1611
2218,142,122,1990,48,0,48
2219,142,123,1990,23,5,18
2220,142,7,1990,4,0,4
2221,142,160,1990,241,46,195
2222,142,161,1990,152,37,115
2223,142,100,1990,71,46,25
2224,142,72,1990,62,33,29
2225,142,144,1990,527,396,131
2226,142,125,1990,14,6,8
2227,142,21,1990,436,165,271
2228,142,150,1990,379,255,124
2229,142,73,1990,1068,511,557
2230,142,162,1990,586,114,472
2231,142,48,1990,106,39,67
2232,142,9,1990,387,115,272
2233,142,33,1990,407,171,236
2234,142,61,1990,44,24,20
2235,142,158,1990,70,2,68
2236,142,22,1990,287,128,159
2237,142,35,1990,226,107,119
2238,142,36,1990,9311,6105,3206
2239,142,126,1990,59,13,46
2240,142,23,1990,4546,1719,2827
2241,142,164,1990,384,75,309
2242,142,127,1990,15,6,9
2243,142,165,1990,41,27,14
2244,142,37,1990,71,40,31
2245,142,128,1990,1372,730,642
2246,142,115,1990,190,80,110
2247,142,133,1990,38,7,31
2248,142,65,1990,449,208,241
2249,142,129,1990,0,0,0
2250,142,145,1990,15184,6900,8284
2251,142,49,1990,358,154,204
2252,142,74,1990,1775,839,936
2253,142,25,1990,5259,2441,2818
2254,142,169,1990,47,7,40
2255,142,27,1990,464,162,302
2256,142,146,1990,495,253,242
2257,142,26,1990,770,174,596
2258,142,170,1990,21,2,19
2259,142,130,1990,91,10,81
2260,142,38,1990,67,32,35
2261,142,60,1990,147,58,89
2262,142,50,1990,3051,1333,1718
2263,142,131,1990,156,27,129
2264,142,152,1990,67,3,64
2265,142,171,1990,85,19,66
2266,142,28,1990,3839,1642,2197
2267,142,132,1990,26,8,18
2268,97,103,1990,255,112,143
2269,97,66,1990,18,11,7
2270,97,3,1990,11,0,11
2271,97,79,1990,64,33,31
2272,97,67,1990,95,47,48
2273,97,105,1990,329,203,126
2274,97,95,1990,244,131,113
2275,97,106,1990,380,208,172
2276,97,172,1990,260,92,168
2277,97,107,1990,386,225,161
2278,97,96,1990,1558,799,759
2279,97,81,1990,84,40,44
2280,97,83,1990,38,20,18
2281,97,108,1990,155,85,70
2282,97,68,1990,200,109,91
2283,97,69,1990,464,185,279
2284,97,98,1990,8235,4496,3739
2285,97,99,1990,15774,8869,6905
2286,97,173,1990,13,7,6
2287,97,5,1990,18,7,11
2288,97,6,1990,20,7,13
2289,97,44,1990,24,9,15
2290,97,17,1990,177,91,86
2291,97,57,1990,391,116,275
2292,97,86,1990,16,7,9
2293,97,177,1990,40,9,31
2294,97,100,1990,2457,1362,1095
2295,97,73,1990,71,24,47
2296,97,101,1990,3893,2121,1772
2297,97,102,1990,557,297,260
2298,97,111,1990,36,18,18
2299,97,112,1990,246,111,135
2300,97,61,1990,20,5,15
2301,97,88,1990,109,54,55
2302,97,36,1990,29,16,13
2303,97,65,1990,855,357,498
2304,97,49,1990,33,16,17
2305,97,74,1990,87,33,54
2306,97,50,1990,135,49,86
2307,97,114,1990,120,45,75
2308,138,135,1990,202,69,133
2309,138,68,1990,1154,643,511
2310,138,139,1990,65,29,36
2311,138,162,1990,91,43,48
2312,138,140,1990,378,152,226
2313,138,65,1990,324,135,189
2314,119,134,1990,247,109,138
2315,119,116,1990,618,312,306
2316,119,172,1990,8,6,2
2317,119,117,1990,27,21,6
2318,119,137,1990,407,172,235
2319,119,120,1990,1284,616,668
2320,119,68,1990,108,56,52
2321,119,5,1990,39,17,22
2322,119,121,1990,187,62,125
2323,119,123,1990,114,75,39
2324,119,125,1990,3537,1724,1813
2325,119,126,1990,991,451,540
2326,119,128,1990,1438,697,741
2327,119,115,1990,97,37,60
2328,119,133,1990,82,26,56
2329,119,129,1990,933,439,494
2330,119,145,1990,131,62,69
2331,119,130,1990,175,66,109
2332,119,50,1990,34,20,14
2333,119,131,1990,218,105,113
2334,119,132,1990,91,34,57
2335,40,2,1990,0,0,0
2336,40,51,1990,0,0,0
2337,40,141,1990,0,0,0
2338,40,52,1990,0,0,0
2339,40,134,1990,0,0,0
2340,40,76,1990,0,0,0
2341,40,103,1990,0,0,0
2342,40,11,1990,715,240,475
2343,40,66,1990,0,0,0
2344,40,12,1990,2211,853,1358
2345,40,13,1990,0,0,0
2346,40,3,1990,0,0,0
2347,40,79,1990,0,0,0
2348,40,29,1990,23870,12527,11343
2349,40,67,1990,0,0,0
2350,40,95,1990,0,0,0
2351,40,151,1990,0,0,0
2352,40,4,1990,0,0,0
2353,40,53,1990,0,0,0
2354,40,105,1990,0,0,0
2355,40,30,1990,0,0,0
2356,40,153,1990,0,0,0
2357,40,135,1990,0,0,0
2358,40,106,1990,0,0,0
2359,40,172,1990,59,31,28
2360,40,173,1990,0,0,0
2361,40,107,1990,0,0,0
2362,40,137,1990,0,0,0
2363,40,96,1990,0,0,0
2364,40,54,1990,0,0,0
2365,40,81,1990,0,0,0
2366,40,14,1990,0,0,0
2367,40,31,1990,0,0,0
2368,40,176,1990,0,0,0
2369,40,137,1990,0,0,0
2370,40,39,1990,25,8,17
2371,40,83,1990,0,0,0
2372,40,108,1990,0,0,0
2373,40,142,1990,0,0,0
2374,40,97,1990,0,0,0
2375,40,120,1990,0,0,0
2376,40,41,1990,0,0,0
2377,40,42,1990,651,304,347
2378,40,68,1990,42,23,19
2379,40,155,1990,0,0,0
2380,40,15,1990,2196,1064,1132
2381,40,69,1990,461,231,230
2382,40,156,1990,0,0,0
2383,40,55,1990,0,0,0
2384,40,56,1990,0,0,0
2385,40,98,1990,0,0,0
2386,40,157,1990,0,0,0
2387,40,110,1990,0,0,0
2388,40,99,1990,0,0,0
2389,40,32,1990,36,18,18
2390,40,43,1990,0,0,0
2391,40,5,1990,25,9,16
2392,40,6,1990,0,0,0
2393,40,16,1990,0,0,0
2394,40,44,1990,0,0,0
2395,40,17,1990,0,0,0
2396,40,57,1990,0,0,0
2397,40,86,1990,0,0,0
2398,40,177,1990,0,0,0
2399,40,18,1990,0,0,0
2400,40,167,1990,7616,3841,3775
2401,40,121,1990,0,0,0
2402,40,19,1990,0,0,0
2403,40,168,1990,1120,545,575
2404,40,46,1990,6102,3283,2819
2405,40,20,1990,0,0,0
2406,40,143,1990,0,0,0
2407,40,70,1990,0,0,0
2408,40,47,1990,3195,1570,1625
2409,40,71,1990,0,0,0
2410,40,122,1990,0,0,0
2411,40,123,1990,0,0,0
2412,40,58,1990,0,0,0
2413,40,161,1990,0,0,0
2414,40,124,1990,0,0,0
2415,40,100,1990,0,0,0
2416,40,72,1990,0,0,0
2417,40,59,1990,0,0,0
2418,40,144,1990,0,0,0
2419,40,125,1990,0,0,0
2420,40,150,1990,0,0,0
2421,40,8,1990,0,0,0
2422,40,73,1990,0,0,0
2423,40,101,1990,0,0,0
2424,40,162,1990,0,0,0
2425,40,60,1990,0,0,0
2426,40,48,1990,0,0,0
2427,40,21,1990,0,0,0
2428,40,9,1990,0,0,0
2429,40,102,1990,0,0,0
2430,40,111,1990,0,0,0
2431,40,112,1990,0,0,0
2432,40,33,1990,236,144,92
2433,40,61,1990,0,0,0
2434,40,22,1990,0,0,0
2435,40,35,1990,0,0,0
2436,40,36,1990,283457,162473,120984
2437,40,126,1990,0,0,0
2438,40,90,1990,0,0,0
2439,40,23,1990,0,0,0
2440,40,164,1990,0,0,0
2441,40,63,1990,0,0,0
2442,40,165,1990,0,0,0
2443,40,37,1990,0,0,0
2444,40,64,1990,0,0,0
2445,40,128,1990,0,0,0
2446,40,115,1990,0,0,0
2447,40,65,1990,0,0,0
2448,40,10,1990,0,0,0
2449,40,145,1990,0,0,0
2450,40,113,1990,0,0,0
2451,40,49,1990,90,39,51
2452,40,74,1990,0,0,0
2453,40,25,1990,0,0,0
2454,40,169,1990,853,422,431
2455,40,166,1990,0,0,0
2456,40,93,1990,0,0,0
2457,40,146,1990,0,0,0
2458,40,26,1990,0,0,0
2459,40,170,1990,996,519,477
2460,40,130,1990,0,0,0
2461,40,38,1990,43063,20061,23002
2462,40,27,1990,0,0,0
2463,40,50,1990,31,11,20
2464,40,131,1990,0,0,0
2465,40,114,1990,0,0,0
2466,40,171,1990,2614,1112,1502
2467,40,1,1990,0,0,0
2468,40,28,1990,0,0,0
2469,40,132,1990,0,0,0
2470,40,133,1990,0,0,0
2471,148,134,1990,4,1,3
2472,148,147,1990,161,70,91
2473,148,116,1990,7,3,4
2474,148,137,1990,1,0,1
2475,148,137,1990,6,2,4
2476,148,120,1990,0,0,0
2477,148,149,1990,293,115,178
2478,148,159,1990,2,1,1
2479,148,125,1990,46196,20308,25888
2480,148,126,1990,2,0,2
2481,148,128,1990,2,0,2
2482,148,115,1990,20848,10945,9903
2483,148,130,1990,1,0,1
2484,120,116,1990,19,9,10
2485,120,137,1990,48,23,25
2486,120,119,1990,69681,33056,36625
2487,120,118,1990,904,429,475
2488,120,126,1990,71,34,37
2489,120,128,1990,616940,292671,324269
2490,120,129,1990,384266,182292,201974
2491,120,145,1990,53857,25549,28308
2492,120,130,1990,103,49,54
2493,120,28,1990,68,32,36
2494,41,105,1990,6,2,4
2495,41,30,1990,0,0,0
2496,41,172,1990,1,0,1
2497,41,107,1990,22,10,12
2498,41,54,1990,1,0,1
2499,41,39,1990,3173,1321,1852
2500,41,120,1990,0,0,0
2501,41,69,1990,27,14,13
2502,41,156,1990,1,0,1
2503,41,43,1990,267,117,150
2504,41,5,1990,14,8,6
2505,41,121,1990,2,0,2
2506,41,47,1990,0,0,0
2507,41,48,1990,151,68,83
2508,41,112,1990,0,0,0
2509,41,33,1990,23,14,9
2510,41,35,1990,1,0,1
2511,41,36,1990,2,2,0
2512,41,63,1990,0,0,0
2513,41,115,1990,1,0,1
2514,41,49,1990,56,23,33
2515,41,146,1990,9,1,8
2516,41,50,1990,139,63,76
2517,42,2,1990,4,0,4
2518,42,51,1990,0,0,0
2519,42,141,1990,233,17,216
2520,42,52,1990,1,0,1
2521,42,134,1990,4,2,2
2522,42,76,1990,0,0,0
2523,42,103,1990,107,49,58
2524,42,11,1990,0,0,0
2525,42,77,1990,0,0,0
2526,42,66,1990,253,105,148
2527,42,12,1990,0,0,0
2528,42,78,1990,1,1,0
2529,42,13,1990,2,1,1
2530,42,3,1990,115,22,93
2531,42,79,1990,4,0,4
2532,42,29,1990,0,0,0
2533,42,67,1990,114,53,61
2534,42,95,1990,0,0,0
2535,42,151,1990,1,0,1
2536,42,4,1990,0,0,0
2537,42,53,1990,0,0,0
2538,42,147,1990,1,0,1
2539,42,105,1990,162,92,70
2540,42,30,1990,274,114,160
2541,42,152,1990,0,0,0
2542,42,116,1990,3,0,3
2543,42,153,1990,2,0,2
2544,42,135,1990,6,4,2
2545,42,136,1990,1,0,1
2546,42,106,1990,166,81,85
2547,42,172,1990,428,175,253
2548,42,107,1990,132,66,66
2549,42,117,1990,1,0,1
2550,42,137,1990,12,7,5
2551,42,96,1990,10,4,6
2552,42,54,1990,0,0,0
2553,42,81,1990,22,9,13
2554,42,14,1990,42,8,34
2555,42,31,1990,260,131,129
2556,42,176,1990,3,2,1
2557,42,137,1990,10,1,9
2558,42,39,1990,559,242,317
2559,42,118,1990,0,0,0
2560,42,82,1990,0,0,0
2561,42,83,1990,10,2,8
2562,42,108,1990,24,11,13
2563,42,142,1990,209,23,186
2564,42,97,1990,4,1,3
2565,42,138,1990,0,0,0
2566,42,119,1990,0,0,0
2567,42,40,1990,0,0,0
2568,42,148,1990,0,0,0
2569,42,120,1990,203,94,109
2570,42,68,1990,538,221,317
2571,42,139,1990,0,0,0
2572,42,155,1990,22,2,20
2573,42,15,1990,0,0,0
2574,42,69,1990,2586,1051,1535
2575,42,156,1990,74,17,57
2576,42,56,1990,320,49,271
2577,42,84,1990,0,0,0
2578,42,98,1990,16,4,12
2579,42,157,1990,6,1,5
2580,42,158,1990,0,0,0
2581,42,110,1990,8,2,6
2582,42,85,1990,0,0,0
2583,42,99,1990,5,3,2
2584,42,32,1990,554,264,290
2585,42,43,1990,79,37,42
2586,42,5,1990,549,180,369
2587,42,6,1990,558,180,378
2588,42,16,1990,206,73,133
2589,42,44,1990,88,27,61
2590,42,17,1990,350,111,239
2591,42,57,1990,504,119,385
2592,42,86,1990,21,5,16
2593,42,177,1990,372,151,221
2594,42,18,1990,58,4,54
2595,42,167,1990,0,0,0
2596,42,121,1990,98,39,59
2597,42,19,1990,17,5,12
2598,42,168,1990,0,0,0
2599,42,46,1990,0,0,0
2600,42,20,1990,142,34,108
2601,42,159,1990,4,1,3
2602,42,143,1990,29,2,27
2603,42,47,1990,0,0,0
2604,42,71,1990,19,9,10
2605,42,122,1990,0,0,0
2606,42,123,1990,2,0,2
2607,42,7,1990,1,0,1
2608,42,160,1990,3,0,3
2609,42,58,1990,8,1,7
2610,42,161,1990,0,0,0
2611,42,124,1990,13,8,5
2612,42,100,1990,67,26,41
2613,42,72,1990,1,0,1
2614,42,59,1990,0,0,0
2615,42,144,1990,412,22,390
2616,42,125,1990,6,2,4
2617,42,150,1990,51,26,25
2618,42,8,1990,16,12,4
2619,42,73,1990,414,106,308
2620,42,101,1990,5,2,3
2621,42,162,1990,94,15,79
2622,42,60,1990,0,0,0
2623,42,48,1990,904,489,415
2624,42,21,1990,2,0,2
2625,42,9,1990,139,25,114
2626,42,102,1990,10,4,6
2627,42,111,1990,7,3,4
2628,42,112,1990,88,56,32
2629,42,33,1990,1027,554,473
2630,42,61,1990,92,33,59
2631,42,22,1990,3,2,1
2632,42,35,1990,157,53,104
2633,42,36,1990,1945,1177,768
2634,42,126,1990,2,1,1
2635,42,90,1990,0,0,0
2636,42,91,1990,0,0,0
2637,42,92,1990,1,0,1
2638,42,62,1990,0,0,0
2639,42,23,1990,17,2,15
2640,42,164,1990,15,2,13
2641,42,63,1990,0,0,0
2642,42,127,1990,0,0,0
2643,42,165,1990,21,2,19
2644,42,37,1990,0,0,0
2645,42,64,1990,0,0,0
2646,42,128,1990,54,13,41
2647,42,115,1990,115,64,51
2648,42,129,1990,0,0,0
2649,42,65,1990,502,181,321
2650,42,10,1990,159,86,73
2651,42,145,1990,0,0,0
2652,42,113,1990,0,0,0
2653,42,49,1990,26043,13111,12932
2654,42,74,1990,434,194,240
2655,42,25,1990,49,11,38
2656,42,169,1990,0,0,0
2657,42,166,1990,3,0,3
2658,42,93,1990,7,5,2
2659,42,146,1990,163,14,149
2660,42,26,1990,457,72,385
2661,42,170,1990,0,0,0
2662,42,94,1990,0,0,0
2663,42,130,1990,10,2,8
2664,42,38,1990,0,0,0
2665,42,27,1990,14,3,11
2666,42,50,1990,1738,619,1119
2667,42,131,1990,86,29,57
2668,42,114,1990,34,12,22
2669,42,171,1990,0,0,0
2670,42,1,1990,1645,775,870
2671,42,28,1990,4,2,2
2672,42,132,1990,45,21,24
2673,42,133,1990,10,3,7
2674,68,2,1990,3346,1437,1909
2675,68,51,1990,3391,1534,1857
2676,68,141,1990,788914,342465,446449
2677,68,52,1990,1233,670,563
2678,68,134,1990,11499,4952,6547
2679,68,75,1990,8,3,5
2680,68,76,1990,19,14,5
2681,68,103,1990,10137,5545,4592
2682,68,11,1990,6547,3557,2990
2683,68,77,1990,10,5,5
2684,68,66,1990,11675,7675,4000
2685,68,12,1990,400,197,203
2686,68,78,1990,64,38,26
2687,68,13,1990,55,28,27
2688,68,3,1990,2198,766,1432
2689,68,79,1990,42,23,19
2690,68,29,1990,1126,674,452
2691,68,67,1990,127976,73638,54338
2692,68,95,1990,7,5,2
2693,68,151,1990,11476,5151,6325
2694,68,4,1990,240,89,151
2695,68,53,1990,8357,4155,4202
2696,68,147,1990,182,96,86
2697,68,105,1990,20435,12014,8421
2698,68,30,1990,9404,5201,4203
2699,68,152,1990,3831,1728,2103
2700,68,116,1990,1344,731,613
2701,68,153,1990,16358,8712,7646
2702,68,135,1990,36846,19495,17351
2703,68,136,1990,2554,1094,1460
2704,68,106,1990,13207,6706,6501
2705,68,172,1990,41681,22036,19645
2706,68,173,1990,2227,1200,1027
2707,68,174,1990,111,56,55
2708,68,107,1990,15050,8321,6729
2709,68,117,1990,18859,9613,9246
2710,68,137,1990,48395,22542,25853
2711,68,96,1990,421,229,192
2712,68,54,1990,10463,4864,5599
2713,68,81,1990,2031,1170,861
2714,68,14,1990,1073,545,528
2715,68,31,1990,11542,6961,4581
2716,68,176,1990,99,60,39
2717,68,137,1990,32512,15988,16524
2718,68,39,1990,6772,4202,2570
2719,68,118,1990,3050,1427,1623
2720,68,82,1990,744,480,264
2721,68,83,1990,454,293,161
2722,68,108,1990,1585,987,598
2723,68,142,1990,22453,7869,14584
2724,68,97,1990,999,579,420
2725,68,138,1990,144,80,64
2726,68,119,1990,160,100,60
2727,68,40,1990,828,506,322
2728,68,148,1990,8,5,3
2729,68,120,1990,3850,2336,1514
2730,68,41,1990,4,3,1
2731,68,42,1990,4412,3208,1204
2732,68,139,1990,7939,4102,3837
2733,68,155,1990,1329,629,700
2734,68,15,1990,1337,678,659
2735,68,69,1990,171594,104509,67085
2736,68,156,1990,5576,2616,2960
2737,68,55,1990,63,42,21
2738,68,56,1990,13918,7059,6859
2739,68,98,1990,1614,817,797
2740,68,157,1990,7816,3402,4414
2741,68,158,1990,8060,3271,4789
2742,68,110,1990,30,18,12
2743,68,85,1990,26253,14381,11872
2744,68,99,1990,482,278,204
2745,68,32,1990,13404,6230,7174
2746,68,43,1990,396,241,155
2747,68,5,1990,25817,13142,12675
2748,68,6,1990,23359,10521,12838
2749,68,16,1990,4614,1933,2681
2750,68,44,1990,6702,4160,2542
2751,68,45,1990,12,9,3
2752,68,17,1990,5866,2902,2964
2753,68,57,1990,521793,262880,258913
2754,68,86,1990,463,278,185
2755,68,177,1990,18064,11354,6710
2756,68,18,1990,940,301,639
2757,68,167,1990,436,245,191
2758,68,121,1990,947,632,315
2759,68,19,1990,680,266,414
2760,68,168,1990,103,68,35
2761,68,46,1990,1310,712,598
2762,68,20,1990,38599,15935,22664
2763,68,149,1990,10,4,6
2764,68,159,1990,803,310,493
2765,68,143,1990,1354,625,729
2766,68,70,1990,103,47,56
2767,68,47,1990,1547,880,667
2768,68,71,1990,8016,4583,3433
2769,68,122,1990,38740,22741,15999
2770,68,123,1990,77,38,39
2771,68,7,1990,4,1,3
2772,68,160,1990,49299,17373,31926
2773,68,58,1990,910,493,417
2774,68,161,1990,11287,3484,7803
2775,68,124,1990,38101,22210,15891
2776,68,100,1990,6305,3866,2439
2777,68,72,1990,3282,1605,1677
2778,68,59,1990,949,448,501
2779,68,87,1990,5,5,0
2780,68,144,1990,713987,321416,392571
2781,68,125,1990,1048,565,483
2782,68,150,1990,104,54,50
2783,68,8,1990,707,371,336
2784,68,73,1990,34420,18607,15813
2785,68,101,1990,489,310,179
2786,68,162,1990,2710,1200,1510
2787,68,60,1990,74534,36416,38118
2788,68,48,1990,3257,2077,1180
2789,68,21,1990,21,8,13
2790,68,9,1990,15579,5750,9829
2791,68,102,1990,358,205,153
2792,68,111,1990,755,408,347
2793,68,112,1990,7906,4556,3350
2794,68,33,1990,135061,87056,48005
2795,68,61,1990,781382,375984,405398
2796,68,88,1990,290,141,149
2797,68,22,1990,151,80,71
2798,68,35,1990,31928,16392,15536
2799,68,36,1990,21377,14057,7320
2800,68,126,1990,3150,1670,1480
2801,68,90,1990,5,4,1
2802,68,91,1990,155,103,52
2803,68,92,1990,93,65,28
2804,68,62,1990,248,118,130
2805,68,140,1990,127,73,54
2806,68,23,1990,1246,553,693
2807,68,164,1990,73801,30550,43251
2808,68,63,1990,1898,896,1002
2809,68,127,1990,429,297,132
2810,68,165,1990,713,363,350
2811,68,37,1990,2771,1589,1182
2812,68,64,1990,3354,1814,1540
2813,68,128,1990,1485,743,742
2814,68,115,1990,2397,1381,1016
2815,68,65,1990,433748,234867,198881
2816,68,10,1990,33041,14967,18074
2817,68,145,1990,1132,420,712
2818,68,113,1990,267,150,117
2819,68,49,1990,10606,7110,3496
2820,68,74,1990,60882,34323,26559
2821,68,25,1990,13644,5487,8157
2822,68,169,1990,30,16,14
2823,68,166,1990,14522,6603,7919
2824,68,93,1990,269,186,83
2825,68,146,1990,276216,115852,160364
2826,68,26,1990,241148,111970,129178
2827,68,170,1990,217,118,99
2828,68,94,1990,7,4,3
2829,68,130,1990,421,240,181
2830,68,38,1990,7869,5116,2753
2831,68,27,1990,266,113,153
2832,68,50,1990,102335,53433,48902
2833,68,131,1990,629,351,278
2834,68,114,1990,2065,1088,977
2835,68,171,1990,303,168,135
2836,68,1,1990,99095,51567,47528
2837,68,28,1990,911,481,430
2838,68,132,1990,275,146,129
2839,68,133,1990,386,210,176
2840,109,141,1990,95,45,50
2841,109,67,1990,75,35,40
2842,109,105,1990,6204,2893,3311
2843,109,172,1990,961,447,514
2844,109,82,1990,443,290,153
2845,109,68,1990,15361,6278,9083
2846,109,110,1990,2242,1045,1197
2847,109,85,1990,9605,4479,5126
2848,109,57,1990,108,50,58
2849,109,112,1990,309,144,165
2850,109,91,1990,1722,802,920
2851,109,113,1990,15289,7129,8160
2852,139,141,1990,34,14,20
2853,139,134,1990,342,140,202
2854,139,67,1990,154,70,84
2855,139,116,1990,52,21,31
2856,139,135,1990,15661,7896,7765
2857,139,136,1990,1398,557,841
2858,139,172,1990,107,31,76
2859,139,137,1990,5045,2707,2338
2860,139,137,1990,2754,1271,1483
2861,139,151,1990,16141,7999,8142
2862,139,138,1990,26892,13665,13227
2863,139,68,1990,4969,2163,2806
2864,139,69,1990,27,12,15
2865,139,156,1990,1968,290,1678
2866,139,157,1990,1539,403,1136
2867,139,17,1990,5,2,3
2868,139,177,1990,10,5,5
2869,139,176,1990,50,20,30
2870,139,20,1990,773,237,536
2871,139,160,1990,17055,6136,10919
2872,139,144,1990,221,112,109
2873,139,162,1990,7392,2035,5357
2874,139,126,1990,65,32,33
2875,139,140,1990,2012,1072,940
2876,139,164,1990,9431,1925,7506
2877,139,115,1990,4,0,4
2878,139,25,1990,9,4,5
2879,139,166,1990,7116,3590,3526
2880,139,146,1990,69,31,38
2881,139,152,1990,2161,862,1299
2882,155,157,1990,24859,9725,15134
2883,155,159,1990,153,67,86
2884,155,160,1990,5697,1944,3753
2885,155,161,1990,2005,276,1729
2886,155,158,1990,7591,3639,3952
2887,155,164,1990,72943,34269,38674
2888,155,165,1990,1435,623,812
2889,15,2,1990,0,0,0
2890,15,51,1990,0,0,0
2891,15,141,1990,0,0,0
2892,15,12,1990,7911,4269,3642
2893,15,103,1990,0,0,0
2894,15,66,1990,0,0,0
2895,15,11,1990,4039,2212,1827
2896,15,67,1990,0,0,0
2897,15,30,1990,0,0,0
2898,15,29,1990,16521,9360,7161
2899,15,172,1990,421,235,186
2900,15,81,1990,0,0,0
2901,15,31,1990,0,0,0
2902,15,40,1990,846,469,377
2903,15,42,1990,0,0,0
2904,15,68,1990,0,0,0
2905,15,69,1990,8348,4631,3717
2906,15,56,1990,0,0,0
2907,15,32,1990,0,0,0
2908,15,5,1990,0,0,0
2909,15,6,1990,0,0,0
2910,15,17,1990,0,0,0
2911,15,57,1990,0,0,0
2912,15,167,1990,21017,11773,9244
2913,15,168,1990,3360,1884,1476
2914,15,20,1990,0,0,0
2915,15,46,1990,1382,770,612
2916,15,47,1990,3623,2016,1607
2917,15,8,1990,0,0,0
2918,15,73,1990,0,0,0
2919,15,9,1990,0,0,0
2920,15,112,1990,0,0,0
2921,15,33,1990,3794,2329,1465
2922,15,35,1990,390,210,180
2923,15,36,1990,151090,87707,63383
2924,15,65,1990,0,0,0
2925,15,74,1990,0,0,0
2926,15,169,1990,3306,1849,1457
2927,15,26,1990,455,245,210
2928,15,170,1990,1609,885,724
2929,15,38,1990,46581,26194,20387
2930,15,50,1990,0,0,0
2931,15,171,1990,10078,5555,4523
2932,69,2,1990,33279,12037,21242
2933,69,51,1990,5211,760,4451
2934,69,141,1990,8493,2078,6415
2935,69,134,1990,0,0,0
2936,69,103,1990,4499,2290,2209
2937,69,11,1990,5581,2352,3229
2938,69,66,1990,189349,80952,108397
2939,69,12,1990,600,275,325
2940,69,3,1990,4767,394,4373
2941,69,29,1990,1190,753,437
2942,69,67,1990,21902,10807,11095
2943,69,151,1990,610,107,503
2944,69,53,1990,108349,49533,58816
2945,69,105,1990,11446,6856,4590
2946,69,30,1990,27077,11868,15209
2947,69,152,1990,563,88,475
2948,69,116,1990,233,60,173
2949,69,135,1990,2178,528,1650
2950,69,136,1990,265,30,235
2951,69,106,1990,6888,3380,3508
2952,69,172,1990,19834,5537,14297
2953,69,107,1990,4218,2350,1868
2954,69,137,1990,351,52,299
2955,69,96,1990,516,285,231
2956,69,54,1990,150313,72278,78035
2957,69,81,1990,2734,901,1833
2958,69,14,1990,328,109,219
2959,69,31,1990,315481,158368,157113
2960,69,176,1990,1277,557,720
2961,69,137,1990,4459,1184,3275
2962,69,39,1990,16667,9955,6712
2963,69,83,1990,1012,709,303
2964,69,108,1990,1252,689,563
2965,69,142,1990,10932,2631,8301
2966,69,97,1990,524,252,272
2967,69,119,1990,2815,1186,1629
2968,69,40,1990,1467,694,773
2969,69,120,1990,19612,7435,12177
2970,69,42,1990,11251,8337,2914
2971,69,68,1990,89386,45852,43534
2972,69,139,1990,123,27,96
2973,69,155,1990,1908,99,1809
2974,69,15,1990,1410,857,553
2975,69,156,1990,20822,6064,14758
2976,69,56,1990,337546,148924,188622
2977,69,98,1990,583,306,277
2978,69,157,1990,697,136,561
2979,69,85,1990,292,119,173
2980,69,99,1990,438,273,165
2981,69,32,1990,55562,20426,35136
2982,69,43,1990,1239,604,635
2983,69,5,1990,31877,8299,23578
2984,69,6,1990,95723,32395,63328
2985,69,16,1990,6844,1643,5201
2986,69,44,1990,12186,5728,6458
2987,69,17,1990,9659,3829,5830
2988,69,57,1990,486516,182859,303657
2989,69,86,1990,701,387,314
2990,69,177,1990,24560,11744,12816
2991,69,18,1990,12527,3296,9231
2992,69,167,1990,10199,5219,4980
2993,69,121,1990,1361,663,698
2994,69,168,1990,199,102,97
2995,69,46,1990,3143,1922,1221
2996,69,20,1990,45648,16414,29234
2997,69,159,1990,2666,803,1863
2998,69,143,1990,1438,362,1076
2999,69,70,1990,35,19,16
3000,69,47,1990,2386,1589,797
3001,69,71,1990,5470,2299,3171
3002,69,122,1990,430,191,239
3003,69,160,1990,634,109,525
3004,69,58,1990,246,130,116
3005,69,100,1990,3437,2184,1253
3006,69,59,1990,30932,14271,16661
3007,69,144,1990,72631,27951,44680
3008,69,8,1990,867,263,604
3009,69,73,1990,116092,52928,63164
3010,69,101,1990,653,317,336
3011,69,162,1990,13230,3186,10044
3012,69,60,1990,35938,15658,20280
3013,69,48,1990,6286,3388,2898
3014,69,9,1990,26620,4926,21694
3015,69,102,1990,207,83,124
3016,69,111,1990,636,327,309
3017,69,112,1990,4288,2366,1922
3018,69,33,1990,412581,215682,196899
3019,69,61,1990,92782,42208,50574
3020,69,35,1990,176920,83547,93373
3021,69,36,1990,77318,39319,37999
3022,69,126,1990,324,78,246
3023,69,23,1990,1003,330,673
3024,69,164,1990,1771,88,1683
3025,69,63,1990,428334,190197,238137
3026,69,165,1990,1002,251,751
3027,69,37,1990,16278,7557,8721
3028,69,64,1990,12999,5638,7361
3029,69,128,1990,5957,1099,4858
3030,69,115,1990,4059,2267,1792
3031,69,65,1990,142457,60169,82288
3032,69,10,1990,38618,10195,28423
3033,69,145,1990,0,0,0
3034,69,49,1990,13195,7752,5443
3035,69,74,1990,33253,18201,15052
3036,69,25,1990,15330,4742,10588
3037,69,169,1990,236,99,137
3038,69,166,1990,1693,359,1334
3039,69,93,1990,354,200,154
3040,69,146,1990,27234,10004,17230
3041,69,26,1990,1459167,663588,795579
3042,69,170,1990,28,12,16
3043,69,130,1990,1013,354,659
3044,69,38,1990,16108,8679,7429
3045,69,50,1990,103961,43759,60202
3046,69,131,1990,816,280,536
3047,69,114,1990,830,408,422
3048,69,171,1990,2864,1420,1444
3049,69,1,1990,69594,29263,40331
3050,69,28,1990,991,185,806
3051,69,132,1990,303,87,216
3052,156,141,1990,7,2,5
3053,156,105,1990,7,4,3
3054,156,135,1990,61,23,38
3055,156,10,1990,15,7,8
3056,156,136,1990,8,2,6
3057,156,172,1990,121,22,99
3058,156,137,1990,16,9,7
3059,156,151,1990,8959,4476,4483
3060,156,120,1990,16,9,7
3061,156,68,1990,117,55,62
3062,156,155,1990,19,7,12
3063,156,157,1990,74,30,44
3064,156,5,1990,454,196,258
3065,156,17,1990,24,12,12
3066,156,57,1990,123,53,70
3067,156,177,1990,30,12,18
3068,156,121,1990,8,2,6
3069,156,20,1990,525,228,297
3070,156,159,1990,9824,4528,5296
3071,156,160,1990,3592,1065,2527
3072,156,161,1990,9,3,6
3073,156,73,1990,131,58,73
3074,156,162,1990,14876,7004,7872
3075,156,9,1990,47,22,25
3076,156,33,1990,34,18,16
3077,156,36,1990,47,27,20
3078,156,126,1990,268,174,94
3079,156,164,1990,53,20,33
3080,156,165,1990,119,57,62
3081,156,145,1990,18,4,14
3082,156,74,1990,104,46,58
3083,156,25,1990,37,17,20
3084,156,166,1990,61553,34105,27448
3085,156,142,1990,21,10,11
3086,156,50,1990,972,503,469
3087,156,131,1990,6,3,3
3088,156,152,1990,41668,18937,22731
3089,55,144,1990,2021,483,1538
3090,55,65,1990,2392,1727,665
3091,55,50,1990,3025,1438,1587
3092,56,2,1990,621,119,502
3093,56,51,1990,63963,20993,42970
3094,56,141,1990,203,39,164
3095,56,52,1990,6,3,3
3096,56,134,1990,20,9,11
3097,56,75,1990,6,3,3
3098,56,76,1990,12,6,6
3099,56,103,1990,641,331,310
3100,56,11,1990,12148,5420,6728
3101,56,77,1990,41,18,23
3102,56,66,1990,3523,2154,1369
3103,56,12,1990,171,77,94
3104,56,78,1990,21,9,12
3105,56,13,1990,5,2,3
3106,56,3,1990,7665,3420,4245
3107,56,79,1990,6,3,3
3108,56,29,1990,592,265,327
3109,56,67,1990,5284,2980,2304
3110,56,95,1990,5,2,3
3111,56,151,1990,5,2,3
3112,56,4,1990,6,3,3
3113,56,53,1990,487,218,269
3114,56,147,1990,3,2,1
3115,56,105,1990,1460,755,705
3116,56,30,1990,7509,1848,5661
3117,56,152,1990,5,2,3
3118,56,116,1990,44,20,24
3119,56,153,1990,32,14,18
3120,56,135,1990,188,84,104
3121,56,80,1990,15,8,7
3122,56,136,1990,18,9,9
3123,56,106,1990,783,322,461
3124,56,172,1990,329,95,234
3125,56,173,1990,30,14,16
3126,56,107,1990,442,422,20
3127,56,117,1990,0,0,0
3128,56,137,1990,35,33,2
3129,56,96,1990,26,11,15
3130,56,54,1990,466,209,257
3131,56,81,1990,194,87,107
3132,56,14,1990,45588,21588,24000
3133,56,31,1990,2296,1388,908
3134,56,176,1990,541,0,541
3135,56,137,1990,657,251,406
3136,56,39,1990,1836,1358,478
3137,56,118,1990,3,2,1
3138,56,82,1990,410,183,227
3139,56,83,1990,218,98,120
3140,56,108,1990,51,23,28
3141,56,142,1990,12485,3494,8991
3142,56,97,1990,18,9,9
3143,56,138,1990,2,0,2
3144,56,119,1990,137,62,75
3145,56,40,1990,146,65,81
3146,56,148,1990,6,3,3
3147,56,120,1990,3422,1529,1893
3148,56,41,1990,3,2,1
3149,56,42,1990,1528,992,536
3150,56,68,1990,10626,6344,4282
3151,56,109,1990,2,0,2
3152,56,139,1990,18,9,9
3153,56,155,1990,59,27,32
3154,56,15,1990,36031,16076,19955
3155,56,69,1990,26527,14891,11636
3156,56,156,1990,633,283,350
3157,56,55,1990,12,6,6
3158,56,84,1990,2,0,2
3159,56,98,1990,41,18,23
3160,56,157,1990,11,5,6
3161,56,158,1990,3,2,1
3162,56,110,1990,14,6,8
3163,56,85,1990,143,63,80
3164,56,99,1990,62,27,35
3165,56,32,1990,905,722,183
3166,56,43,1990,39,18,21
3167,56,5,1990,5351,1219,4132
3168,56,6,1990,2645,1027,1618
3169,56,16,1990,6631,2276,4355
3170,56,44,1990,1042,664,378
3171,56,45,1990,18,9,9
3172,56,17,1990,1413,628,785
3173,56,57,1990,12933,6698,6235
3174,56,86,1990,72,32,40
3175,56,177,1990,1185,654,531
3176,56,18,1990,2473,320,2153
3177,56,167,1990,3531,1576,1955
3178,56,121,1990,480,92,388
3179,56,19,1990,29,12,17
3180,56,168,1990,74,33,41
3181,56,46,1990,75,33,42
3182,56,20,1990,5775,2196,3579
3183,56,149,1990,3,2,1
3184,56,159,1990,35,15,20
3185,56,143,1990,1123,293,830
3186,56,70,1990,12,6,6
3187,56,47,1990,293,131,162
3188,56,71,1990,146,93,53
3189,56,122,1990,63,29,34
3190,56,7,1990,8,3,5
3191,56,160,1990,15,8,7
3192,56,58,1990,227,101,126
3193,56,161,1990,3,2,1
3194,56,124,1990,45,20,25
3195,56,100,1990,379,242,137
3196,56,72,1990,11,5,6
3197,56,87,1990,2,0,2
3198,56,144,1990,762,340,422
3199,56,125,1990,39,18,21
3200,56,150,1990,8,3,5
3201,56,8,1990,29,12,17
3202,56,73,1990,5508,3378,2130
3203,56,101,1990,41,18,23
3204,56,162,1990,1565,352,1213
3205,56,60,1990,4152,1852,2300
3206,56,48,1990,958,459,499
3207,56,21,1990,3,2,1
3208,56,9,1990,5947,1294,4653
3209,56,102,1990,286,128,158
3210,56,111,1990,72,32,40
3211,56,112,1990,209,93,116
3212,56,33,1990,29946,17916,12030
3213,56,61,1990,731,389,342
3214,56,88,1990,18,9,9
3215,56,22,1990,6,3,3
3216,56,35,1990,5983,3043,2940
3217,56,36,1990,28345,12646,15699
3218,56,126,1990,174,78,96
3219,56,90,1990,6,3,3
3220,56,92,1990,92,41,51
3221,56,62,1990,9,5,4
3222,56,140,1990,3,2,1
3223,56,23,1990,532,232,300
3224,56,164,1990,81,36,45
3225,56,63,1990,0,0,0
3226,56,127,1990,41,18,23
3227,56,165,1990,436,194,242
3228,56,37,1990,699,311,388
3229,56,64,1990,104,47,57
3230,56,128,1990,44,20,24
3231,56,115,1990,1755,855,900
3232,56,65,1990,2586,1473,1113
3233,56,10,1990,1344,600,744
3234,56,145,1990,1141,182,959
3235,56,113,1990,2,0,2
3236,56,49,1990,3364,2162,1202
3237,56,74,1990,2747,1299,1448
3238,56,25,1990,6547,1481,5066
3239,56,169,1990,15,8,7
3240,56,166,1990,11,5,6
3241,56,93,1990,9,5,4
3242,56,146,1990,529,239,290
3243,56,26,1990,34502,17140,17362
3244,56,170,1990,40196,17934,22262
3245,56,130,1990,107,48,59
3246,56,38,1990,189,84,105
3247,56,27,1990,17,8,9
3248,56,50,1990,34223,20108,14115
3249,56,131,1990,268,119,149
3250,56,114,1990,56,26,30
3251,56,171,1990,1284,573,711
3252,56,1,1990,713,251,462
3253,56,28,1990,69,0,69
3254,56,132,1990,189,45,144
3255,56,133,1990,61,24,37
3256,84,76,1990,22,11,11
3257,84,78,1990,17,9,8
3258,84,79,1990,101,51,50
3259,84,82,1990,42,21,21
3260,84,110,1990,324,164,160
3261,84,86,1990,65,33,32
3262,84,87,1990,6,3,3
3263,84,90,1990,9,4,5
3264,84,91,1990,92,47,45
3265,84,92,1990,325,164,161
3266,84,93,1990,1647,834,813
3267,98,103,1990,285,163,122
3268,98,105,1990,77,61,16
3269,98,95,1990,543,362,181
3270,98,106,1990,271,179,92
3271,98,172,1990,307,174,133
3272,98,107,1990,490,338,152
3273,98,96,1990,758,554,204
3274,98,81,1990,275,174,101
3275,98,83,1990,59,46,13
3276,98,108,1990,120,74,46
3277,98,97,1990,236655,132597,104058
3278,98,68,1990,294,175,119
3279,98,109,1990,13,9,4
3280,98,69,1990,476,321,155
3281,98,85,1990,26,19,7
3282,98,99,1990,4768,3778,990
3283,98,6,1990,12,7,5
3284,98,17,1990,58,27,31
3285,98,57,1990,325,150,175
3286,98,177,1990,84,48,36
3287,98,20,1990,27,13,14
3288,98,100,1990,5402,3844,1558
3289,98,73,1990,83,37,46
3290,98,101,1990,3726,2625,1101
3291,98,9,1990,17,12,5
3292,98,102,1990,242,175,67
3293,98,111,1990,72,37,35
3294,98,112,1990,210,133,77
3295,98,61,1990,14,7,7
3296,98,88,1990,69,44,25
3297,98,23,1990,27,20,7
3298,98,65,1990,944,538,406
3299,98,49,1990,27,19,8
3300,98,74,1990,151,85,66
3301,98,25,1990,52,24,28
3302,98,26,1990,16,13,3
3303,98,142,1990,22,18,4
3304,98,50,1990,125,78,47
3305,98,114,1990,95,49,46
3306,157,2,1990,0,0,0
3307,157,51,1990,0,0,0
3308,157,141,1990,0,0,0
3309,157,52,1990,0,0,0
3310,157,134,1990,0,0,0
3311,157,76,1990,0,0,0
3312,157,12,1990,0,0,0
3313,157,103,1990,0,0,0
3314,157,66,1990,0,0,0
3315,157,78,1990,0,0,0
3316,157,13,1990,0,0,0
3317,157,3,1990,0,0,0
3318,157,11,1990,0,0,0
3319,157,79,1990,0,0,0
3320,157,67,1990,207,85,122
3321,157,4,1990,0,0,0
3322,157,53,1990,0,0,0
3323,157,147,1990,0,0,0
3324,157,105,1990,248,95,153
3325,157,95,1990,0,0,0
3326,157,30,1990,0,0,0
3327,157,116,1990,0,0,0
3328,157,135,1990,0,0,0
3329,157,153,1990,98,47,51
3330,157,10,1990,0,0,0
3331,157,136,1990,0,0,0
3332,157,106,1990,0,0,0
3333,157,172,1990,134,32,102
3334,157,107,1990,0,0,0
3335,157,117,1990,0,0,0
3336,157,137,1990,0,0,0
3337,157,137,1990,0,0,0
3338,157,96,1990,0,0,0
3339,157,54,1990,0,0,0
3340,157,81,1990,61,32,29
3341,157,151,1990,2351,1079,1272
3342,157,39,1990,0,0,0
3343,157,82,1990,0,0,0
3344,157,83,1990,0,0,0
3345,157,108,1990,0,0,0
3346,157,97,1990,0,0,0
3347,157,138,1990,0,0,0
3348,157,120,1990,0,0,0
3349,157,119,1990,0,0,0
3350,157,42,1990,0,0,0
3351,157,68,1990,1642,683,959
3352,157,118,1990,0,0,0
3353,157,139,1990,0,0,0
3354,157,155,1990,811,321,490
3355,157,69,1990,849,428,421
3356,157,156,1990,0,0,0
3357,157,85,1990,0,0,0
3358,157,99,1990,0,0,0
3359,157,5,1990,0,0,0
3360,157,17,1990,0,0,0
3361,157,57,1990,102,17,85
3362,157,177,1990,27,15,12
3363,157,18,1990,0,0,0
3364,157,121,1990,0,0,0
3365,157,176,1990,0,0,0
3366,157,20,1990,0,0,0
3367,157,149,1990,0,0,0
3368,157,46,1990,0,0,0
3369,157,159,1990,342691,174919,167772
3370,157,143,1990,0,0,0
3371,157,70,1990,0,0,0
3372,157,122,1990,0,0,0
3373,157,123,1990,0,0,0
3374,157,160,1990,15549,7199,8350
3375,157,161,1990,384,133,251
3376,157,124,1990,0,0,0
3377,157,144,1990,0,0,0
3378,157,125,1990,0,0,0
3379,157,150,1990,0,0,0
3380,157,8,1990,0,0,0
3381,157,73,1990,0,0,0
3382,157,101,1990,0,0,0
3383,157,162,1990,910,240,670
3384,157,48,1990,0,0,0
3385,157,9,1990,0,0,0
3386,157,33,1990,0,0,0
3387,157,61,1990,237,121,116
3388,157,158,1990,2798,1315,1483
3389,157,35,1990,0,0,0
3390,157,36,1990,478,180,298
3391,157,126,1990,0,0,0
3392,157,92,1990,0,0,0
3393,157,140,1990,0,0,0
3394,157,23,1990,682,333,349
3395,157,164,1990,6770,2306,4464
3396,157,63,1990,0,0,0
3397,157,127,1990,0,0,0
3398,157,165,1990,15985,8556,7429
3399,157,1,1990,0,0,0
3400,157,64,1990,0,0,0
3401,157,128,1990,0,0,0
3402,157,115,1990,0,0,0
3403,157,133,1990,0,0,0
3404,157,65,1990,59,32,27
3405,157,129,1990,0,0,0
3406,157,145,1990,0,0,0
3407,157,148,1990,0,0,0
3408,157,49,1990,0,0,0
3409,157,74,1990,0,0,0
3410,157,25,1990,30,7,23
3411,157,169,1990,0,0,0
3412,157,166,1990,1468,514,954
3413,157,146,1990,0,0,0
3414,157,26,1990,0,0,0
3415,157,130,1990,0,0,0
3416,157,38,1990,84,45,39
3417,157,142,1990,0,0,0
3418,157,50,1990,0,0,0
3419,157,131,1990,0,0,0
3420,157,152,1990,479,178,301
3421,157,114,1990,0,0,0
3422,157,171,1990,0,0,0
3423,158,153,1990,355,225,130
3424,158,68,1990,71,22,49
3425,158,155,1990,960,499,461
3426,158,157,1990,3170,1478,1692
3427,158,159,1990,3906,1539,2367
3428,158,161,1990,359,186,173
3429,158,61,1990,528,241,287
3430,158,164,1990,5053,2981,2072
3431,158,165,1990,87,28,59
3432,110,76,1990,5,3,2
3433,110,78,1990,4,2,2
3434,110,79,1990,156,76,80
3435,110,105,1990,485,193,292
3436,110,172,1990,263,109,154
3437,110,82,1990,13,5,8
3438,110,84,1990,54,25,29
3439,110,86,1990,83,39,44
3440,110,91,1990,286,120,166
3441,110,92,1990,103,48,55
3442,110,113,1990,1047,522,525
3443,110,93,1990,189,86,103
3444,110,50,1990,131,60,71
3445,85,103,1990,466,199,267
3446,85,66,1990,170,28,142
3447,85,106,1990,333,119,214
3448,85,172,1990,348,147,201
3449,85,107,1990,828,407,421
3450,85,96,1990,274,168,106
3451,85,81,1990,1203,530,673
3452,85,83,1990,2406,1061,1345
3453,85,68,1990,445,173,272
3454,85,69,1990,896,363,533
3455,85,57,1990,1227,361,866
3456,85,177,1990,221,102,119
3457,85,100,1990,306,175,131
3458,85,112,1990,351,143,208
3459,85,88,1990,1546,843,703
3460,85,65,1990,1297,473,824
3461,85,74,1990,377,137,240
3462,85,114,1990,286,174,112
3463,99,103,1990,145,61,84
3464,99,67,1990,19,6,13
3465,99,105,1990,179,102,77
3466,99,95,1990,213,97,116
3467,99,80,1990,68,32,36
3468,99,106,1990,273,130,143
3469,99,172,1990,394,139,255
3470,99,107,1990,409,172,237
3471,99,96,1990,594,266,328
3472,99,81,1990,464,142,322
3473,99,83,1990,103,37,66
3474,99,108,1990,348,109,239
3475,99,97,1990,114810,59413,55397
3476,99,68,1990,109,45,64
3477,99,69,1990,223,74,149
3478,99,98,1990,3250,1537,1713
3479,99,85,1990,34,5,29
3480,99,17,1990,68,23,45
3481,99,57,1990,198,48,150
3482,99,86,1990,20,4,16
3483,99,177,1990,106,46,60
3484,99,18,1990,31,14,17
3485,99,176,1990,48,14,34
3486,99,100,1990,795,386,409
3487,99,73,1990,69,20,49
3488,99,101,1990,142802,68004,74798
3489,99,102,1990,190,79,111
3490,99,111,1990,27,11,16
3491,99,112,1990,291,120,171
3492,99,88,1990,98,36,62
3493,99,36,1990,19,8,11
3494,99,65,1990,371,154,217
3495,99,49,1990,23,11,12
3496,99,74,1990,47,13,34
3497,99,50,1990,78,23,55
3498,99,114,1990,51,18,33
3499,173,3,1990,297,103,194
3500,173,172,1990,1659157,738516,920641
3501,173,174,1990,57222,27648,29574
3502,173,68,1990,1470,472,998
3503,173,69,1990,1323,333,990
3504,173,5,1990,12064,5778,6286
3505,173,44,1990,466,184,282
3506,173,57,1990,430,151,279
3507,173,177,1990,9505,4295,5210
3508,173,8,1990,6254,2979,3275
3509,173,73,1990,683,226,457
3510,173,9,1990,5062,1910,3152
3511,173,61,1990,73,38,35
3512,173,36,1990,59,46,13
3513,173,65,1990,269,125,144
3514,173,10,1990,524,316,208
3515,173,74,1990,487,137,350
3516,173,50,1990,11838,4180,7658
3517,173,1,1990,7324,4206,3118
3518,32,2,1990,274,152,122
3519,32,51,1990,96,62,34
3520,32,141,1990,263,11,252
3521,32,52,1990,0,0,0
3522,32,134,1990,32,4,28
3523,32,76,1990,0,0,0
3524,32,103,1990,22,12,10
3525,32,11,1990,186,100,86
3526,32,77,1990,0,0,0
3527,32,66,1990,5206,2893,2313
3528,32,12,1990,134,69,65
3529,32,78,1990,1,0,1
3530,32,13,1990,13,5,8
3531,32,3,1990,60,8,52
3532,32,79,1990,0,0,0
3533,32,29,1990,91,45,46
3534,32,67,1990,98,55,43
3535,32,95,1990,0,0,0
3536,32,151,1990,11,0,11
3537,32,4,1990,0,0,0
3538,32,53,1990,381,154,227
3539,32,147,1990,1,0,1
3540,32,105,1990,68,42,26
3541,32,30,1990,1962,1090,872
3542,32,152,1990,0,0,0
3543,32,116,1990,0,0,0
3544,32,153,1990,0,0,0
3545,32,135,1990,6,0,6
3546,32,80,1990,0,0,0
3547,32,136,1990,2,0,2
3548,32,106,1990,112,42,70
3549,32,172,1990,941,522,419
3550,32,107,1990,33,13,20
3551,32,117,1990,0,0,0
3552,32,137,1990,18,0,18
3553,32,96,1990,8,1,7
3554,32,54,1990,365,203,162
3555,32,81,1990,252,166,86
3556,32,14,1990,387,133,254
3557,32,31,1990,68,51,17
3558,32,176,1990,0,0,0
3559,32,137,1990,11,4,7
3560,32,39,1990,42,24,18
3561,32,118,1990,0,0,0
3562,32,82,1990,0,0,0
3563,32,83,1990,0,0,0
3564,32,108,1990,22,8,14
3565,32,142,1990,251,31,220
3566,32,97,1990,12,5,7
3567,32,138,1990,0,0,0
3568,32,119,1990,0,0,0
3569,32,40,1990,39,27,12
3570,32,148,1990,0,0,0
3571,32,120,1990,31,5,26
3572,32,41,1990,0,0,0
3573,32,42,1990,92,51,41
3574,32,68,1990,1793,996,797
3575,32,139,1990,0,0,0
3576,32,155,1990,0,0,0
3577,32,15,1990,186,84,102
3578,32,69,1990,18409,10230,8179
3579,32,156,1990,44,7,37
3580,32,56,1990,1601,889,712
3581,32,84,1990,1,0,1
3582,32,98,1990,6,4,2
3583,32,157,1990,15,0,15
3584,32,158,1990,5,0,5
3585,32,110,1990,5,1,4
3586,32,85,1990,0,0,0
3587,32,99,1990,2,0,2
3588,32,43,1990,8,6,2
3589,32,5,1990,978,337,641
3590,32,6,1990,1800,675,1125
3591,32,16,1990,732,228,504
3592,32,44,1990,26,14,12
3593,32,17,1990,425,236,189
3594,32,57,1990,389,216,173
3595,32,86,1990,4,1,3
3596,32,177,1990,271,151,120
3597,32,18,1990,350,86,264
3598,32,167,1990,469,240,229
3599,32,121,1990,18,7,11
3600,32,19,1990,154,51,103
3601,32,168,1990,116,89,27
3602,32,46,1990,21,18,3
3603,32,20,1990,304,69,235
3604,32,149,1990,0,0,0
3605,32,159,1990,1,0,1
3606,32,143,1990,332,184,148
3607,32,70,1990,0,0,0
3608,32,47,1990,42,21,21
3609,32,71,1990,4,2,2
3610,32,122,1990,8,1,7
3611,32,123,1990,0,0,0
3612,32,160,1990,8,2,6
3613,32,58,1990,0,0,0
3614,32,161,1990,9,5,4
3615,32,124,1990,21,12,9
3616,32,100,1990,20,9,11
3617,32,72,1990,0,0,0
3618,32,59,1990,0,0,0
3619,32,144,1990,38,5,33
3620,32,125,1990,12,1,11
3621,32,150,1990,0,0,0
3622,32,8,1990,0,0,0
3623,32,73,1990,181,101,80
3624,32,101,1990,8,2,6
3625,32,162,1990,169,28,141
3626,32,60,1990,46027,25576,20451
3627,32,48,1990,118,65,53
3628,32,21,1990,14,10,4
3629,32,9,1990,205,67,138
3630,32,102,1990,8,1,7
3631,32,111,1990,5,1,4
3632,32,112,1990,72,24,48
3633,32,33,1990,3647,2027,1620
3634,32,61,1990,21,12,9
3635,32,22,1990,30,12,18
3636,32,35,1990,194128,107876,86252
3637,32,36,1990,38081,21162,16919
3638,32,126,1990,1,0,1
3639,32,90,1990,12,9,3
3640,32,91,1990,0,0,0
3641,32,92,1990,0,0,0
3642,32,62,1990,0,0,0
3643,32,23,1990,286,76,210
3644,32,164,1990,5,1,4
3645,32,63,1990,0,0,0
3646,32,127,1990,0,0,0
3647,32,165,1990,6,1,5
3648,32,37,1990,316,176,140
3649,32,64,1990,96,43,53
3650,32,128,1990,5,1,4
3651,32,115,1990,44,19,25
3652,32,65,1990,54,30,24
3653,32,10,1990,47,19,28
3654,32,145,1990,72,9,63
3655,32,113,1990,0,0,0
3656,32,49,1990,262,146,116
3657,32,74,1990,145,81,64
3658,32,25,1990,482,268,214
3659,32,169,1990,16,7,9
3660,32,166,1990,2,0,2
3661,32,93,1990,0,0,0
3662,32,146,1990,34,5,29
3663,32,26,1990,385,214,171
3664,32,170,1990,0,0,0
3665,32,130,1990,6,0,6
3666,32,38,1990,3040,1689,1351
3667,32,27,1990,0,0,0
3668,32,50,1990,521,290,231
3669,32,131,1990,28,4,24
3670,32,114,1990,60,33,27
3671,32,171,1990,102,58,44
3672,32,1,1990,653,363,290
3673,32,28,1990,241,69,172
3674,32,132,1990,2,2,0
3675,32,133,1990,9,6,3
3676,43,2,1990,1,0,1
3677,43,51,1990,10,7,3
3678,43,141,1990,10,2,8
3679,43,52,1990,0,0,0
3680,43,134,1990,10,4,6
3681,43,76,1990,0,0,0
3682,43,103,1990,5,1,4
3683,43,11,1990,2,1,1
3684,43,77,1990,0,0,0
3685,43,66,1990,52,28,24
3686,43,12,1990,2,1,1
3687,43,78,1990,1,1,0
3688,43,13,1990,0,0,0
3689,43,3,1990,0,0,0
3690,43,79,1990,0,0,0
3691,43,29,1990,0,0,0
3692,43,67,1990,34,19,15
3693,43,95,1990,0,0,0
3694,43,151,1990,0,0,0
3695,43,53,1990,9,4,5
3696,43,105,1990,11,7,4
3697,43,30,1990,18,10,8
3698,43,152,1990,0,0,0
3699,43,153,1990,19,10,9
3700,43,135,1990,1,0,1
3701,43,136,1990,0,0,0
3702,43,106,1990,15,6,9
3703,43,172,1990,58,32,26
3704,43,107,1990,21,12,9
3705,43,137,1990,0,0,0
3706,43,96,1990,3,1,2
3707,43,54,1990,6,3,3
3708,43,81,1990,7,3,4
3709,43,14,1990,1,0,1
3710,43,31,1990,43,26,17
3711,43,176,1990,0,0,0
3712,43,137,1990,1,0,1
3713,43,39,1990,2048,1161,887
3714,43,118,1990,0,0,0
3715,43,82,1990,0,0,0
3716,43,83,1990,2,2,0
3717,43,108,1990,7,4,3
3718,43,142,1990,8,2,6
3719,43,97,1990,0,0,0
3720,43,138,1990,1,1,0
3721,43,119,1990,0,0,0
3722,43,40,1990,0,0,0
3723,43,120,1990,13,7,6
3724,43,41,1990,237,145,92
3725,43,42,1990,75,53,22
3726,43,68,1990,135,71,64
3727,43,139,1990,0,0,0
3728,43,155,1990,2,1,1
3729,43,15,1990,2,1,1
3730,43,69,1990,803,552,251
3731,43,156,1990,10,4,6
3732,43,55,1990,0,0,0
3733,43,56,1990,5,2,3
3734,43,98,1990,14,6,8
3735,43,157,1990,3,1,2
3736,43,158,1990,0,0,0
3737,43,110,1990,7,4,3
3738,43,85,1990,1,1,0
3739,43,99,1990,7,1,6
3740,43,32,1990,35,21,14
3741,43,5,1990,62,36,26
3742,43,6,1990,14,3,11
3743,43,16,1990,2,1,1
3744,43,44,1990,81,39,42
3745,43,17,1990,20,7,13
3746,43,57,1990,38,17,21
3747,43,86,1990,5,3,2
3748,43,177,1990,17,12,5
3749,43,18,1990,0,0,0
3750,43,167,1990,0,0,0
3751,43,121,1990,10,6,4
3752,43,19,1990,0,0,0
3753,43,168,1990,0,0,0
3754,43,46,1990,0,0,0
3755,43,20,1990,14,4,10
3756,43,159,1990,0,0,0
3757,43,143,1990,0,0,0
3758,43,70,1990,0,0,0
3759,43,47,1990,0,0,0
3760,43,71,1990,53,27,26
3761,43,122,1990,0,0,0
3762,43,123,1990,0,0,0
3763,43,160,1990,0,0,0
3764,43,58,1990,0,0,0
3765,43,161,1990,0,0,0
3766,43,124,1990,3,2,1
3767,43,100,1990,10,7,3
3768,43,72,1990,0,0,0
3769,43,59,1990,0,0,0
3770,43,144,1990,21,6,15
3771,43,125,1990,4,3,1
3772,43,150,1990,10,5,5
3773,43,8,1990,8,2,6
3774,43,73,1990,112,66,46
3775,43,101,1990,1,1,0
3776,43,162,1990,3,1,2
3777,43,60,1990,7,3,4
3778,43,48,1990,683,395,288
3779,43,21,1990,0,0,0
3780,43,9,1990,8,3,5
3781,43,102,1990,1,1,0
3782,43,111,1990,1,1,0
3783,43,112,1990,20,12,8
3784,43,33,1990,265,152,113
3785,43,61,1990,45,17,28
3786,43,88,1990,0,0,0
3787,43,22,1990,1,1,0
3788,43,35,1990,1,0,1
3789,43,36,1990,37,22,15
3790,43,126,1990,0,0,0
3791,43,92,1990,0,0,0
3792,43,62,1990,0,0,0
3793,43,23,1990,1,1,0
3794,43,164,1990,3,1,2
3795,43,63,1990,312,139,173
3796,43,165,1990,5,2,3
3797,43,37,1990,1,1,0
3798,43,64,1990,8,3,5
3799,43,128,1990,0,0,0
3800,43,115,1990,65,42,23
3801,43,65,1990,105,42,63
3802,43,10,1990,83,57,26
3803,43,145,1990,0,0,0
3804,43,49,1990,1012,549,463
3805,43,74,1990,53,25,28
3806,43,25,1990,8,2,6
3807,43,169,1990,97,67,30
3808,43,166,1990,0,0,0
3809,43,93,1990,1,1,0
3810,43,146,1990,6,1,5
3811,43,26,1990,18,7,11
3812,43,170,1990,0,0,0
3813,43,130,1990,3,3,0
3814,43,38,1990,11,8,3
3815,43,27,1990,0,0,0
3816,43,50,1990,647,292,355
3817,43,131,1990,9,5,4
3818,43,114,1990,3,1,2
3819,43,171,1990,2,1,1
3820,43,1,1990,76,42,34
3821,43,28,1990,0,0,0
3822,43,132,1990,2,2,0
3823,43,133,1990,4,4,0
3824,5,2,1990,14159,6900,7259
3825,5,3,1990,4375155,2050262,2324893
3826,5,4,1990,11088,5597,5491
3827,5,172,1990,18165,7380,10785
3828,5,68,1990,5858,3164,2694
3829,5,69,1990,5654,2972,2682
3830,5,6,1990,3051,1516,1535
3831,5,16,1990,1189,668,521
3832,5,177,1990,903,493,410
3833,5,167,1990,1408,1335,73
3834,5,121,1990,8170,4315,3855
3835,5,19,1990,16860,8760,8100
3836,5,7,1990,1810,317,1493
3837,5,124,1990,2547,1250,1297
3838,5,8,1990,518212,294660,223552
3839,5,162,1990,1286,552,734
3840,5,9,1990,1921278,896557,1024721
3841,5,61,1990,454,272,182
3842,5,23,1990,6058,3043,3015
3843,5,10,1990,281720,138559,143161
3844,5,26,1990,343,180,163
3845,5,36,1990,3445,1754,1691
3846,5,130,1990,2058,1123,935
3847,5,27,1990,9940,5059,4881
3848,5,50,1990,5063,2669,2394
3849,5,1,1990,2832,2073,759
3850,5,132,1990,1008,578,430
3851,6,2,1990,3980307,1770639,2209668
3852,6,11,1990,571,319,252
3853,6,12,1990,896,466,430
3854,6,16,1990,290278,141469,148809
3855,6,9,1990,9925,5242,4683
3856,6,26,1990,393,208,185
3857,6,170,1990,237,130,107
3858,16,2,1990,241,81,160
3859,16,119,1990,359,87,272
3860,16,5,1990,179,72,107
3861,16,6,1990,14976,5148,9828
3862,16,18,1990,7970,2448,5522
3863,16,19,1990,309,104,205
3864,16,20,1990,1173,505,668
3865,16,161,1990,154,41,113
3866,16,144,1990,451,176,275
3867,16,9,1990,525,144,381
3868,16,36,1990,210,68,142
3869,16,23,1990,519,153,366
3870,16,128,1990,204,59,145
3871,16,129,1990,360,49,311
3872,16,145,1990,2924,402,2522
3873,16,25,1990,4778,1826,2952
3874,16,27,1990,222,54,168
3875,16,146,1990,241,36,205
3876,16,26,1990,938,307,631
3877,16,142,1990,11075,2177,8898
3878,16,28,1990,1543,329,1214
3879,44,2,1990,29,5,24
3880,44,51,1990,57,23,34
3881,44,141,1990,113,32,81
3882,44,52,1990,0,0,0
3883,44,134,1990,92,45,47
3884,44,75,1990,0,0,0
3885,44,76,1990,1,0,1
3886,44,103,1990,63,33,30
3887,44,11,1990,10,5,5
3888,44,77,1990,1,1,0
3889,44,66,1990,49,25,24
3890,44,12,1990,10,4,6
3891,44,78,1990,5,2,3
3892,44,13,1990,16,8,8
3893,44,3,1990,157,80,77
3894,44,79,1990,4,2,2
3895,44,29,1990,117,65,52
3896,44,67,1990,471,241,230
3897,44,95,1990,1,0,1
3898,44,151,1990,6,4,2
3899,44,4,1990,1,0,1
3900,44,53,1990,123,64,59
3901,44,147,1990,15,7,8
3902,44,105,1990,380,193,187
3903,44,30,1990,178,94,84
3904,44,152,1990,2,1,1
3905,44,116,1990,9,4,5
3906,44,153,1990,1,0,1
3907,44,135,1990,67,38,29
3908,44,80,1990,5,3,2
3909,44,136,1990,2,1,1
3910,44,106,1990,27,16,11
3911,44,172,1990,563,286,277
3912,44,173,1990,86,44,42
3913,44,137,1990,163,83,80
3914,44,96,1990,2,1,1
3915,44,54,1990,97,46,51
3916,44,81,1990,16,8,8
3917,44,14,1990,20,10,10
3918,44,31,1990,265,135,130
3919,44,176,1990,25,15,10
3920,44,137,1990,10,5,5
3921,44,39,1990,394,177,217
3922,44,118,1990,0,0,0
3923,44,82,1990,0,0,0
3924,44,83,1990,2,1,1
3925,44,108,1990,8,5,3
3926,44,142,1990,102,32,70
3927,44,97,1990,5,3,2
3928,44,119,1990,7,3,4
3929,44,40,1990,190,97,93
3930,44,148,1990,4,2,2
3931,44,120,1990,29,16,13
3932,44,41,1990,1,0,1
3933,44,42,1990,75,38,37
3934,44,68,1990,1917,1170,747
3935,44,139,1990,1,0,1
3936,44,155,1990,11,5,6
3937,44,15,1990,49,22,27
3938,44,69,1990,3341,1688,1653
3939,44,156,1990,97,52,45
3940,44,55,1990,7,4,3
3941,44,56,1990,104,41,63
3942,44,84,1990,3,1,2
3943,44,98,1990,24,12,12
3944,44,157,1990,10,4,6
3945,44,158,1990,0,0,0
3946,44,110,1990,6,3,3
3947,44,85,1990,1,1,0
3948,44,99,1990,2,1,1
3949,44,32,1990,167,85,82
3950,44,43,1990,7,4,3
3951,44,5,1990,750,381,369
3952,44,6,1990,85,29,56
3953,44,16,1990,87,33,54
3954,44,17,1990,42,19,23
3955,44,57,1990,1296,523,773
3956,44,86,1990,23,15,8
3957,44,177,1990,102,67,35
3958,44,18,1990,22,9,13
3959,44,167,1990,50,27,23
3960,44,121,1990,93,53,40
3961,44,19,1990,39,15,24
3962,44,168,1990,6,3,3
3963,44,46,1990,703,357,346
3964,44,20,1990,26,11,15
3965,44,149,1990,7,4,3
3966,44,159,1990,21,9,12
3967,44,143,1990,84,36,48
3968,44,70,1990,0,0,0
3969,44,47,1990,1246,634,612
3970,44,71,1990,19,11,8
3971,44,122,1990,2,1,1
3972,44,123,1990,14,7,7
3973,44,7,1990,1,0,1
3974,44,160,1990,6,3,3
3975,44,58,1990,23,12,11
3976,44,161,1990,2,1,1
3977,44,124,1990,74,32,42
3978,44,100,1990,59,40,19
3979,44,72,1990,1,0,1
3980,44,87,1990,0,0,0
3981,44,144,1990,52,16,36
3982,44,125,1990,8,4,4
3983,44,150,1990,7,4,3
3984,44,8,1990,26,8,18
3985,44,73,1990,1642,793,849
3986,44,101,1990,3,2,1
3987,44,162,1990,837,426,411
3988,44,60,1990,126,53,73
3989,44,48,1990,59,31,28
3990,44,21,1990,9,5,4
3991,44,9,1990,293,149,144
3992,44,102,1990,3,2,1
3993,44,111,1990,5,3,2
3994,44,112,1990,24,16,8
3995,44,33,1990,3168,1612,1556
3996,44,61,1990,122,62,60
3997,44,22,1990,7,3,4
3998,44,35,1990,430,219,211
3999,44,36,1990,229,117,112
4000,44,126,1990,15,9,6
4001,44,90,1990,0,0,0
4002,44,91,1990,1,0,1
4003,44,92,1990,1,0,1
4004,44,23,1990,82,40,42
4005,44,164,1990,4,2,2
4006,44,127,1990,2,1,1
4007,44,165,1990,38,15,23
4008,44,37,1990,412,209,203
4009,44,64,1990,11,6,5
4010,44,128,1990,102,47,55
4011,44,115,1990,621,315,306
4012,44,65,1990,499,253,246
4013,44,10,1990,46,19,27
4014,44,145,1990,113,40,73
4015,44,113,1990,2,1,1
4016,44,49,1990,145,74,71
4017,44,74,1990,106,63,43
4018,44,25,1990,22,7,15
4019,44,169,1990,4,2,2
4020,44,166,1990,22,9,13
4021,44,93,1990,22,13,9
4022,44,146,1990,19,4,15
4023,44,26,1990,94,22,72
4024,44,170,1990,1,1,0
4025,44,94,1990,0,0,0
4026,44,130,1990,29,16,13
4027,44,38,1990,170,87,83
4028,44,27,1990,39,19,20
4029,44,50,1990,184671,93802,90869
4030,44,131,1990,24,13,11
4031,44,114,1990,11,6,5
4032,44,171,1990,18,10,8
4033,44,1,1990,122,75,47
4034,44,28,1990,6,3,3
4035,44,132,1990,65,34,31
4036,44,133,1990,185,94,91
4037,45,44,1990,1628,935,693
4038,45,115,1990,303,158,145
4039,45,50,1990,30510,16083,14427
4040,17,2,1990,2724,1442,1282
4041,17,141,1990,19544,10342,9202
4042,17,12,1990,14696,7687,7009
4043,17,103,1990,25526,13211,12315
4044,17,66,1990,6373,3343,3030
4045,17,67,1990,3657,2015,1642
4046,17,105,1990,5866,3299,2567
4047,17,30,1990,19353,10480,8873
4048,17,29,1990,33049,17481,15568
4049,17,106,1990,2613,1385,1228
4050,17,172,1990,1027,559,468
4051,17,107,1990,1155,669,486
4052,17,39,1990,1040,629,411
4053,17,120,1990,40595,20028,20567
4054,17,42,1990,529,380,149
4055,17,68,1990,17904,9593,8311
4056,17,15,1990,25921,13224,12697
4057,17,69,1990,26628,14811,11817
4058,17,56,1990,1320,708,612
4059,17,32,1990,15656,8295,7361
4060,17,5,1990,16927,8723,8204
4061,17,6,1990,47785,24163,23622
4062,17,16,1990,74502,37391,37111
4063,17,57,1990,4617,2439,2178
4064,17,167,1990,6279,3413,2866
4065,17,168,1990,1078,592,486
4066,17,20,1990,3924,2377,1547
4067,17,46,1990,9479,5131,4348
4068,17,143,1990,19180,9885,9295
4069,17,47,1990,13594,7346,6248
4070,17,100,1990,1422,760,662
4071,17,144,1990,157029,80590,76439
4072,17,73,1990,4337,2447,1890
4073,17,112,1990,649,385,264
4074,17,33,1990,95566,51546,44020
4075,17,35,1990,128886,70150,58736
4076,17,36,1990,175938,95488,80450
4077,17,115,1990,8519,4436,4083
4078,17,65,1990,3129,1761,1368
4079,17,49,1990,1178,690,488
4080,17,74,1990,2662,1525,1137
4081,17,25,1990,10963,5751,5212
4082,17,169,1990,4484,2233,2251
4083,17,146,1990,40293,21025,19268
4084,17,26,1990,31449,16087,15362
4085,17,170,1990,507,271,236
4086,17,38,1990,168081,90720,77361
4087,17,142,1990,21780,11310,10470
4088,17,50,1990,14958,7866,7092
4089,17,114,1990,4315,2268,2047
4090,17,171,1990,31121,15973,15148
4091,17,28,1990,36222,18980,17242
4092,57,2,1990,271,60,211
4093,57,51,1990,44935,13273,31662
4094,57,141,1990,6171,2345,3826
4095,57,52,1990,2,1,1
4096,57,134,1990,304,199,105
4097,57,76,1990,1,0,1
4098,57,103,1990,31345,20955,10390
4099,57,11,1990,25,17,8
4100,57,66,1990,16037,12940,3097
4101,57,12,1990,6,4,2
4102,57,78,1990,6,4,2
4103,57,13,1990,0,0,0
4104,57,3,1990,5421,594,4827
4105,57,79,1990,3,2,1
4106,57,29,1990,93,61,32
4107,57,67,1990,14298,10309,3989
4108,57,95,1990,4,3,1
4109,57,151,1990,107,70,37
4110,57,4,1990,12,8,4
4111,57,53,1990,4034,2632,1402
4112,57,147,1990,1,1,0
4113,57,105,1990,25441,21448,3993
4114,57,30,1990,446,291,155
4115,57,152,1990,381,248,133
4116,57,116,1990,101,66,35
4117,57,153,1990,6799,6319,480
4118,57,135,1990,254,166,88
4119,57,136,1990,17,11,6
4120,57,106,1990,8674,5761,2913
4121,57,172,1990,32172,17323,14849
4122,57,107,1990,9633,8166,1467
4123,57,117,1990,3,2,1
4124,57,137,1990,508,331,177
4125,57,96,1990,92,60,32
4126,57,54,1990,6648,4337,2311
4127,57,81,1990,1444,942,502
4128,57,14,1990,42,28,14
4129,57,31,1990,937,611,326
4130,57,176,1990,1,1,0
4131,57,137,1990,205,134,71
4132,57,39,1990,4729,3587,1142
4133,57,118,1990,2,1,1
4134,57,82,1990,0,0,0
4135,57,83,1990,9060,5911,3149
4136,57,108,1990,997,650,347
4137,57,142,1990,40045,13660,26385
4138,57,97,1990,724,472,252
4139,57,138,1990,6,4,2
4140,57,119,1990,779,508,271
4141,57,40,1990,31,20,11
4142,57,148,1990,1,1,0
4143,57,120,1990,16703,13006,3697
4144,57,42,1990,462,301,161
4145,57,68,1990,66902,50766,16136
4146,57,139,1990,14,9,5
4147,57,155,1990,84,55,29
4148,57,15,1990,11,7,4
4149,57,69,1990,96165,69321,26844
4150,57,156,1990,25093,10364,14729
4151,57,56,1990,19876,8382,11494
4152,57,84,1990,1,1,0
4153,57,98,1990,108,70,38
4154,57,157,1990,103,67,36
4155,57,158,1990,35,23,12
4156,57,110,1990,9,6,3
4157,57,85,1990,38,25,13
4158,57,99,1990,78,51,27
4159,57,32,1990,698,455,243
4160,57,43,1990,55,36,19
4161,57,5,1990,3413,2227,1186
4162,57,6,1990,19096,8307,10789
4163,57,16,1990,176,115,61
4164,57,44,1990,4114,3044,1070
4165,57,17,1990,7287,3079,4208
4166,57,86,1990,38,25,13
4167,57,177,1990,13179,8488,4691
4168,57,18,1990,5005,850,4155
4169,57,167,1990,50,32,18
4170,57,121,1990,134,88,46
4171,57,19,1990,49,32,17
4172,57,168,1990,3,2,1
4173,57,46,1990,38,25,13
4174,57,20,1990,9128,3104,6024
4175,57,149,1990,0,0,0
4176,57,159,1990,4,2,2
4177,57,143,1990,5450,2712,2738
4178,57,70,1990,3,2,1
4179,57,47,1990,16,10,6
4180,57,71,1990,929,644,285
4181,57,122,1990,193,126,67
4182,57,123,1990,8,6,2
4183,57,7,1990,1,1,0
4184,57,160,1990,43,28,15
4185,57,58,1990,257,168,89
4186,57,161,1990,46,30,16
4187,57,124,1990,9594,5685,3909
4188,57,100,1990,4331,3799,532
4189,57,72,1990,154,101,53
4190,57,59,1990,1458,951,507
4191,57,144,1990,169285,38077,131208
4192,57,125,1990,58,38,20
4193,57,150,1990,13,8,5
4194,57,8,1990,11,7,4
4195,57,73,1990,17068,12135,4933
4196,57,101,1990,78,51,27
4197,57,162,1990,11859,5469,6390
4198,57,60,1990,72688,39913,32775
4199,57,48,1990,159,104,55
4200,57,21,1990,38,25,13
4201,57,9,1990,6808,815,5993
4202,57,102,1990,143,93,50
4203,57,111,1990,53,35,18
4204,57,112,1990,12843,9529,3314
4205,57,33,1990,24516,18088,6428
4206,57,61,1990,6791,5444,1347
4207,57,22,1990,0,0,0
4208,57,35,1990,40066,28392,11674
4209,57,36,1990,7359,6687,672
4210,57,126,1990,126,82,44
4211,57,90,1990,2,1,1
4212,57,91,1990,1,1,0
4213,57,92,1990,0,0,0
4214,57,62,1990,1055,688,367
4215,57,140,1990,9,6,3
4216,57,23,1990,17,11,6
4217,57,164,1990,44973,2586,42387
4218,57,63,1990,17845,11642,6203
4219,57,127,1990,181,118,63
4220,57,165,1990,91,59,32
4221,57,37,1990,223,146,77
4222,57,64,1990,1268,827,441
4223,57,128,1990,11363,7738,3625
4224,57,115,1990,409,267,142
4225,57,129,1990,0,0,0
4226,57,65,1990,26557,22928,3629
4227,57,10,1990,19974,8236,11738
4228,57,145,1990,47,30,17
4229,57,113,1990,12,8,4
4230,57,49,1990,5968,4755,1213
4231,57,74,1990,43544,29926,13618
4232,57,25,1990,527,344,183
4233,57,169,1990,7,5,2
4234,57,166,1990,87,57,30
4235,57,93,1990,21,14,7
4236,57,146,1990,70813,18399,52414
4237,57,26,1990,7575,3492,4083
4238,57,170,1990,7,4,3
4239,57,130,1990,53,35,18
4240,57,38,1990,206,134,72
4241,57,27,1990,2,1,1
4242,57,50,1990,59492,41433,18059
4243,57,131,1990,135,88,47
4244,57,114,1990,678,442,236
4245,57,171,1990,191,124,67
4246,57,1,1990,636,415,221
4247,57,28,1990,40,26,14
4248,57,132,1990,20,13,7
4249,57,133,1990,30,20,10
4250,86,76,1990,120,61,59
4251,86,78,1990,518,263,255
4252,86,79,1990,418,213,205
4253,86,95,1990,6,4,2
4254,86,96,1990,96,56,40
4255,86,81,1990,1746,911,835
4256,86,82,1990,107,54,53
4257,86,97,1990,130,75,55
4258,86,84,1990,161,82,79
4259,86,98,1990,295,172,123
4260,86,99,1990,157,91,66
4261,86,5,1990,711,313,398
4262,86,101,1990,121,70,51
4263,86,102,1990,73,42,31
4264,86,90,1990,75,38,37
4265,86,91,1990,257,130,127
4266,86,92,1990,176,89,87
4267,86,93,1990,1775,912,863
4268,86,50,1990,5469,2852,2617
4269,177,103,1990,2657,1303,1354
4270,177,66,1990,309,152,157
4271,177,3,1990,2110,1035,1075
4272,177,67,1990,402,197,205
4273,177,105,1990,56445,27689,28756
4274,177,172,1990,150383,75552,74831
4275,177,39,1990,450,221,229
4276,177,142,1990,368,181,187
4277,177,42,1990,432,212,220
4278,177,68,1990,3167,1554,1613
4279,177,69,1990,3607,1769,1838
4280,177,156,1990,598,293,305
4281,177,5,1990,3108,1525,1583
4282,177,6,1990,1237,607,630
4283,177,44,1990,671,329,342
4284,177,57,1990,940,461,479
4285,177,100,1990,786,386,400
4286,177,73,1990,749,367,382
4287,177,162,1990,193,95,98
4288,177,48,1990,360,177,183
4289,177,9,1990,2068,1014,1054
4290,177,112,1990,10282,5044,5238
4291,177,33,1990,359,176,183
4292,177,61,1990,319,156,163
4293,177,36,1990,440,216,224
4294,177,65,1990,856,420,436
4295,177,10,1990,1206,592,614
4296,177,49,1990,586,287,299
4297,177,74,1990,980,481,499
4298,177,50,1990,10209,5008,5201
4299,177,1,1990,6235,3059,3176
4300,18,2,1990,74,31,43
4301,18,141,1990,222,159,63
4302,18,66,1990,78,44,34
4303,18,13,1990,143,82,61
4304,18,3,1990,948,297,651
4305,18,11,1990,26,15,11
4306,18,67,1990,33,16,17
4307,18,53,1990,320,170,150
4308,18,105,1990,101,63,38
4309,18,30,1990,91,45,46
4310,18,10,1990,11062,10931,131
4311,18,136,1990,4,0,4
4312,18,172,1990,192,89,103
4313,18,107,1990,15,12,3
4314,18,54,1990,19,16,3
4315,18,14,1990,13,9,4
4316,18,31,1990,18,12,6
4317,18,39,1990,49,26,23
4318,18,120,1990,21,9,12
4319,18,119,1990,139,75,64
4320,18,68,1990,295,126,169
4321,18,69,1990,413,207,206
4322,18,156,1990,44,15,29
4323,18,56,1990,117,72,45
4324,18,173,1990,1,0,1
4325,18,32,1990,35,31,4
4326,18,5,1990,871,268,603
4327,18,6,1990,119,73,46
4328,18,16,1990,25773,10230,15543
4329,18,44,1990,75,58,17
4330,18,17,1990,6,4,2
4331,18,57,1990,518,284,234
4332,18,177,1990,143,55,88
4333,18,167,1990,3,2,1
4334,18,176,1990,40,15,25
4335,18,19,1990,233,137,96
4336,18,20,1990,3021,1808,1213
4337,18,143,1990,338,157,181
4338,18,161,1990,90,13,77
4339,18,144,1990,398,257,141
4340,18,21,1990,540,247,293
4341,18,8,1990,9,2,7
4342,18,73,1990,147,77,70
4343,18,162,1990,23,9,14
4344,18,48,1990,8,3,5
4345,18,9,1990,5168,2445,2723
4346,18,33,1990,85,54,31
4347,18,22,1990,102,36,66
4348,18,35,1990,310,288,22
4349,18,36,1990,581,443,138
4350,18,23,1990,3495,1666,1829
4351,18,63,1990,35,30,5
4352,18,37,1990,12,8,4
4353,18,128,1990,24,9,15
4354,18,115,1990,24,13,11
4355,18,65,1990,282,174,108
4356,18,129,1990,233,52,181
4357,18,145,1990,1891,423,1468
4358,18,49,1990,82,43,39
4359,18,74,1990,53,30,23
4360,18,25,1990,51557,22797,28760
4361,18,27,1990,156,92,64
4362,18,146,1990,221,116,105
4363,18,26,1990,957,358,599
4364,18,38,1990,45,39,6
4365,18,60,1990,208,156,52
4366,18,142,1990,171413,49968,121445
4367,18,50,1990,465,214,251
4368,18,28,1990,2439,724,1715
4369,167,12,1990,35789,16396,19393
4370,167,11,1990,7596,3134,4462
4371,167,29,1990,72545,38028,34517
4372,167,172,1990,695,328,367
4373,167,40,1990,358,205,153
4374,167,15,1990,3773,1440,2333
4375,167,176,1990,19805,10474,9331
4376,167,168,1990,5606,2763,2843
4377,167,46,1990,358,184,174
4378,167,47,1990,4347,1897,2450
4379,167,36,1990,2474111,1351650,1122461
4380,167,169,1990,5085,2501,2584
4381,167,26,1990,19692,10125,9567
4382,167,170,1990,338,143,195
4383,167,38,1990,356063,192409,163654
4384,167,171,1990,131905,66286,65619
4385,121,116,1990,99,44,55
4386,121,137,1990,394,178,216
4387,121,120,1990,26695,11402,15293
4388,121,119,1990,0,0,0
4389,121,125,1990,1043,463,580
4390,121,150,1990,119,53,66
4391,121,126,1990,3874,1719,2155
4392,121,128,1990,7875,3493,4382
4393,121,115,1990,197,87,110
4394,121,129,1990,5801,2469,3332
4395,121,145,1990,814,347,467
4396,121,130,1990,83355,41264,42091
4397,121,131,1990,66464,30682,35782
4398,19,2,1990,1334,526,808
4399,19,13,1990,189,170,19
4400,19,3,1990,126783,17595,109188
4401,19,10,1990,36364,32728,3636
4402,19,136,1990,870,343,527
4403,19,120,1990,2216,874,1342
4404,19,119,1990,3148,1242,1906
4405,19,68,1990,355,236,119
4406,19,5,1990,375183,117332,257851
4407,19,18,1990,21348,11777,9571
4408,19,20,1990,4513,1780,2733
4409,19,144,1990,1594,628,966
4410,19,8,1990,1416,558,858
4411,19,73,1990,1080,929,151
4412,19,162,1990,1160,457,703
4413,19,9,1990,129928,41211,88717
4414,19,22,1990,49,44,5
4415,19,23,1990,380,208,172
4416,19,128,1990,2111,832,1279
4417,19,129,1990,0,0,0
4418,19,145,1990,29503,15329,14174
4419,19,25,1990,11021,4348,6673
4420,19,27,1990,4778,3932,846
4421,19,146,1990,961,379,582
4422,19,26,1990,8007,3159,4848
4423,19,142,1990,135880,69940,65940
4424,19,50,1990,10010,5784,4226
4425,19,28,1990,36441,14377,22064
4426,168,12,1990,14455,8083,6372
4427,168,11,1990,7381,4189,3192
4428,168,29,1990,30187,17721,12466
4429,168,172,1990,770,445,325
4430,168,40,1990,1544,889,655
4431,168,42,1990,361,142,219
4432,168,15,1990,10351,5803,4548
4433,168,69,1990,15254,8768,6486
4434,168,167,1990,38405,22287,16118
4435,168,176,1990,800,456,344
4436,168,46,1990,2526,1457,1069
4437,168,47,1990,6622,3817,2805
4438,168,33,1990,6934,4410,2524
4439,168,35,1990,713,399,314
4440,168,36,1990,349174,203912,145262
4441,168,1,1990,372,214,158
4442,168,169,1990,6041,3502,2539
4443,168,26,1990,833,465,368
4444,168,170,1990,2941,1676,1265
4445,168,38,1990,85115,49593,35522
4446,168,171,1990,18416,10517,7899
4447,46,2,1990,20,12,8
4448,46,51,1990,4,2,2
4449,46,141,1990,6,1,5
4450,46,52,1990,0,0,0
4451,46,134,1990,1,1,0
4452,46,75,1990,4,2,2
4453,46,76,1990,0,0,0
4454,46,103,1990,9,6,3
4455,46,11,1990,1552,631,921
4456,46,77,1990,1,0,1
4457,46,66,1990,50,23,27
4458,46,12,1990,1399,397,1002
4459,46,13,1990,0,0,0
4460,46,3,1990,3,0,3
4461,46,79,1990,2,1,1
4462,46,29,1990,60530,34334,26196
4463,46,67,1990,14,5,9
4464,46,151,1990,0,0,0
4465,46,53,1990,2,0,2
4466,46,147,1990,0,0,0
4467,46,105,1990,8,4,4
4468,46,30,1990,390,203,187
4469,46,116,1990,1,0,1
4470,46,153,1990,1,0,1
4471,46,135,1990,1,0,1
4472,46,106,1990,1,0,1
4473,46,172,1990,24,14,10
4474,46,107,1990,2,2,0
4475,46,137,1990,1,0,1
4476,46,96,1990,0,0,0
4477,46,54,1990,4,1,3
4478,46,81,1990,21,12,9
4479,46,14,1990,2,1,1
4480,46,31,1990,48,27,21
4481,46,176,1990,204,113,91
4482,46,137,1990,0,0,0
4483,46,39,1990,35,21,14
4484,46,83,1990,0,0,0
4485,46,108,1990,0,0,0
4486,46,142,1990,5,1,4
4487,46,119,1990,0,0,0
4488,46,40,1990,1675,952,723
4489,46,41,1990,0,0,0
4490,46,42,1990,1199,409,790
4491,46,68,1990,26,15,11
4492,46,139,1990,0,0,0
4493,46,155,1990,0,0,0
4494,46,15,1990,697,270,427
4495,46,69,1990,1913,1081,832
4496,46,156,1990,0,0,0
4497,46,56,1990,326,179,147
4498,46,98,1990,0,0,0
4499,46,32,1990,293,140,153
4500,46,43,1990,4,1,3
4501,46,5,1990,35,9,26
4502,46,6,1990,15,4,11
4503,46,16,1990,3,1,2
4504,46,44,1990,14,9,5
4505,46,17,1990,21,7,14
4506,46,57,1990,16,8,8
4507,46,86,1990,0,0,0
4508,46,177,1990,4,3,1
4509,46,18,1990,3,1,2
4510,46,167,1990,528,197,331
4511,46,121,1990,0,0,0
4512,46,19,1990,1,1,0
4513,46,168,1990,593,328,265
4514,46,20,1990,45,25,20
4515,46,143,1990,2,1,1
4516,46,70,1990,0,0,0
4517,46,47,1990,17512,9435,8077
4518,46,71,1990,1,1,0
4519,46,122,1990,1,0,1
4520,46,123,1990,1,1,0
4521,46,160,1990,2,0,2
4522,46,58,1990,2,1,1
4523,46,161,1990,0,0,0
4524,46,124,1990,0,0,0
4525,46,100,1990,6,3,3
4526,46,72,1990,0,0,0
4527,46,59,1990,0,0,0
4528,46,144,1990,3,2,1
4529,46,125,1990,0,0,0
4530,46,150,1990,0,0,0
4531,46,8,1990,1,1,0
4532,46,73,1990,16,9,7
4533,46,101,1990,1,1,0
4534,46,162,1990,4,1,3
4535,46,60,1990,0,0,0
4536,46,48,1990,22,13,9
4537,46,9,1990,16,2,14
4538,46,111,1990,1,1,0
4539,46,112,1990,3,1,2
4540,46,33,1990,30550,18693,11857
4541,46,61,1990,1,0,1
4542,46,22,1990,0,0,0
4543,46,35,1990,3562,1885,1677
4544,46,36,1990,473207,261663,211544
4545,46,126,1990,1,0,1
4546,46,23,1990,0,0,0
4547,46,63,1990,17,9,8
4548,46,165,1990,2,0,2
4549,46,37,1990,21,13,8
4550,46,64,1990,2,2,0
4551,46,128,1990,0,0,0
4552,46,115,1990,2,1,1
4553,46,129,1990,1,1,0
4554,46,65,1990,18,10,8
4555,46,10,1990,31,18,13
4556,46,145,1990,1,0,1
4557,46,49,1990,128,39,89
4558,46,74,1990,11,4,7
4559,46,25,1990,5,1,4
4560,46,169,1990,47,27,20
4561,46,166,1990,1,0,1
4562,46,93,1990,0,0,0
4563,46,146,1990,0,0,0
4564,46,26,1990,12,3,9
4565,46,170,1990,23,13,10
4566,46,130,1990,1,1,0
4567,46,38,1990,46572,22798,23774
4568,46,27,1990,1,0,1
4569,46,50,1990,117,32,85
4570,46,131,1990,0,0,0
4571,46,114,1990,3,2,1
4572,46,171,1990,309,201,108
4573,46,1,1990,3,1,2
4574,46,28,1990,1,0,1
4575,46,132,1990,0,0,0
4576,46,133,1990,1,0,1
4577,20,13,1990,65,37,28
4578,20,3,1990,433,136,297
4579,20,10,1990,5054,4994,60
4580,20,172,1990,88,41,47
4581,20,68,1990,135,58,77
4582,20,69,1990,189,95,94
4583,20,32,1990,16,14,2
4584,20,5,1990,398,122,276
4585,20,16,1990,11774,4673,7101
4586,20,17,1990,3,2,1
4587,20,18,1990,1380,826,554
4588,20,19,1990,106,63,43
4589,20,143,1990,154,72,82
4590,20,144,1990,182,117,65
4591,20,21,1990,247,113,134
4592,20,9,1990,2361,1117,1244
4593,20,36,1990,265,202,63
4594,20,23,1990,1597,761,836
4595,20,129,1990,106,24,82
4596,20,145,1990,864,193,671
4597,20,25,1990,23553,10415,13138
4598,20,26,1990,437,164,273
4599,20,38,1990,21,18,3
4600,20,142,1990,78308,22827,55481
4601,20,50,1990,212,98,114
4602,20,28,1990,1114,331,783
4603,149,147,1990,103,54,49
4604,149,172,1990,162,70,92
4605,149,156,1990,122,41,81
4606,149,5,1990,308,136,172
4607,149,123,1990,51,20,31
4608,149,125,1990,32,11,21
4609,149,150,1990,5,1,4
4610,149,9,1990,308,136,172
4611,149,115,1990,2777,1500,1277
4612,149,133,1990,77,37,40
4613,149,148,1990,51,27,24
4614,149,130,1990,185,83,102
4615,149,131,1990,116,59,57
4616,149,132,1990,77,37,40
4617,159,151,1990,63,25,38
4618,159,68,1990,296,139,157
4619,159,155,1990,656,273,383
4620,159,69,1990,928,450,478
4621,159,156,1990,9952,4667,5285
4622,159,157,1990,32485,13032,19453
4623,159,5,1990,774,281,493
4624,159,57,1990,252,102,150
4625,159,20,1990,4230,1511,2719
4626,159,160,1990,1970,654,1316
4627,159,73,1990,298,139,159
4628,159,162,1990,2393,910,1483
4629,159,158,1990,2263,1120,1143
4630,159,164,1990,243,85,158
4631,159,165,1990,7943,3405,4538
4632,159,65,1990,286,129,157
4633,159,49,1990,1120,532,588
4634,159,74,1990,148,65,83
4635,159,166,1990,250,103,147
4636,159,50,1990,1146,538,608
4637,159,152,1990,388,151,237
4638,143,2,1990,677,121,556
4639,143,51,1990,315,106,209
4640,143,141,1990,1551,1021,530
4641,143,66,1990,2044,1097,947
4642,143,13,1990,1091,649,442
4643,143,3,1990,318,66,252
4644,143,11,1990,511,327,184
4645,143,67,1990,1918,951,967
4646,143,53,1990,66,33,33
4647,143,105,1990,390,233,157
4648,143,29,1990,702,401,301
4649,143,10,1990,710,278,432
4650,143,136,1990,871,302,569
4651,143,172,1990,1366,241,1125
4652,143,117,1990,1230,142,1088
4653,143,137,1990,74,7,67
4654,143,137,1990,283,106,177
4655,143,39,1990,796,396,400
4656,143,97,1990,458,270,188
4657,143,120,1990,1618,965,653
4658,143,119,1990,1023,506,517
4659,143,42,1990,538,331,207
4660,143,68,1990,8821,4047,4774
4661,143,118,1990,694,262,432
4662,143,69,1990,27674,12477,15197
4663,143,156,1990,610,129,481
4664,143,56,1990,3730,2117,1613
4665,143,32,1990,350,188,162
4666,143,5,1990,2288,891,1397
4667,143,6,1990,383,172,211
4668,143,16,1990,3879,2467,1412
4669,143,57,1990,13295,6026,7269
4670,143,177,1990,4156,1998,2158
4671,143,167,1990,403,262,141
4672,143,18,1990,9668,4595,5073
4673,143,121,1990,375,84,291
4674,143,19,1990,6005,2534,3471
4675,143,20,1990,6615,3696,2919
4676,143,160,1990,688,129,559
4677,143,161,1990,433,106,327
4678,143,72,1990,176,93,83
4679,143,144,1990,1505,1124,381
4680,143,21,1990,1246,469,777
4681,143,73,1990,3048,1452,1596
4682,143,162,1990,1674,323,1351
4683,143,48,1990,302,112,190
4684,143,9,1990,1104,327,777
4685,143,33,1990,1163,485,678
4686,143,158,1990,200,5,195
4687,143,22,1990,819,363,456
4688,143,35,1990,645,302,343
4689,143,36,1990,26586,17335,9251
4690,143,23,1990,12976,4880,8096
4691,143,164,1990,1096,212,884
4692,143,165,1990,117,76,41
4693,143,128,1990,3917,2072,1845
4694,143,115,1990,543,228,315
4695,143,65,1990,1282,591,691
4696,143,129,1990,4753,2148,2605
4697,143,145,1990,38599,17446,21153
4698,143,49,1990,1021,436,585
4699,143,74,1990,5069,2383,2686
4700,143,25,1990,15014,6935,8079
4701,143,169,1990,133,21,112
4702,143,27,1990,1322,459,863
4703,143,146,1990,1414,719,695
4704,143,26,1990,2197,492,1705
4705,143,170,1990,58,5,53
4706,143,38,1990,189,91,98
4707,143,142,1990,8384,3759,4625
4708,143,50,1990,8712,3786,4926
4709,143,131,1990,445,76,369
4710,143,171,1990,243,52,191
4711,143,28,1990,10956,4666,6290
4712,70,2,1990,0,0,0
4713,70,51,1990,0,0,0
4714,70,141,1990,0,0,0
4715,70,52,1990,0,0,0
4716,70,134,1990,0,0,0
4717,70,103,1990,0,0,0
4718,70,11,1990,0,0,0
4719,70,66,1990,2021,1054,967
4720,70,12,1990,0,0,0
4721,70,78,1990,0,0,0
4722,70,3,1990,0,0,0
4723,70,29,1990,0,0,0
4724,70,67,1990,1,0,1
4725,70,53,1990,297,152,145
4726,70,105,1990,36,25,11
4727,70,30,1990,18,0,18
4728,70,152,1990,0,0,0
4729,70,135,1990,0,0,0
4730,70,106,1990,0,0,0
4731,70,172,1990,28,14,14
4732,70,107,1990,0,0,0
4733,70,96,1990,0,0,0
4734,70,54,1990,111,57,54
4735,70,81,1990,0,0,0
4736,70,31,1990,9,0,9
4737,70,137,1990,0,0,0
4738,70,39,1990,16,4,12
4739,70,83,1990,0,0,0
4740,70,108,1990,0,0,0
4741,70,142,1990,0,0,0
4742,70,97,1990,0,0,0
4743,70,119,1990,0,0,0
4744,70,40,1990,13,0,13
4745,70,120,1990,0,0,0
4746,70,42,1990,1,0,1
4747,70,68,1990,66,32,34
4748,70,155,1990,0,0,0
4749,70,15,1990,0,0,0
4750,70,69,1990,978,455,523
4751,70,56,1990,86,42,44
4752,70,98,1990,0,0,0
4753,70,157,1990,0,0,0
4754,70,85,1990,0,0,0
4755,70,99,1990,0,0,0
4756,70,32,1990,6,0,6
4757,70,43,1990,1,1,0
4758,70,5,1990,0,0,0
4759,70,6,1990,0,0,0
4760,70,16,1990,0,0,0
4761,70,44,1990,1,1,0
4762,70,17,1990,0,0,0
4763,70,57,1990,806,306,500
4764,70,86,1990,0,0,0
4765,70,177,1990,0,0,0
4766,70,18,1990,0,0,0
4767,70,167,1990,0,0,0
4768,70,121,1990,0,0,0
4769,70,19,1990,0,0,0
4770,70,168,1990,0,0,0
4771,70,46,1990,0,0,0
4772,70,143,1990,0,0,0
4773,70,47,1990,0,0,0
4774,70,71,1990,8,3,5
4775,70,122,1990,0,0,0
4776,70,7,1990,0,0,0
4777,70,58,1990,0,0,0
4778,70,124,1990,0,0,0
4779,70,100,1990,0,0,0
4780,70,72,1990,0,0,0
4781,70,59,1990,78,0,78
4782,70,144,1990,0,0,0
4783,70,125,1990,0,0,0
4784,70,8,1990,0,0,0
4785,70,73,1990,40,19,21
4786,70,101,1990,0,0,0
4787,70,162,1990,0,0,0
4788,70,60,1990,436,189,247
4789,70,48,1990,6,3,3
4790,70,9,1990,0,0,0
4791,70,102,1990,0,0,0
4792,70,111,1990,0,0,0
4793,70,112,1990,0,0,0
4794,70,33,1990,11,0,11
4795,70,61,1990,134,62,72
4796,70,35,1990,2,2,0
4797,70,36,1990,6,5,1
4798,70,91,1990,0,0,0
4799,70,164,1990,0,0,0
4800,70,63,1990,379,0,379
4801,70,127,1990,0,0,0
4802,70,37,1990,18,11,7
4803,70,64,1990,53,33,20
4804,70,128,1990,0,0,0
4805,70,115,1990,0,0,0
4806,70,65,1990,191,86,105
4807,70,10,1990,0,0,0
4808,70,49,1990,22,11,11
4809,70,74,1990,4128,1959,2169
4810,70,25,1990,0,0,0
4811,70,93,1990,0,0,0
4812,70,146,1990,0,0,0
4813,70,26,1990,820,382,438
4814,70,130,1990,0,0,0
4815,70,38,1990,3,2,1
4816,70,27,1990,0,0,0
4817,70,50,1990,27,9,18
4818,70,131,1990,0,0,0
4819,70,114,1990,0,0,0
4820,70,171,1990,0,0,0
4821,70,1,1990,0,0,0
4822,70,132,1990,0,0,0
4823,70,133,1990,0,0,0
4824,47,2,1990,40,14,26
4825,47,51,1990,0,0,0
4826,47,141,1990,0,0,0
4827,47,134,1990,0,0,0
4828,47,103,1990,83,38,45
4829,47,11,1990,815,253,562
4830,47,77,1990,0,0,0
4831,47,66,1990,48,24,24
4832,47,12,1990,2193,685,1508
4833,47,78,1990,0,0,0
4834,47,13,1990,0,0,0
4835,47,3,1990,0,0,0
4836,47,29,1990,80249,45489,34760
4837,47,67,1990,30,8,22
4838,47,95,1990,0,0,0
4839,47,151,1990,0,0,0
4840,47,53,1990,0,0,0
4841,47,105,1990,75,39,36
4842,47,30,1990,33,6,27
4843,47,135,1990,0,0,0
4844,47,106,1990,0,0,0
4845,47,172,1990,157,65,92
4846,47,107,1990,0,0,0
4847,47,137,1990,0,0,0
4848,47,54,1990,0,0,0
4849,47,81,1990,0,0,0
4850,47,14,1990,3,3,0
4851,47,31,1990,66,33,33
4852,47,176,1990,0,0,0
4853,47,137,1990,0,0,0
4854,47,39,1990,100,28,72
4855,47,82,1990,0,0,0
4856,47,108,1990,0,0,0
4857,47,142,1990,3,1,2
4858,47,119,1990,0,0,0
4859,47,40,1990,1514,729,785
4860,47,120,1990,0,0,0
4861,47,42,1990,74,30,44
4862,47,68,1990,215,119,96
4863,47,155,1990,0,0,0
4864,47,15,1990,2036,823,1213
4865,47,69,1990,1833,858,975
4866,47,156,1990,0,0,0
4867,47,56,1990,10,5,5
4868,47,157,1990,0,0,0
4869,47,110,1990,0,0,0
4870,47,99,1990,0,0,0
4871,47,32,1990,132,64,68
4872,47,43,1990,7,5,2
4873,47,5,1990,0,0,0
4874,47,6,1990,24,6,18
4875,47,16,1990,0,0,0
4876,47,44,1990,18,9,9
4877,47,17,1990,30,10,20
4878,47,57,1990,40,17,23
4879,47,86,1990,0,0,0
4880,47,177,1990,14,7,7
4881,47,18,1990,0,0,0
4882,47,167,1990,13109,6536,6573
4883,47,121,1990,0,0,0
4884,47,19,1990,0,0,0
4885,47,168,1990,1006,508,498
4886,47,46,1990,11157,5734,5423
4887,47,20,1990,118,10,108
4888,47,159,1990,0,0,0
4889,47,143,1990,0,0,0
4890,47,71,1990,0,0,0
4891,47,122,1990,0,0,0
4892,47,123,1990,0,0,0
4893,47,7,1990,0,0,0
4894,47,160,1990,0,0,0
4895,47,58,1990,0,0,0
4896,47,161,1990,0,0,0
4897,47,124,1990,0,0,0
4898,47,100,1990,0,0,0
4899,47,72,1990,0,0,0
4900,47,144,1990,0,0,0
4901,47,125,1990,0,0,0
4902,47,150,1990,0,0,0
4903,47,8,1990,0,0,0
4904,47,73,1990,33,13,20
4905,47,101,1990,0,0,0
4906,47,162,1990,5,0,5
4907,47,60,1990,0,0,0
4908,47,48,1990,43,13,30
4909,47,21,1990,0,0,0
4910,47,9,1990,35,6,29
4911,47,111,1990,0,0,0
4912,47,112,1990,0,0,0
4913,47,33,1990,4372,2517,1855
4914,47,61,1990,3,1,2
4915,47,22,1990,0,0,0
4916,47,35,1990,35,16,19
4917,47,36,1990,158448,85209,73239
4918,47,126,1990,0,0,0
4919,47,23,1990,0,0,0
4920,47,63,1990,0,0,0
4921,47,37,1990,16,7,9
4922,47,64,1990,0,0,0
4923,47,128,1990,0,0,0
4924,47,115,1990,0,0,0
4925,47,65,1990,1450,615,835
4926,47,10,1990,0,0,0
4927,47,145,1990,0,0,0
4928,47,113,1990,0,0,0
4929,47,49,1990,478,164,314
4930,47,74,1990,23,9,14
4931,47,25,1990,0,0,0
4932,47,169,1990,1481,658,823
4933,47,166,1990,0,0,0
4934,47,146,1990,0,0,0
4935,47,26,1990,40,9,31
4936,47,170,1990,3341,1837,1504
4937,47,130,1990,0,0,0
4938,47,38,1990,43228,20452,22776
4939,47,27,1990,17,7,10
4940,47,50,1990,281,145,136
4941,47,131,1990,0,0,0
4942,47,114,1990,22,14,8
4943,47,171,1990,4197,2045,2152
4944,47,1,1990,66,18,48
4945,47,132,1990,0,0,0
4946,47,133,1990,0,0,0
4947,71,2,1990,0,0,0
4948,71,51,1990,290,139,151
4949,71,141,1990,98,40,58
4950,71,52,1990,0,0,0
4951,71,134,1990,0,0,0
4952,71,76,1990,0,0,0
4953,71,103,1990,38,19,19
4954,71,11,1990,0,0,0
4955,71,77,1990,0,0,0
4956,71,66,1990,512,311,201
4957,71,12,1990,0,0,0
4958,71,78,1990,0,0,0
4959,71,13,1990,0,0,0
4960,71,3,1990,29,12,17
4961,71,79,1990,0,0,0
4962,71,29,1990,42,39,3
4963,71,67,1990,11205,5883,5322
4964,71,151,1990,0,0,0
4965,71,4,1990,0,0,0
4966,71,53,1990,2334,1151,1183
4967,71,147,1990,0,0,0
4968,71,105,1990,288,194,94
4969,71,30,1990,42,25,17
4970,71,152,1990,0,0,0
4971,71,116,1990,0,0,0
4972,71,153,1990,1148,578,570
4973,71,135,1990,58,37,21
4974,71,136,1990,0,0,0
4975,71,106,1990,56,27,29
4976,71,172,1990,1017,520,497
4977,71,107,1990,26,18,8
4978,71,117,1990,0,0,0
4979,71,137,1990,0,0,0
4980,71,96,1990,0,0,0
4981,71,54,1990,400,194,206
4982,71,81,1990,23,15,8
4983,71,14,1990,3,1,2
4984,71,31,1990,76,44,32
4985,71,176,1990,0,0,0
4986,71,137,1990,94,50,44
4987,71,39,1990,1263,673,590
4988,71,118,1990,0,0,0
4989,71,82,1990,112,81,31
4990,71,83,1990,35,23,12
4991,71,108,1990,0,0,0
4992,71,142,1990,25,10,15
4993,71,97,1990,0,0,0
4994,71,138,1990,0,0,0
4995,71,119,1990,0,0,0
4996,71,40,1990,18,15,3
4997,71,148,1990,0,0,0
4998,71,120,1990,0,0,0
4999,71,42,1990,243,140,103
5000,71,68,1990,14367,7983,6384
5001,71,139,1990,0,0,0
5002,71,155,1990,0,0,0
5003,71,15,1990,0,0,0
5004,71,69,1990,12616,7870,4746
5005,71,156,1990,0,0,0
5006,71,55,1990,0,0,0
5007,71,56,1990,636,323,313
5008,71,84,1990,0,0,0
5009,71,98,1990,0,0,0
5010,71,157,1990,0,0,0
5011,71,158,1990,0,0,0
5012,71,110,1990,0,0,0
5013,71,85,1990,0,0,0
5014,71,99,1990,0,0,0
5015,71,32,1990,58,30,28
5016,71,43,1990,259,135,124
5017,71,5,1990,187,97,90
5018,71,6,1990,224,109,115
5019,71,16,1990,0,0,0
5020,71,44,1990,412,231,181
5021,71,17,1990,40,18,22
5022,71,57,1990,12479,5410,7069
5023,71,86,1990,0,0,0
5024,71,177,1990,336,179,157
5025,71,18,1990,0,0,0
5026,71,167,1990,0,0,0
5027,71,121,1990,0,0,0
5028,71,19,1990,0,0,0
5029,71,168,1990,0,0,0
5030,71,46,1990,8,7,1
5031,71,20,1990,34,21,13
5032,71,159,1990,0,0,0
5033,71,143,1990,0,0,0
5034,71,70,1990,0,0,0
5035,71,47,1990,13,9,4
5036,71,122,1990,0,0,0
5037,71,123,1990,0,0,0
5038,71,160,1990,0,0,0
5039,71,58,1990,13,6,7
5040,71,161,1990,0,0,0
5041,71,124,1990,51,36,15
5042,71,100,1990,27,20,7
5043,71,72,1990,0,0,0
5044,71,59,1990,2301,1056,1245
5045,71,144,1990,125,51,74
5046,71,125,1990,0,0,0
5047,71,150,1990,0,0,0
5048,71,8,1990,30,9,21
5049,71,73,1990,3092,1555,1537
5050,71,101,1990,0,0,0
5051,71,162,1990,0,0,0
5052,71,60,1990,1957,839,1118
5053,71,48,1990,171,87,84
5054,71,21,1990,0,0,0
5055,71,9,1990,0,0,0
5056,71,102,1990,0,0,0
5057,71,111,1990,0,0,0
5058,71,112,1990,96,60,36
5059,71,33,1990,722,413,309
5060,71,61,1990,30614,14150,16464
5061,71,22,1990,0,0,0
5062,71,35,1990,106,61,45
5063,71,36,1990,377,280,97
5064,71,126,1990,24,15,9
5065,71,92,1990,0,0,0
5066,71,62,1990,0,0,0
5067,71,140,1990,0,0,0
5068,71,23,1990,0,0,0
5069,71,164,1990,29,13,16
5070,71,63,1990,4602,2112,2490
5071,71,127,1990,0,0,0
5072,71,165,1990,0,0,0
5073,71,37,1990,69,39,30
5074,71,64,1990,54,26,28
5075,71,128,1990,0,0,0
5076,71,115,1990,45,23,22
5077,71,65,1990,1911,930,981
5078,71,10,1990,0,0,0
5079,71,145,1990,0,0,0
5080,71,113,1990,0,0,0
5081,71,49,1990,456,232,224
5082,71,74,1990,646,349,297
5083,71,25,1990,0,0,0
5084,71,169,1990,0,0,0
5085,71,166,1990,0,0,0
5086,71,93,1990,0,0,0
5087,71,146,1990,114,30,84
5088,71,26,1990,194,90,104
5089,71,170,1990,0,0,0
5090,71,130,1990,0,0,0
5091,71,38,1990,169,148,21
5092,71,27,1990,0,0,0
5093,71,50,1990,2355,1124,1231
5094,71,131,1990,0,0,0
5095,71,114,1990,0,0,0
5096,71,171,1990,0,0,0
5097,71,1,1990,70,48,22
5098,71,28,1990,0,0,0
5099,71,132,1990,0,0,0
5100,71,133,1990,0,0,0
5101,174,172,1990,172346,92054,80292
5102,174,173,1990,11736,5581,6155
5103,174,61,1990,3489,1642,1847
5104,122,172,1990,1481,654,827
5105,122,117,1990,8179,3614,4565
5106,122,68,1990,6672,2947,3725
5107,122,5,1990,1171,523,648
5108,123,116,1990,705,447,258
5109,123,137,1990,735,334,401
5110,123,137,1990,1338,850,488
5111,123,5,1990,1362,774,588
5112,123,125,1990,1075410,548271,527139
5113,123,126,1990,2249,1428,821
5114,123,128,1990,211,133,78
5115,123,115,1990,1276,881,395
5116,123,50,1990,769,370,399
5117,123,131,1990,3279,2161,1118
5118,123,132,1990,5637,4561,1076
5119,123,133,1990,3851,2727,1124
5120,7,66,1990,50,23,27
5121,7,3,1990,1623,731,892
5122,7,10,1990,4289,1930,2359
5123,7,68,1990,51,23,28
5124,7,69,1990,251,113,138
5125,7,5,1990,951,428,523
5126,7,57,1990,310,140,170
5127,7,177,1990,65,29,36
5128,7,20,1990,7,3,4
5129,7,9,1990,79,36,43
5130,7,49,1990,11,5,6
5131,7,74,1990,102,46,56
5132,7,142,1990,15,7,8
5133,7,50,1990,94,42,52
5134,160,2,1990,0,0,0
5135,160,51,1990,0,0,0
5136,160,141,1990,380,135,245
5137,160,52,1990,0,0,0
5138,160,134,1990,70,31,39
5139,160,135,1990,592,256,336
5140,160,136,1990,0,0,0
5141,160,106,1990,0,0,0
5142,160,172,1990,301,59,242
5143,160,137,1990,4022,1924,2098
5144,160,137,1990,0,0,0
5145,160,54,1990,0,0,0
5146,160,151,1990,542,227,315
5147,160,138,1990,0,0,0
5148,160,68,1990,2689,1246,1443
5149,160,139,1990,4463,2079,2384
5150,160,155,1990,595,272,323
5151,160,156,1990,1913,972,941
5152,160,84,1990,0,0,0
5153,160,157,1990,19164,9680,9484
5154,160,17,1990,0,0,0
5155,160,177,1990,0,0,0
5156,160,167,1990,0,0,0
5157,160,176,1990,0,0,0
5158,160,159,1990,586,290,296
5159,160,143,1990,0,0,0
5160,160,161,1990,14942,8212,6730
5161,160,144,1990,0,0,0
5162,160,162,1990,1590,727,863
5163,160,158,1990,0,0,0
5164,160,36,1990,384,202,182
5165,160,126,1990,0,0,0
5166,160,23,1990,0,0,0
5167,160,164,1990,12899,6412,6487
5168,160,165,1990,1227,598,629
5169,160,115,1990,0,0,0
5170,160,145,1990,0,0,0
5171,160,166,1990,893,367,526
5172,160,27,1990,0,0,0
5173,160,94,1990,0,0,0
5174,160,142,1990,0,0,0
5175,160,131,1990,0,0,0
5176,160,152,1990,23024,11419,11605
5177,160,114,1990,0,0,0
5178,160,132,1990,0,0,0
5179,58,51,1990,16,10,6
5180,58,141,1990,21,6,15
5181,58,103,1990,7,2,5
5182,58,11,1990,11,5,6
5183,58,66,1990,18,11,7
5184,58,3,1990,6,3,3
5185,58,29,1990,3,3,0
5186,58,67,1990,19,10,9
5187,58,53,1990,25,9,16
5188,58,105,1990,27,17,10
5189,58,30,1990,77,41,36
5190,58,172,1990,148,85,63
5191,58,54,1990,18,8,10
5192,58,14,1990,21,11,10
5193,58,31,1990,10,5,5
5194,58,39,1990,12,6,6
5195,58,142,1990,255,98,157
5196,58,119,1990,10,2,8
5197,58,120,1990,25,12,13
5198,58,42,1990,8,7,1
5199,58,68,1990,97,54,43
5200,58,15,1990,12,6,6
5201,58,69,1990,323,195,128
5202,58,156,1990,6,1,5
5203,58,56,1990,11,4,7
5204,58,32,1990,5,4,1
5205,58,5,1990,130,35,95
5206,58,6,1990,9,3,6
5207,58,16,1990,32,11,21
5208,58,44,1990,47,30,17
5209,58,17,1990,8,3,5
5210,58,57,1990,665,287,378
5211,58,177,1990,15,13,2
5212,58,18,1990,12,1,11
5213,58,121,1990,18,10,8
5214,58,19,1990,8,0,8
5215,58,46,1990,4,1,3
5216,58,20,1990,30,14,16
5217,58,143,1990,435,204,231
5218,58,47,1990,3,1,2
5219,58,144,1990,83,65,18
5220,58,73,1990,72,34,38
5221,58,162,1990,51,12,39
5222,58,60,1990,14,8,6
5223,58,48,1990,5,2,3
5224,58,9,1990,54,37,17
5225,58,112,1990,8,5,3
5226,58,33,1990,20,13,7
5227,58,61,1990,3,2,1
5228,58,35,1990,76,45,31
5229,58,36,1990,129,96,33
5230,58,23,1990,11,6,5
5231,58,63,1990,101,40,61
5232,58,37,1990,13,7,6
5233,58,64,1990,6,2,4
5234,58,128,1990,7,2,5
5235,58,115,1990,45,25,20
5236,58,65,1990,11,6,5
5237,58,10,1990,9,4,5
5238,58,145,1990,8,1,7
5239,58,49,1990,28,13,15
5240,58,74,1990,17,7,10
5241,58,25,1990,101,20,81
5242,58,93,1990,9,7,2
5243,58,146,1990,161,71,90
5244,58,26,1990,79,27,52
5245,58,38,1990,30,24,6
5246,58,27,1990,6,3,3
5247,58,50,1990,5333,3044,2289
5248,58,171,1990,7,5,2
5249,58,133,1990,15,6,9
5250,161,141,1990,1450,642,808
5251,161,103,1990,60,31,29
5252,161,67,1990,56,31,25
5253,161,105,1990,143,69,74
5254,161,135,1990,350,161,189
5255,161,136,1990,47,23,24
5256,161,172,1990,142,123,19
5257,161,137,1990,31,18,13
5258,161,151,1990,491,260,231
5259,161,139,1990,77,42,35
5260,161,156,1990,186,134,52
5261,161,157,1990,2748,1897,851
5262,161,16,1990,77,44,33
5263,161,57,1990,50,28,22
5264,161,19,1990,29,20,9
5265,161,20,1990,106,65,41
5266,161,143,1990,124,69,55
5267,161,160,1990,6776,4112,2664
5268,161,144,1990,306,164,142
5269,161,158,1990,1067,766,301
5270,161,36,1990,56,17,39
5271,161,23,1990,273,140,133
5272,161,164,1990,94138,43615,50523
5273,161,65,1990,77,39,38
5274,161,25,1990,125,77,48
5275,161,166,1990,104,77,27
5276,161,27,1990,62,38,24
5277,161,146,1990,221,129,92
5278,161,142,1990,202,113,89
5279,124,3,1990,71,50,21
5280,124,67,1990,76,16,60
5281,124,10,1990,9,7,2
5282,124,172,1990,346,76,270
5283,124,68,1990,788,414,374
5284,124,69,1990,57,24,33
5285,124,173,1990,91,42,49
5286,124,5,1990,515,263,252
5287,124,44,1990,30,16,14
5288,124,57,1990,38,21,17
5289,124,177,1990,23,11,12
5290,124,122,1990,56,34,22
5291,124,9,1990,1,0,1
5292,124,36,1990,34,25,9
5293,124,127,1990,43,31,12
5294,124,115,1990,184,112,72
5295,124,65,1990,15,5,10
5296,124,74,1990,66,22,44
5297,124,50,1990,694,390,304
5298,100,141,1990,47,23,24
5299,100,134,1990,39,18,21
5300,100,103,1990,4340,2198,2142
5301,100,66,1990,429,220,209
5302,100,3,1990,35,12,23
5303,100,11,1990,60,27,33
5304,100,67,1990,730,335,395
5305,100,105,1990,1682,900,782
5306,100,95,1990,1415,819,596
5307,100,30,1990,69,23,46
5308,100,135,1990,5,2,3
5309,100,106,1990,2783,1443,1340
5310,100,172,1990,1240,456,784
5311,100,107,1990,4660,2388,2272
5312,100,137,1990,12,0,12
5313,100,96,1990,2088,1305,783
5314,100,54,1990,64,30,34
5315,100,81,1990,2660,1522,1138
5316,100,31,1990,348,116,232
5317,100,39,1990,255,104,151
5318,100,83,1990,522,243,279
5319,100,108,1990,719,381,338
5320,100,97,1990,301106,150310,150796
5321,100,42,1990,35,23,12
5322,100,68,1990,4190,2090,2100
5323,100,69,1990,4560,2239,2321
5324,100,56,1990,255,104,151
5325,100,98,1990,72343,35769,36574
5326,100,85,1990,475,92,383
5327,100,99,1990,1990,1035,955
5328,100,32,1990,290,150,140
5329,100,5,1990,128,35,93
5330,100,6,1990,58,12,46
5331,100,16,1990,23,23,0
5332,100,44,1990,186,81,105
5333,100,17,1990,1195,542,653
5334,100,57,1990,3503,1385,2118
5335,100,86,1990,116,92,24
5336,100,177,1990,3096,1420,1676
5337,100,18,1990,35,0,35
5338,100,121,1990,69,58,11
5339,100,176,1990,336,185,151
5340,100,20,1990,1542,704,838
5341,100,46,1990,21,10,11
5342,100,47,1990,78,50,28
5343,100,144,1990,186,104,82
5344,100,73,1990,638,312,326
5345,100,101,1990,3096,1500,1596
5346,100,162,1990,69,12,57
5347,100,48,1990,58,23,35
5348,100,9,1990,23,12,11
5349,100,102,1990,25641,12685,12956
5350,100,111,1990,290,92,198
5351,100,112,1990,2981,1351,1630
5352,100,33,1990,1693,1120,573
5353,100,61,1990,163,35,128
5354,100,88,1990,1287,658,629
5355,100,35,1990,278,104,174
5356,100,36,1990,1171,611,560
5357,100,23,1990,186,92,94
5358,100,164,1990,23,0,23
5359,100,63,1990,5,3,2
5360,100,37,1990,69,46,23
5361,100,1,1990,81,23,58
5362,100,64,1990,39,16,23
5363,100,115,1990,87,45,42
5364,100,65,1990,24620,11147,13473
5365,100,49,1990,324,162,162
5366,100,74,1990,1195,485,710
5367,100,25,1990,510,162,348
5368,100,93,1990,32,12,20
5369,100,26,1990,290,162,128
5370,100,38,1990,250,134,116
5371,100,142,1990,197,104,93
5372,100,50,1990,2273,1074,1199
5373,100,114,1990,1113,519,594
5374,72,68,1990,7679,4490,3189
5375,72,57,1990,3886,1653,2233
5376,59,51,1990,0,0,0
5377,59,66,1990,0,0,0
5378,59,53,1990,0,0,0
5379,59,30,1990,0,0,0
5380,59,54,1990,0,0,0
5381,59,31,1990,0,0,0
5382,59,39,1990,0,0,0
5383,59,68,1990,0,0,0
5384,59,69,1990,0,0,0
5385,59,56,1990,0,0,0
5386,59,32,1990,0,0,0
5387,59,57,1990,0,0,0
5388,59,71,1990,0,0,0
5389,59,73,1990,0,0,0
5390,59,33,1990,0,0,0
5391,59,35,1990,0,0,0
5392,59,36,1990,0,0,0
5393,59,63,1990,0,0,0
5394,59,37,1990,0,0,0
5395,59,64,1990,0,0,0
5396,59,49,1990,0,0,0
5397,59,74,1990,0,0,0
5398,59,26,1990,0,0,0
5399,59,38,1990,0,0,0
5400,59,60,1990,0,0,0
5401,59,50,1990,0,0,0
5402,87,76,1990,172,90,82
5403,87,82,1990,412,220,192
5404,87,83,1990,37,12,25
5405,87,110,1990,359,150,209
5406,87,90,1990,176,101,75
5407,87,92,1990,45,15,30
5408,87,93,1990,66,27,39
5409,87,50,1990,156,75,81
5410,144,141,1990,9188,4330,4858
5411,144,67,1990,959,451,508
5412,144,137,1990,1286,606,680
5413,144,68,1990,15056,7095,7961
5414,144,69,1990,984,463,521
5415,144,157,1990,673,317,356
5416,144,16,1990,1171,551,620
5417,144,57,1990,1296,610,686
5418,144,20,1990,923,434,489
5419,144,143,1990,803,378,425
5420,144,161,1990,1088,512,576
5421,144,164,1990,1233,581,652
5422,144,65,1990,2802,1320,1482
5423,144,25,1990,1399,659,740
5424,144,146,1990,1763,830,933
5425,144,142,1990,1271,598,673
5426,144,50,1990,828,390,438
5427,125,134,1990,14337,6596,7741
5428,125,116,1990,615,281,334
5429,125,153,1990,2500,1090,1410
5430,125,137,1990,2315,1061,1254
5431,125,5,1990,900,304,596
5432,125,121,1990,9087,4256,4831
5433,125,149,1990,2875,1455,1420
5434,125,123,1990,22975,10351,12624
5435,125,162,1990,1964,928,1036
5436,125,9,1990,516,175,341
5437,125,61,1990,1667,532,1135
5438,125,127,1990,6212,3041,3171
5439,125,115,1990,7397,3331,4066
5440,125,133,1990,35711,16816,18895
5441,125,131,1990,2722,1179,1543
5442,125,132,1990,1948,914,1034
5443,150,2,1990,64,38,26
5444,150,141,1990,716,380,336
5445,150,134,1990,24028,8935,15093
5446,150,76,1990,693,418,275
5447,150,103,1990,74,47,27
5448,150,66,1990,901,418,483
5449,150,78,1990,74,55,19
5450,150,13,1990,72,52,20
5451,150,3,1990,48,18,30
5452,150,11,1990,94,1,93
5453,150,67,1990,272,136,136
5454,150,147,1990,975,504,471
5455,150,105,1990,790,464,326
5456,150,30,1990,45,35,10
5457,150,116,1990,575,227,348
5458,150,135,1990,175,31,144
5459,150,106,1990,48,14,34
5460,150,172,1990,4593,1306,3287
5461,150,137,1990,1652,697,955
5462,150,137,1990,4707,2453,2254
5463,150,81,1990,1005,601,404
5464,150,31,1990,112,77,35
5465,150,151,1990,230,131,99
5466,150,39,1990,168,55,113
5467,150,120,1990,312,214,98
5468,150,42,1990,116,84,32
5469,150,68,1990,793,439,354
5470,150,155,1990,128,71,57
5471,150,69,1990,13401,7781,5620
5472,150,156,1990,212,88,124
5473,150,157,1990,79,31,48
5474,150,5,1990,997,348,649
5475,150,6,1990,45,18,27
5476,150,44,1990,89,47,42
5477,150,17,1990,161,71,90
5478,150,57,1990,1219,677,542
5479,150,177,1990,168,105,63
5480,150,121,1990,1641,819,822
5481,150,176,1990,149,0,149
5482,150,20,1990,68,27,41
5483,150,149,1990,186,97,89
5484,150,143,1990,52,27,25
5485,150,71,1990,64,35,29
5486,150,123,1990,545,256,289
5487,150,124,1990,158,94,64
5488,150,125,1990,203,88,115
5489,150,73,1990,763,393,370
5490,150,162,1990,1453,568,885
5491,150,48,1990,79,52,27
5492,150,9,1990,246,27,219
5493,150,33,1990,249,164,85
5494,150,61,1990,641,264,377
5495,150,35,1990,45,21,24
5496,150,36,1990,672,280,392
5497,150,126,1990,530,236,294
5498,150,164,1990,45,18,27
5499,150,127,1990,84,52,32
5500,150,165,1990,242,131,111
5501,150,128,1990,138,42,96
5502,150,115,1990,12536,6325,6211
5503,150,133,1990,21364,10613,10751
5504,150,65,1990,508,210,298
5505,150,145,1990,294,164,130
5506,150,148,1990,290,160,130
5507,150,49,1990,149,81,68
5508,150,74,1990,634,368,266
5509,150,26,1990,52,21,31
5510,150,130,1990,712,352,360
5511,150,38,1990,380,52,328
5512,150,142,1990,257,101,156
5513,150,50,1990,2540,1478,1062
5514,150,131,1990,1624,830,794
5515,150,152,1990,105,55,50
5516,150,132,1990,4473,1584,2889
5517,8,3,1990,500,457,43
5518,8,4,1990,16805,8740,8065
5519,8,10,1990,78,34,44
5520,8,172,1990,21906,12458,9448
5521,8,5,1990,369370,267540,101830
5522,8,9,1990,2371,1485,886
5523,73,2,1990,9865,4079,5786
5524,73,51,1990,181,74,107
5525,73,141,1990,1764,509,1255
5526,73,52,1990,0,0,0
5527,73,134,1990,1727,609,1118
5528,73,75,1990,7,3,4
5529,73,76,1990,11,5,6
5530,73,103,1990,1614,862,752
5531,73,11,1990,43,20,23
5532,73,77,1990,557,255,302
5533,73,66,1990,6902,3937,2965
5534,73,12,1990,40,23,17
5535,73,78,1990,24,9,15
5536,73,13,1990,49,25,24
5537,73,3,1990,401,256,145
5538,73,79,1990,37,14,23
5539,73,29,1990,14,5,9
5540,73,67,1990,41730,22983,18747
5541,73,95,1990,0,0,0
5542,73,151,1990,53,18,35
5543,73,4,1990,9,1,8
5544,73,53,1990,131,60,71
5545,73,147,1990,89,43,46
5546,73,105,1990,3820,2202,1618
5547,73,30,1990,827,496,331
5548,73,152,1990,91,31,60
5549,73,116,1990,222,100,122
5550,73,153,1990,7912,3859,4053
5551,73,135,1990,431,204,227
5552,73,80,1990,0,0,0
5553,73,136,1990,28,11,17
5554,73,106,1990,2655,1312,1343
5555,73,172,1990,20779,10397,10382
5556,73,107,1990,4915,2739,2176
5557,73,117,1990,0,0,0
5558,73,137,1990,295,121,174
5559,73,96,1990,207,106,101
5560,73,54,1990,38,17,21
5561,73,81,1990,313,179,134
5562,73,14,1990,124,47,77
5563,73,31,1990,3382,2257,1125
5564,73,176,1990,2,0,2
5565,73,137,1990,2252,901,1351
5566,73,39,1990,2095,1261,834
5567,73,118,1990,48,22,26
5568,73,82,1990,33,17,16
5569,73,83,1990,2403,1673,730
5570,73,108,1990,439,255,184
5571,73,142,1990,4725,1046,3679
5572,73,97,1990,134,73,61
5573,73,138,1990,9,3,6
5574,73,119,1990,155,64,91
5575,73,40,1990,83,58,25
5576,73,148,1990,36,17,19
5577,73,120,1990,3852,1615,2237
5578,73,41,1990,0,0,0
5579,73,42,1990,1130,772,358
5580,73,68,1990,13064,7081,5983
5581,73,139,1990,35,17,18
5582,73,155,1990,112,25,87
5583,73,15,1990,32,14,18
5584,73,69,1990,127898,74548,53350
5585,73,156,1990,6020,2785,3235
5586,73,55,1990,11,1,10
5587,73,56,1990,5206,1748,3458
5588,73,84,1990,14,5,9
5589,73,98,1990,165,82,83
5590,73,157,1990,392,66,326
5591,73,158,1990,74,28,46
5592,73,110,1990,1803,1125,678
5593,73,85,1990,271,131,140
5594,73,99,1990,125,77,48
5595,73,32,1990,4740,2716,2024
5596,73,43,1990,188,100,88
5597,73,5,1990,7540,3440,4100
5598,73,6,1990,5187,2087,3100
5599,73,16,1990,1151,407,744
5600,73,44,1990,3733,1938,1795
5601,73,45,1990,0,0,0
5602,73,17,1990,2958,1213,1745
5603,73,57,1990,14055,4278,9777
5604,73,86,1990,392,239,153
5605,73,177,1990,4076,2062,2014
5606,73,18,1990,389,140,249
5607,73,167,1990,4,0,4
5608,73,121,1990,999,518,481
5609,73,19,1990,647,256,391
5610,73,168,1990,0,0,0
5611,73,46,1990,128,84,44
5612,73,20,1990,1682,667,1015
5613,73,149,1990,41,19,22
5614,73,159,1990,980,283,697
5615,73,143,1990,199,69,130
5616,73,70,1990,0,0,0
5617,73,47,1990,172,131,41
5618,73,71,1990,399,211,188
5619,73,122,1990,68,38,30
5620,73,123,1990,110,52,58
5621,73,7,1990,0,0,0
5622,73,160,1990,48,20,28
5623,73,58,1990,106,61,45
5624,73,161,1990,163,4,159
5625,73,124,1990,145,85,60
5626,73,100,1990,658,371,287
5627,73,72,1990,23,12,11
5628,73,59,1990,0,0,0
5629,73,87,1990,0,0,0
5630,73,144,1990,114850,49535,65315
5631,73,125,1990,216,103,113
5632,73,150,1990,68,38,30
5633,73,8,1990,206,98,108
5634,73,101,1990,133,74,59
5635,73,162,1990,1410,492,918
5636,73,60,1990,5,2,3
5637,73,48,1990,1733,1019,714
5638,73,21,1990,175,86,89
5639,73,9,1990,6717,2447,4270
5640,73,102,1990,101,44,57
5641,73,111,1990,78,45,33
5642,73,112,1990,1040,644,396
5643,73,33,1990,9026,6231,2795
5644,73,61,1990,7814,3728,4086
5645,73,22,1990,15,8,7
5646,73,35,1990,1665,974,691
5647,73,36,1990,2561,1563,998
5648,73,126,1990,304,134,170
5649,73,90,1990,21,9,12
5650,73,91,1990,20,8,12
5651,73,92,1990,20,10,10
5652,73,62,1990,0,0,0
5653,73,140,1990,57,27,30
5654,73,23,1990,446,207,239
5655,73,164,1990,303,85,218
5656,73,63,1990,14216,6735,7481
5657,73,127,1990,39,23,16
5658,73,165,1990,634,129,505
5659,73,37,1990,14,5,9
5660,73,64,1990,7,2,5
5661,73,128,1990,1859,789,1070
5662,73,115,1990,6568,3413,3155
5663,73,129,1990,0,0,0
5664,73,65,1990,17357,8181,9176
5665,73,10,1990,4699,2039,2660
5666,73,145,1990,1725,419,1306
5667,73,113,1990,156211,80807,75404
5668,73,49,1990,2144,1214,930
5669,73,74,1990,4279,2421,1858
5670,73,25,1990,2035,867,1168
5671,73,169,1990,61,51,10
5672,73,166,1990,305,77,228
5673,73,93,1990,225,132,93
5674,73,146,1990,2632,785,1847
5675,73,26,1990,140494,64505,75989
5676,73,170,1990,0,0,0
5677,73,94,1990,0,0,0
5678,73,130,1990,321,142,179
5679,73,38,1990,46,18,28
5680,73,27,1990,20,5,15
5681,73,50,1990,36211,15944,20267
5682,73,131,1990,546,266,280
5683,73,114,1990,284,129,155
5684,73,171,1990,4895,2269,2626
5685,73,1,1990,7130,3363,3767
5686,73,28,1990,66,18,48
5687,73,132,1990,411,198,213
5688,73,133,1990,1521,765,756
5689,101,2,1990,27,11,16
5690,101,141,1990,50,23,27
5691,101,76,1990,35,17,18
5692,101,103,1990,185,80,105
5693,101,66,1990,54,21,33
5694,101,78,1990,23,11,12
5695,101,67,1990,52,16,36
5696,101,105,1990,138,85,53
5697,101,95,1990,60,27,33
5698,101,30,1990,88,60,28
5699,101,106,1990,144,50,94
5700,101,172,1990,55,11,44
5701,101,107,1990,298,155,143
5702,101,137,1990,21,6,15
5703,101,96,1990,5959,3065,2894
5704,101,81,1990,896,362,534
5705,101,39,1990,55,20,35
5706,101,83,1990,65,33,32
5707,101,108,1990,98,43,55
5708,101,97,1990,12443,6119,6324
5709,101,120,1990,36,12,24
5710,101,68,1990,139,60,79
5711,101,69,1990,374,165,209
5712,101,98,1990,1134,551,583
5713,101,85,1990,25,6,19
5714,101,99,1990,10105,5152,4953
5715,101,5,1990,12,3,9
5716,101,44,1990,15,8,7
5717,101,57,1990,187,63,124
5718,101,86,1990,39,16,23
5719,101,177,1990,54,18,36
5720,101,18,1990,13,2,11
5721,101,100,1990,925,530,395
5722,101,73,1990,117,56,61
5723,101,162,1990,11,6,5
5724,101,102,1990,442,226,216
5725,101,112,1990,221,96,125
5726,101,88,1990,54,30,24
5727,101,36,1990,387,239,148
5728,101,164,1990,83,41,42
5729,101,128,1990,17,12,5
5730,101,65,1990,557,240,317
5731,101,49,1990,55,32,23
5732,101,74,1990,95,30,65
5733,101,38,1990,80,52,28
5734,101,50,1990,46,17,29
5735,101,114,1990,11,6,5
5736,101,28,1990,13,8,5
5737,162,135,1990,10242,4496,5746
5738,162,136,1990,11111,4877,6234
5739,162,151,1990,96599,42406,54193
5740,162,156,1990,75322,33066,42256
5741,162,159,1990,7823,3434,4389
5742,162,160,1990,14578,6399,8179
5743,162,165,1990,1553,681,872
5744,162,166,1990,46886,20582,26304
5745,176,3,1990,74,53,21
5746,176,105,1990,479,235,244
5747,176,10,1990,120,96,24
5748,176,172,1990,19668,8927,10741
5749,176,173,1990,97,46,51
5750,176,5,1990,178,85,93
5751,176,177,1990,180,82,98
5752,176,9,1990,72,33,39
5753,176,112,1990,87,43,44
5754,176,36,1990,43,20,23
5755,176,1,1990,716,287,429
5756,176,50,1990,188,78,110
5757,60,51,1990,45001,26242,18759
5758,60,53,1990,4365,2545,1820
5759,60,30,1990,1075,627,448
5760,60,54,1990,1437,838,599
5761,60,31,1990,54,31,23
5762,60,69,1990,43,25,18
5763,60,56,1990,235,137,98
5764,60,32,1990,82,48,34
5765,60,57,1990,39,23,16
5766,60,59,1990,9247,5392,3855
5767,60,33,1990,101,59,42
5768,60,35,1990,24,14,10
5769,60,36,1990,217,127,90
5770,60,63,1990,17950,10468,7482
5771,60,37,1990,38,22,16
5772,60,64,1990,258,150,108
5773,60,26,1990,11417,6657,4760
5774,60,38,1990,65,38,27
5775,60,142,1990,1969,1148,821
5776,48,2,1990,253,67,186
5777,48,51,1990,21,8,13
5778,48,141,1990,448,91,357
5779,48,52,1990,0,0,0
5780,48,134,1990,30,15,15
5781,48,76,1990,0,0,0
5782,48,103,1990,445,242,203
5783,48,11,1990,4,0,4
5784,48,77,1990,0,0,0
5785,48,66,1990,997,477,520
5786,48,12,1990,0,0,0
5787,48,78,1990,7,3,4
5788,48,13,1990,6,3,3
5789,48,3,1990,558,208,350
5790,48,79,1990,9,4,5
5791,48,29,1990,0,0,0
5792,48,67,1990,782,433,349
5793,48,95,1990,0,0,0
5794,48,151,1990,11,0,11
5795,48,4,1990,5,0,5
5796,48,53,1990,3,0,3
5797,48,147,1990,35,21,14
5798,48,105,1990,576,361,215
5799,48,30,1990,369,135,234
5800,48,152,1990,19,3,16
5801,48,116,1990,0,0,0
5802,48,153,1990,163,72,91
5803,48,135,1990,121,50,71
5804,48,80,1990,0,0,0
5805,48,136,1990,7,0,7
5806,48,106,1990,5496,2379,3117
5807,48,172,1990,1862,793,1069
5808,48,173,1990,728,307,421
5809,48,174,1990,17,4,13
5810,48,107,1990,1618,712,906
5811,48,117,1990,0,0,0
5812,48,137,1990,132,65,67
5813,48,96,1990,130,67,63
5814,48,54,1990,7,3,4
5815,48,81,1990,44,22,22
5816,48,14,1990,70,12,58
5817,48,31,1990,148,67,81
5818,48,176,1990,26,12,14
5819,48,137,1990,32,13,19
5820,48,39,1990,21160,11164,9996
5821,48,118,1990,6,3,3
5822,48,82,1990,0,0,0
5823,48,83,1990,53,38,15
5824,48,108,1990,177,87,90
5825,48,142,1990,290,75,215
5826,48,97,1990,54,29,25
5827,48,138,1990,0,0,0
5828,48,119,1990,19,5,14
5829,48,40,1990,23,10,13
5830,48,148,1990,0,0,0
5831,48,120,1990,1681,567,1114
5832,48,41,1990,527,315,212
5833,48,42,1990,4257,2445,1812
5834,48,68,1990,2433,1197,1236
5835,48,139,1990,0,0,0
5836,48,155,1990,570,123,447
5837,48,15,1990,0,0,0
5838,48,69,1990,8821,4926,3895
5839,48,156,1990,736,182,554
5840,48,55,1990,0,0,0
5841,48,56,1990,475,115,360
5842,48,84,1990,0,0,0
5843,48,98,1990,208,100,108
5844,48,157,1990,29,9,20
5845,48,158,1990,9,3,6
5846,48,110,1990,67,39,28
5847,48,85,1990,6,3,3
5848,48,99,1990,57,28,29
5849,48,32,1990,1356,515,841
5850,48,43,1990,2221,1186,1035
5851,48,5,1990,4422,1937,2485
5852,48,6,1990,5198,1752,3446
5853,48,16,1990,738,202,536
5854,48,44,1990,446,258,188
5855,48,45,1990,0,0,0
5856,48,17,1990,422,160,262
5857,48,57,1990,1090,353,737
5858,48,86,1990,44,27,17
5859,48,177,1990,826,506,320
5860,48,18,1990,48,17,31
5861,48,167,1990,0,0,0
5862,48,121,1990,489,220,269
5863,48,19,1990,24,11,13
5864,48,168,1990,0,0,0
5865,48,46,1990,15,4,11
5866,48,20,1990,590,190,400
5867,48,149,1990,0,0,0
5868,48,159,1990,66,33,33
5869,48,143,1990,57,6,51
5870,48,70,1990,3,0,3
5871,48,47,1990,8,5,3
5872,48,71,1990,58,28,30
5873,48,122,1990,337,158,179
5874,48,123,1990,8,3,5
5875,48,7,1990,0,0,0
5876,48,160,1990,5,0,5
5877,48,58,1990,37,16,21
5878,48,161,1990,3,0,3
5879,48,124,1990,145,74,71
5880,48,100,1990,208,121,87
5881,48,72,1990,0,0,0
5882,48,59,1990,0,0,0
5883,48,87,1990,0,0,0
5884,48,144,1990,2393,727,1666
5885,48,125,1990,22,12,10
5886,48,150,1990,19,9,10
5887,48,8,1990,52,23,29
5888,48,73,1990,3268,1702,1566
5889,48,101,1990,35,23,12
5890,48,162,1990,306,85,221
5891,48,60,1990,0,0,0
5892,48,21,1990,10,7,3
5893,48,9,1990,10470,4345,6125
5894,48,102,1990,12,7,5
5895,48,111,1990,50,31,19
5896,48,112,1990,277,137,140
5897,48,33,1990,4367,2385,1982
5898,48,61,1990,600,241,359
5899,48,88,1990,0,0,0
5900,48,22,1990,0,0,0
5901,48,35,1990,286,136,150
5902,48,36,1990,61,40,21
5903,48,126,1990,6,3,3
5904,48,90,1990,0,0,0
5905,48,91,1990,0,0,0
5906,48,92,1990,0,0,0
5907,48,62,1990,0,0,0
5908,48,140,1990,0,0,0
5909,48,23,1990,36,16,20
5910,48,164,1990,36,12,24
5911,48,63,1990,0,0,0
5912,48,127,1990,0,0,0
5913,48,165,1990,143,29,114
5914,48,37,1990,6,3,3
5915,48,64,1990,0,0,0
5916,48,128,1990,1286,360,926
5917,48,115,1990,629,320,309
5918,48,129,1990,0,0,0
5919,48,65,1990,1321,510,811
5920,48,10,1990,4707,1434,3273
5921,48,145,1990,68,20,48
5922,48,113,1990,10,4,6
5923,48,49,1990,20429,11246,9183
5924,48,74,1990,1151,612,539
5925,48,25,1990,194,62,132
5926,48,169,1990,0,0,0
5927,48,166,1990,53,5,48
5928,48,93,1990,221,112,109
5929,48,146,1990,375,53,322
5930,48,26,1990,4977,1901,3076
5931,48,170,1990,0,0,0
5932,48,94,1990,0,0,0
5933,48,130,1990,242,96,146
5934,48,38,1990,6,3,3
5935,48,27,1990,27,11,16
5936,48,50,1990,14586,6685,7901
5937,48,131,1990,248,91,157
5938,48,114,1990,145,78,67
5939,48,171,1990,3,0,3
5940,48,1,1990,7522,3288,4234
5941,48,28,1990,13,4,9
5942,48,132,1990,115,49,66
5943,48,133,1990,70,31,39
5944,21,13,1990,106,56,50
5945,21,3,1990,50041,718,49323
5946,21,10,1990,13996,9423,4573
5947,21,68,1990,200,68,132
5948,21,5,1990,152554,21957,130597
5949,21,16,1990,118,52,66
5950,21,18,1990,4527,1888,2639
5951,21,19,1990,64,22,42
5952,21,73,1990,611,269,342
5953,21,9,1990,35675,4301,31374
5954,21,22,1990,27,16,11
5955,21,23,1990,215,60,155
5956,21,129,1990,0,0,0
5957,21,145,1990,4910,2063,2847
5958,21,27,1990,2702,1140,1562
5959,21,142,1990,18811,8541,10270
5960,21,50,1990,4260,1394,2866
5961,9,2,1990,3374973,1651680,1723293
5962,9,10,1990,889,425,464
5963,9,172,1990,490,207,283
5964,9,5,1990,2818248,1285346,1532902
5965,9,6,1990,4108,1862,2246
5966,9,16,1990,894,435,459
5967,102,103,1990,580,276,304
5968,102,66,1990,41,15,26
5969,102,3,1990,7,0,7
5970,102,79,1990,137,84,53
5971,102,67,1990,26,7,19
5972,102,105,1990,633,386,247
5973,102,95,1990,64,30,34
5974,102,30,1990,25,8,17
5975,102,106,1990,998,494,504
5976,102,172,1990,10235,4293,5942
5977,102,107,1990,13968,7066,6902
5978,102,96,1990,3919,2236,1683
5979,102,54,1990,36,4,32
5980,102,81,1990,3267,1480,1787
5981,102,31,1990,16,8,8
5982,102,39,1990,19,7,12
5983,102,82,1990,12,8,4
5984,102,83,1990,1474,1057,417
5985,102,108,1990,1414,531,883
5986,102,97,1990,2396,1113,1283
5987,102,42,1990,7,3,4
5988,102,68,1990,260,116,144
5989,102,15,1990,0,0,0
5990,102,69,1990,284,109,175
5991,102,56,1990,235,69,166
5992,102,84,1990,21,15,6
5993,102,98,1990,376,185,191
5994,102,110,1990,46,14,32
5995,102,85,1990,122,62,60
5996,102,99,1990,638,346,292
5997,102,173,1990,187,87,100
5998,102,32,1990,79,47,32
5999,102,5,1990,1474,587,887
6000,102,6,1990,31,7,24
6001,102,44,1990,9,3,6
6002,102,17,1990,414,145,269
6003,102,57,1990,454,170,284
6004,102,86,1990,942,548,394
6005,102,177,1990,169,65,104
6006,102,18,1990,43,13,30
6007,102,20,1990,282,106,176
6008,102,143,1990,11,5,6
6009,102,47,1990,15,4,11
6010,102,100,1990,1393,839,554
6011,102,144,1990,24,9,15
6012,102,73,1990,79,30,49
6013,102,101,1990,4553,2437,2116
6014,102,162,1990,7,1,6
6015,102,48,1990,7,4,3
6016,102,9,1990,43,18,25
6017,102,111,1990,38,24,14
6018,102,112,1990,1781,729,1052
6019,102,33,1990,67,22,45
6020,102,61,1990,177,52,125
6021,102,88,1990,253,96,157
6022,102,35,1990,38,14,24
6023,102,36,1990,408,239,169
6024,102,23,1990,18,5,13
6025,102,63,1990,27,7,20
6026,102,37,1990,5,1,4
6027,102,1,1990,5,2,3
6028,102,115,1990,12,6,6
6029,102,65,1990,2506,927,1579
6030,102,49,1990,27,9,18
6031,102,74,1990,84,32,52
6032,102,25,1990,83,30,53
6033,102,93,1990,64,29,35
6034,102,26,1990,33,12,21
6035,102,38,1990,66,26,40
6036,102,142,1990,21,12,9
6037,102,50,1990,319,114,205
6038,102,114,1990,147,63,84
6039,111,103,1990,50447,25381,25066
6040,111,105,1990,111355,51989,59366
6041,111,106,1990,2460,1094,1366
6042,111,172,1990,1953,864,1089
6043,111,68,1990,491,205,286
6044,111,69,1990,2108,898,1210
6045,111,57,1990,699,284,415
6046,111,177,1990,2648,1224,1424
6047,111,100,1990,3059,1547,1512
6048,111,33,1990,696,344,352
6049,111,65,1990,1114,475,639
6050,111,50,1990,140,67,73
6051,111,114,1990,3293,1453,1840
6052,112,141,1990,10,3,7
6053,112,134,1990,8,5,3
6054,112,103,1990,7080,3578,3502
6055,112,66,1990,122,54,68
6056,112,67,1990,381,181,200
6057,112,105,1990,3030,1685,1345
6058,112,30,1990,41,16,25
6059,112,106,1990,4479,2389,2090
6060,112,172,1990,2548,1143,1405
6061,112,107,1990,3702,1956,1746
6062,112,96,1990,209,108,101
6063,112,54,1990,56,11,45
6064,112,81,1990,563,227,336
6065,112,31,1990,55,24,31
6066,112,39,1990,150,67,83
6067,112,83,1990,111,56,55
6068,112,108,1990,2488,1422,1066
6069,112,97,1990,66,34,32
6070,112,40,1990,9,4,5
6071,112,42,1990,43,22,21
6072,112,68,1990,1439,662,777
6073,112,109,1990,20,11,9
6074,112,69,1990,1823,891,932
6075,112,56,1990,35,9,26
6076,112,98,1990,100,50,50
6077,112,85,1990,29,17,12
6078,112,99,1990,102,62,40
6079,112,32,1990,39,19,20
6080,112,43,1990,8,0,8
6081,112,5,1990,128,48,80
6082,112,6,1990,34,10,24
6083,112,16,1990,10,1,9
6084,112,44,1990,130,64,66
6085,112,17,1990,315,122,193
6086,112,57,1990,2086,930,1156
6087,112,177,1990,2090,1030,1060
6088,112,18,1990,23,5,18
6089,112,176,1990,53,23,30
6090,112,20,1990,42,17,25
6091,112,71,1990,8,3,5
6092,112,58,1990,12,0,12
6093,112,100,1990,930,490,440
6094,112,144,1990,23,7,16
6095,112,73,1990,421,189,232
6096,112,101,1990,99,60,39
6097,112,48,1990,64,28,36
6098,112,9,1990,44,9,35
6099,112,102,1990,214,108,106
6100,112,111,1990,339,185,154
6101,112,33,1990,123,60,63
6102,112,61,1990,79,27,52
6103,112,88,1990,84,45,39
6104,112,35,1990,113,61,52
6105,112,36,1990,391,247,144
6106,112,92,1990,13,9,4
6107,112,23,1990,19,8,11
6108,112,64,1990,16,7,9
6109,112,115,1990,71,26,45
6110,112,65,1990,3165,1482,1683
6111,112,49,1990,175,81,94
6112,112,74,1990,485,223,262
6113,112,26,1990,32,11,21
6114,112,38,1990,149,97,52
6115,112,142,1990,11,1,10
6116,112,50,1990,1053,496,557
6117,112,114,1990,389,166,223
6118,33,2,1990,219,25,194
6119,33,51,1990,82,31,51
6120,33,141,1990,643,158,485
6121,33,134,1990,38,0,38
6122,33,103,1990,251,115,136
6123,33,11,1990,1181,485,696
6124,33,66,1990,6119,3089,3030
6125,33,12,1990,356,192,164
6126,33,3,1990,60,3,57
6127,33,29,1990,148245,85657,62588
6128,33,67,1990,3969,2002,1967
6129,33,53,1990,4625,2533,2092
6130,33,105,1990,299,176,123
6131,33,30,1990,2414,987,1427
6132,33,135,1990,14,1,13
6133,33,106,1990,33,12,21
6134,33,172,1990,922,479,443
6135,33,107,1990,81,27,54
6136,33,137,1990,68,14,54
6137,33,96,1990,28,7,21
6138,33,54,1990,1142,606,536
6139,33,81,1990,261,86,175
6140,33,14,1990,62,19,43
6141,33,31,1990,8798,5042,3756
6142,33,39,1990,998,569,429
6143,33,83,1990,4,1,3
6144,33,108,1990,43,10,33
6145,33,142,1990,289,78,211
6146,33,119,1990,3,0,3
6147,33,40,1990,402,243,159
6148,33,120,1990,68,18,50
6149,33,42,1990,272,146,126
6150,33,68,1990,49150,26389,22761
6151,33,15,1990,460,239,221
6152,33,69,1990,144229,80163,64066
6153,33,156,1990,65,19,46
6154,33,56,1990,3964,1615,2349
6155,33,157,1990,17,5,12
6156,33,110,1990,18,3,15
6157,33,32,1990,1907,1074,833
6158,33,43,1990,58,19,39
6159,33,5,1990,436,131,305
6160,33,6,1990,197,52,145
6161,33,16,1990,562,76,486
6162,33,44,1990,101,27,74
6163,33,17,1990,542,162,380
6164,33,57,1990,6091,2865,3226
6165,33,177,1990,326,164,162
6166,33,18,1990,223,29,194
6167,33,167,1990,4778,2526,2252
6168,33,121,1990,75,33,42
6169,33,19,1990,194,74,120
6170,33,168,1990,106,60,46
6171,33,46,1990,3167,1869,1298
6172,33,20,1990,467,89,378
6173,33,143,1990,433,168,265
6174,33,47,1990,113201,66252,46949
6175,33,71,1990,177,97,80
6176,33,160,1990,35,0,35
6177,33,100,1990,165,79,86
6178,33,72,1990,3,1,2
6179,33,59,1990,275,109,166
6180,33,144,1990,221,59,162
6181,33,125,1990,18,1,17
6182,33,8,1990,13,0,13
6183,33,73,1990,1368,516,852
6184,33,162,1990,281,41,240
6185,33,60,1990,291,100,191
6186,33,48,1990,447,201,246
6187,33,9,1990,85,15,70
6188,33,102,1990,34,14,20
6189,33,112,1990,143,34,109
6190,33,61,1990,85,33,52
6191,33,22,1990,9,3,6
6192,33,35,1990,4748,2675,2073
6193,33,36,1990,76953,47848,29105
6194,33,23,1990,34,14,20
6195,33,164,1990,34,1,33
6196,33,63,1990,4743,2470,2273
6197,33,37,1990,2149,1226,923
6198,33,64,1990,183,105,78
6199,33,115,1990,376,179,197
6200,33,65,1990,1577,715,862
6201,33,10,1990,35,11,24
6202,33,145,1990,88,15,73
6203,33,49,1990,998,471,527
6204,33,74,1990,718,374,344
6205,33,25,1990,785,105,680
6206,33,169,1990,85,55,30
6207,33,146,1990,187,38,149
6208,33,26,1990,641,227,414
6209,33,170,1990,62,49,13
6210,33,130,1990,61,27,34
6211,33,38,1990,438692,257586,181106
6212,33,27,1990,118,57,61
6213,33,50,1990,3732,1593,2139
6214,33,131,1990,71,16,55
6215,33,114,1990,14,8,6
6216,33,171,1990,498,310,188
6217,33,1,1990,2343,868,1475
6218,33,28,1990,132,10,122
6219,33,132,1990,53,18,35
6220,33,133,1990,35,15,20
6221,61,51,1990,11,4,7
6222,61,141,1990,55,20,35
6223,61,52,1990,122,64,58
6224,61,134,1990,141573,75168,66405
6225,61,103,1990,303,164,139
6226,61,11,1990,16,7,9
6227,61,66,1990,113,60,53
6228,61,12,1990,2,1,1
6229,61,3,1990,76,4,72
6230,61,29,1990,38,14,24
6231,61,67,1990,1464,807,657
6232,61,151,1990,7,1,6
6233,61,53,1990,13,6,7
6234,61,105,1990,23722,13466,10256
6235,61,30,1990,183,61,122
6236,61,153,1990,30179,14314,15865
6237,61,135,1990,16,7,9
6238,61,106,1990,55,28,27
6239,61,172,1990,673,324,349
6240,61,173,1990,27,16,11
6241,61,174,1990,842,464,378
6242,61,107,1990,107,73,34
6243,61,137,1990,532,280,252
6244,61,54,1990,27,10,17
6245,61,81,1990,116,65,51
6246,61,14,1990,5,2,3
6247,61,31,1990,37,22,15
6248,61,176,1990,1,0,1
6249,61,137,1990,472,243,229
6250,61,39,1990,276,138,138
6251,61,83,1990,10,7,3
6252,61,108,1990,65,33,32
6253,61,142,1990,30,13,17
6254,61,97,1990,6,3,3
6255,61,138,1990,16,11,5
6256,61,40,1990,66,37,29
6257,61,148,1990,48,27,21
6258,61,120,1990,3,2,1
6259,61,42,1990,91,53,38
6260,61,68,1990,58434,30176,28258
6261,61,139,1990,21,11,10
6262,61,155,1990,7,0,7
6263,61,15,1990,40,4,36
6264,61,69,1990,16069,8196,7873
6265,61,156,1990,15,3,12
6266,61,56,1990,42,28,14
6267,61,98,1990,7,5,2
6268,61,157,1990,86,15,71
6269,61,158,1990,6588,2829,3759
6270,61,32,1990,63,41,22
6271,61,43,1990,9,4,5
6272,61,5,1990,1939,898,1041
6273,61,6,1990,52,23,29
6274,61,16,1990,16,6,10
6275,61,44,1990,199,129,70
6276,61,17,1990,28,11,17
6277,61,57,1990,985,456,529
6278,61,86,1990,7,3,4
6279,61,177,1990,81,43,38
6280,61,18,1990,3,0,3
6281,61,167,1990,27,9,18
6282,61,121,1990,43,25,18
6283,61,46,1990,20,6,14
6284,61,20,1990,17,7,10
6285,61,159,1990,8,1,7
6286,61,143,1990,2,0,2
6287,61,70,1990,1,0,1
6288,61,47,1990,38,8,30
6289,61,71,1990,1485,731,754
6290,61,122,1990,10,3,7
6291,61,123,1990,55,34,21
6292,61,160,1990,12,1,11
6293,61,58,1990,6,2,4
6294,61,161,1990,8,1,7
6295,61,100,1990,62,39,23
6296,61,59,1990,0,0,0
6297,61,144,1990,395,152,243
6298,61,125,1990,74609,38902,35707
6299,61,8,1990,9,1,8
6300,61,73,1990,1823,939,884
6301,61,162,1990,42,13,29
6302,61,60,1990,3,1,2
6303,61,48,1990,82,39,43
6304,61,9,1990,250,27,223
6305,61,102,1990,35,19,16
6306,61,111,1990,6,3,3
6307,61,112,1990,59,37,22
6308,61,33,1990,104,54,50
6309,61,35,1990,818,220,598
6310,61,36,1990,680,276,404
6311,61,140,1990,5581,2954,2627
6312,61,164,1990,183,48,135
6313,61,63,1990,46,5,41
6314,61,165,1990,12,0,12
6315,61,37,1990,8,4,4
6316,61,64,1990,8,4,4
6317,61,115,1990,6464,3326,3138
6318,61,65,1990,11027,6700,4327
6319,61,10,1990,3,1,2
6320,61,49,1990,216,118,98
6321,61,74,1990,3766,1864,1902
6322,61,25,1990,10,4,6
6323,61,166,1990,8,1,7
6324,61,146,1990,15,5,10
6325,61,26,1990,31,9,22
6326,61,130,1990,17,10,7
6327,61,38,1990,3196,602,2594
6328,61,50,1990,6866,3564,3302
6329,61,131,1990,48,31,17
6330,61,114,1990,39,19,20
6331,61,171,1990,5,0,5
6332,61,1,1990,5,2,3
6333,61,133,1990,395,218,177
6334,88,103,1990,1234,650,584
6335,88,105,1990,185,97,88
6336,88,106,1990,924,486,438
6337,88,172,1990,339,178,161
6338,88,107,1990,3399,1789,1610
6339,88,96,1990,487,256,231
6340,88,81,1990,19579,10069,9510
6341,88,82,1990,2567,1351,1216
6342,88,83,1990,37207,20872,16335
6343,88,108,1990,573,302,271
6344,88,142,1990,69,36,33
6345,88,97,1990,519,273,246
6346,88,68,1990,278,146,132
6347,88,69,1990,2231,1174,1057
6348,88,98,1990,487,256,231
6349,88,110,1990,99,52,47
6350,88,85,1990,295,155,140
6351,88,99,1990,435,229,206
6352,88,5,1990,96,51,45
6353,88,17,1990,87,46,41
6354,88,57,1990,483,254,229
6355,88,86,1990,84,44,40
6356,88,177,1990,163,86,77
6357,88,18,1990,175,92,83
6358,88,20,1990,35,18,17
6359,88,100,1990,1907,1004,903
6360,88,73,1990,53,28,25
6361,88,101,1990,460,242,218
6362,88,102,1990,1873,986,887
6363,88,112,1990,703,370,333
6364,88,33,1990,36,19,17
6365,88,61,1990,68,36,32
6366,88,65,1990,4542,2391,2151
6367,88,93,1990,337,177,160
6368,88,26,1990,42,22,20
6369,88,50,1990,336,177,159
6370,88,1,1990,124,65,59
6371,22,2,1990,384,103,281
6372,22,13,1990,54,39,15
6373,22,3,1990,36556,3480,33076
6374,22,10,1990,932,332,600
6375,22,136,1990,10484,7334,3150
6376,22,120,1990,908,246,662
6377,22,119,1990,639,172,467
6378,22,68,1990,102,46,56
6379,22,5,1990,2738,740,1998
6380,22,18,1990,10999,5241,5758
6381,22,19,1990,6155,2328,3827
6382,22,20,1990,3090,843,2247
6383,22,144,1990,1300,352,948
6384,22,8,1990,459,124,335
6385,22,73,1990,407,110,297
6386,22,162,1990,311,183,128
6387,22,9,1990,334,90,244
6388,22,23,1990,14187,5460,8727
6389,22,128,1990,109,41,68
6390,22,129,1990,608,164,444
6391,22,145,1990,3178,860,2318
6392,22,25,1990,526,142,384
6393,22,27,1990,39178,13834,25344
6394,22,146,1990,277,74,203
6395,22,26,1990,2308,625,1683
6396,22,142,1990,250,67,183
6397,22,50,1990,2886,1144,1742
6398,22,28,1990,10506,2843,7663
6399,35,2,1990,0,0,0
6400,35,51,1990,591,327,264
6401,35,141,1990,3,1,2
6402,35,52,1990,0,0,0
6403,35,134,1990,0,0,0
6404,35,75,1990,0,0,0
6405,35,76,1990,0,0,0
6406,35,103,1990,10,7,3
6407,35,11,1990,1,0,1
6408,35,66,1990,722,410,312
6409,35,12,1990,0,0,0
6410,35,78,1990,0,0,0
6411,35,13,1990,0,0,0
6412,35,3,1990,3,1,2
6413,35,79,1990,0,0,0
6414,35,29,1990,9,5,4
6415,35,67,1990,273,164,109
6416,35,95,1990,0,0,0
6417,35,151,1990,0,0,0
6418,35,4,1990,0,0,0
6419,35,53,1990,25,13,12
6420,35,147,1990,0,0,0
6421,35,105,1990,2,1,1
6422,35,30,1990,24353,13261,11092
6423,35,152,1990,0,0,0
6424,35,116,1990,0,0,0
6425,35,153,1990,0,0,0
6426,35,135,1990,0,0,0
6427,35,80,1990,0,0,0
6428,35,136,1990,0,0,0
6429,35,106,1990,0,0,0
6430,35,172,1990,605,259,346
6431,35,107,1990,0,0,0
6432,35,117,1990,0,0,0
6433,35,137,1990,0,0,0
6434,35,96,1990,0,0,0
6435,35,54,1990,324,166,158
6436,35,81,1990,1,0,1
6437,35,14,1990,18,11,7
6438,35,31,1990,829,531,298
6439,35,176,1990,0,0,0
6440,35,137,1990,0,0,0
6441,35,39,1990,51,31,20
6442,35,118,1990,0,0,0
6443,35,82,1990,0,0,0
6444,35,83,1990,0,0,0
6445,35,108,1990,0,0,0
6446,35,142,1990,7,3,4
6447,35,97,1990,0,0,0
6448,35,138,1990,0,0,0
6449,35,119,1990,0,0,0
6450,35,40,1990,0,0,0
6451,35,148,1990,0,0,0
6452,35,120,1990,0,0,0
6453,35,41,1990,0,0,0
6454,35,42,1990,116,64,52
6455,35,68,1990,427,232,195
6456,35,139,1990,0,0,0
6457,35,155,1990,0,0,0
6458,35,15,1990,0,0,0
6459,35,69,1990,1783,1052,731
6460,35,156,1990,0,0,0
6461,35,55,1990,0,0,0
6462,35,56,1990,4380,2449,1931
6463,35,84,1990,0,0,0
6464,35,98,1990,0,0,0
6465,35,157,1990,1,0,1
6466,35,158,1990,0,0,0
6467,35,110,1990,0,0,0
6468,35,85,1990,0,0,0
6469,35,99,1990,0,0,0
6470,35,32,1990,9320,6029,3291
6471,35,43,1990,0,0,0
6472,35,5,1990,0,0,0
6473,35,6,1990,853,136,717
6474,35,16,1990,299,81,218
6475,35,44,1990,96,46,50
6476,35,45,1990,0,0,0
6477,35,17,1990,262,68,194
6478,35,57,1990,461,261,200
6479,35,86,1990,0,0,0
6480,35,177,1990,8,4,4
6481,35,18,1990,261,59,202
6482,35,167,1990,0,0,0
6483,35,121,1990,0,0,0
6484,35,19,1990,0,0,0
6485,35,168,1990,0,0,0
6486,35,46,1990,0,0,0
6487,35,20,1990,306,61,245
6488,35,159,1990,0,0,0
6489,35,143,1990,0,0,0
6490,35,70,1990,0,0,0
6491,35,47,1990,0,0,0
6492,35,71,1990,7,2,5
6493,35,122,1990,0,0,0
6494,35,123,1990,0,0,0
6495,35,7,1990,0,0,0
6496,35,160,1990,0,0,0
6497,35,58,1990,0,0,0
6498,35,161,1990,0,0,0
6499,35,124,1990,0,0,0
6500,35,100,1990,4,3,1
6501,35,72,1990,0,0,0
6502,35,59,1990,0,0,0
6503,35,144,1990,4,2,2
6504,35,125,1990,0,0,0
6505,35,150,1990,0,0,0
6506,35,8,1990,0,0,0
6507,35,73,1990,59,30,29
6508,35,101,1990,0,0,0
6509,35,162,1990,1,1,0
6510,35,60,1990,3205,1839,1366
6511,35,48,1990,120,65,55
6512,35,21,1990,0,0,0
6513,35,9,1990,1,0,1
6514,35,102,1990,0,0,0
6515,35,111,1990,0,0,0
6516,35,112,1990,0,0,0
6517,35,33,1990,538,332,206
6518,35,61,1990,48,27,21
6519,35,22,1990,0,0,0
6520,35,36,1990,7224,4870,2354
6521,35,126,1990,0,0,0
6522,35,91,1990,0,0,0
6523,35,92,1990,0,0,0
6524,35,62,1990,0,0,0
6525,35,140,1990,0,0,0
6526,35,23,1990,8,1,7
6527,35,164,1990,0,0,0
6528,35,63,1990,565,292,273
6529,35,165,1990,0,0,0
6530,35,37,1990,58,34,24
6531,35,64,1990,0,0,0
6532,35,128,1990,0,0,0
6533,35,115,1990,0,0,0
6534,35,65,1990,106,64,42
6535,35,10,1990,1,0,1
6536,35,145,1990,0,0,0
6537,35,113,1990,0,0,0
6538,35,49,1990,177,106,71
6539,35,74,1990,106,54,52
6540,35,25,1990,2087,861,1226
6541,35,169,1990,0,0,0
6542,35,166,1990,0,0,0
6543,35,93,1990,0,0,0
6544,35,146,1990,2,1,1
6545,35,26,1990,878,183,695
6546,35,170,1990,0,0,0
6547,35,130,1990,0,0,0
6548,35,38,1990,15695,9120,6575
6549,35,27,1990,5,0,5
6550,35,50,1990,273,125,148
6551,35,131,1990,0,0,0
6552,35,114,1990,0,0,0
6553,35,171,1990,0,0,0
6554,35,1,1990,4,1,3
6555,35,28,1990,0,0,0
6556,35,132,1990,0,0,0
6557,35,133,1990,0,0,0
6558,36,2,1990,19103,9729,9374
6559,36,51,1990,1026,523,503
6560,36,141,1990,1303,664,639
6561,36,134,1990,519,264,255
6562,36,12,1990,936852,477127,459725
6563,36,103,1990,582,296,286
6564,36,66,1990,3776,1923,1853
6565,36,3,1990,1280,652,628
6566,36,11,1990,535266,272605,262661
6567,36,67,1990,859,437,422
6568,36,53,1990,876,446,430
6569,36,147,1990,194,99,95
6570,36,105,1990,577,294,283
6571,36,30,1990,10760,5480,5280
6572,36,116,1990,171,87,84
6573,36,29,1990,809353,412194,397159
6574,36,135,1990,738,376,362
6575,36,153,1990,52,26,26
6576,36,10,1990,1020,519,501
6577,36,136,1990,161,82,79
6578,36,106,1990,638,325,313
6579,36,172,1990,67405,34329,33076
6580,36,107,1990,336,171,165
6581,36,117,1990,17,9,8
6582,36,137,1990,492,251,241
6583,36,96,1990,35,18,17
6584,36,54,1990,365,186,179
6585,36,81,1990,2689,1369,1320
6586,36,14,1990,479,244,235
6587,36,31,1990,13710,6982,6728
6588,36,151,1990,317,161,156
6589,36,39,1990,2445,1245,1200
6590,36,108,1990,336,171,165
6591,36,138,1990,29,15,14
6592,36,120,1990,438,223,215
6593,36,40,1990,62441,31800,30641
6594,36,42,1990,1737,885,852
6595,36,68,1990,1474,751,723
6596,36,15,1990,656888,334545,322343
6597,36,69,1990,144895,73793,71102
6598,36,156,1990,286,146,140
6599,36,56,1990,1997,1017,980
6600,36,157,1990,429,218,211
6601,36,173,1990,38,19,19
6602,36,32,1990,18236,9287,8949
6603,36,43,1990,54,28,26
6604,36,5,1990,9801,4992,4809
6605,36,6,1990,3096,1577,1519
6606,36,16,1990,1424,725,699
6607,36,44,1990,194,99,95
6608,36,17,1990,2842,1447,1395
6609,36,57,1990,1020,519,501
6610,36,177,1990,655,334,321
6611,36,167,1990,2349697,1196673,1153024
6612,36,18,1990,1555,792,763
6613,36,121,1990,394,201,193
6614,36,176,1990,9699,4940,4759
6615,36,19,1990,248,126,122
6616,36,168,1990,433625,220840,212785
6617,36,20,1990,2133,1086,1047
6618,36,46,1990,95730,48754,46976
6619,36,143,1990,373,190,183
6620,36,47,1990,82889,42214,40675
6621,36,71,1990,92,47,45
6622,36,122,1990,144,73,71
6623,36,123,1990,12,6,6
6624,36,7,1990,135,69,66
6625,36,160,1990,196,100,96
6626,36,58,1990,575,293,282
6627,36,124,1990,273,139,134
6628,36,100,1990,173,88,85
6629,36,72,1990,192,98,94
6630,36,59,1990,538,274,264
6631,36,144,1990,1755,894,861
6632,36,125,1990,111,57,54
6633,36,21,1990,61,31,30
6634,36,150,1990,106,54,52
6635,36,8,1990,573,292,281
6636,36,73,1990,371,189,182
6637,36,101,1990,71,36,35
6638,36,162,1990,1165,593,572
6639,36,48,1990,1134,578,556
6640,36,9,1990,1683,857,826
6641,36,102,1990,81,41,40
6642,36,111,1990,104,53,51
6643,36,112,1990,784,399,385
6644,36,33,1990,31333,15958,15375
6645,36,61,1990,129,66,63
6646,36,158,1990,342,174,168
6647,36,22,1990,115,59,56
6648,36,35,1990,3936,2005,1931
6649,36,126,1990,177,90,87
6650,36,75,1990,304,155,149
6651,36,62,1990,31,16,15
6652,36,23,1990,317,161,156
6653,36,164,1990,108,55,53
6654,36,37,1990,1020,519,501
6655,36,1,1990,32251,16425,15826
6656,36,64,1990,138,70,68
6657,36,128,1990,129,66,63
6658,36,115,1990,246,125,121
6659,36,133,1990,265,135,130
6660,36,65,1990,840,428,412
6661,36,145,1990,588,299,289
6662,36,49,1990,340,173,167
6663,36,74,1990,407,207,200
6664,36,25,1990,5464,2783,2681
6665,36,169,1990,424727,216308,208419
6666,36,27,1990,283,144,139
6667,36,146,1990,607,309,298
6668,36,26,1990,13032,6637,6395
6669,36,170,1990,165923,84503,81420
6670,36,130,1990,100,51,49
6671,36,38,1990,3301922,1681629,1620293
6672,36,60,1990,359,183,176
6673,36,142,1990,1499,763,736
6674,36,50,1990,899,458,441
6675,36,131,1990,269,137,132
6676,36,152,1990,525,267,258
6677,36,114,1990,479,244,235
6678,36,171,1990,890893,453721,437172
6679,36,28,1990,986,502,484
6680,36,132,1990,354,180,174
6681,126,116,1990,26393,12355,14038
6682,126,137,1990,62526,31829,30697
6683,126,121,1990,955,400,555
6684,126,130,1990,34106,16424,17682
6685,126,131,1990,15825,7878,7947
6686,90,76,1990,175,94,81
6687,90,78,1990,5,3,2
6688,90,79,1990,41,24,17
6689,90,82,1990,87,42,45
6690,90,84,1990,24,11,13
6691,90,110,1990,335,163,172
6692,90,86,1990,62,33,29
6693,90,87,1990,186,97,89
6694,90,91,1990,46,17,29
6695,90,92,1990,74,38,36
6696,90,93,1990,115,46,69
6697,91,76,1990,49,24,25
6698,91,66,1990,6,3,3
6699,91,78,1990,6,2,4
6700,91,79,1990,324,160,164
6701,91,67,1990,5,2,3
6702,91,105,1990,5,2,3
6703,91,95,1990,1,0,1
6704,91,80,1990,2,1,1
6705,91,172,1990,21,11,10
6706,91,81,1990,10,6,4
6707,91,82,1990,96,47,49
6708,91,83,1990,20,12,8
6709,91,120,1990,2,2,0
6710,91,68,1990,31,10,21
6711,91,109,1990,127,81,46
6712,91,69,1990,31,19,12
6713,91,156,1990,10,4,6
6714,91,84,1990,67,27,40
6715,91,98,1990,2,1,1
6716,91,110,1990,821,479,342
6717,91,85,1990,15,7,8
6718,91,5,1990,49,19,30
6719,91,44,1990,10,4,6
6720,91,57,1990,7,4,3
6721,91,86,1990,78,47,31
6722,91,177,1990,11,9,2
6723,91,20,1990,4,3,1
6724,91,100,1990,4,4,0
6725,91,87,1990,14,7,7
6726,91,73,1990,9,3,6
6727,91,77,1990,8,5,3
6728,91,162,1990,6,4,2
6729,91,9,1990,8,4,4
6730,91,102,1990,12,6,6
6731,91,88,1990,7,2,5
6732,91,90,1990,19,11,8
6733,91,75,1990,16,9,7
6734,91,92,1990,182,103,79
6735,91,115,1990,4,2,2
6736,91,133,1990,1,0,1
6737,91,113,1990,18,11,7
6738,91,74,1990,5,1,4
6739,91,25,1990,12,3,9
6740,91,93,1990,325,172,153
6741,91,50,1990,405,216,189
6742,92,76,1990,51,23,28
6743,92,79,1990,303,132,171
6744,92,82,1990,75,45,30
6745,92,84,1990,377,222,155
6746,92,110,1990,209,120,89
6747,92,86,1990,111,53,58
6748,92,90,1990,35,25,10
6749,92,91,1990,208,124,84
6750,92,93,1990,837,426,411
6751,92,50,1990,682,330,352
6752,62,57,1990,2986,1391,1595
6753,62,51,1990,27,21,6
6754,62,33,1990,18,16,2
6755,62,35,1990,43,29,14
6756,62,38,1990,4,1,3
6757,62,36,1990,7,3,4
6758,62,68,1990,32,19,13
6759,62,103,1990,68,31,37
6760,62,105,1990,18,18,0
6761,140,134,1990,468,265,203
6762,140,153,1990,4250,1995,2255
6763,140,138,1990,305,183,122
6764,140,139,1990,11,2,9
6765,140,125,1990,243,27,216
6766,140,61,1990,206,95,111
6767,23,2,1990,166255,55665,110590
6768,23,3,1990,479380,121984,357396
6769,23,10,1990,200579,67157,133422
6770,23,120,1990,61017,20429,40588
6771,23,5,1990,906468,294397,612071
6772,23,16,1990,42857,21276,21581
6773,23,18,1990,90278,30226,60052
6774,23,20,1990,57203,19152,38051
6775,23,8,1990,177661,41638,136023
6776,23,9,1990,556715,173350,383365
6777,23,145,1990,178769,59855,118914
6778,23,25,1990,305838,133120,172718
6779,23,142,1990,357540,119711,237829
6780,23,28,1990,286032,100557,185475
6781,164,141,1990,3464,2226,1238
6782,164,105,1990,536,278,258
6783,164,135,1990,837,520,317
6784,164,137,1990,0,0,0
6785,164,151,1990,2984,1465,1519
6786,164,68,1990,11453,5946,5507
6787,164,155,1990,4263,2405,1858
6788,164,69,1990,721,362,359
6789,164,156,1990,1476,332,1144
6790,164,157,1990,42570,15818,26752
6791,164,20,1990,911,324,587
6792,164,159,1990,0,0,0
6793,164,160,1990,28161,13668,14493
6794,164,161,1990,89862,43087,46775
6795,164,144,1990,3405,1769,1636
6796,164,162,1990,701,186,515
6797,164,158,1990,23825,13813,10012
6798,164,126,1990,0,0,0
6799,164,23,1990,1177,621,556
6800,164,165,1990,12313,6623,5690
6801,164,166,1990,1380,466,914
6802,164,26,1990,0,0,0
6803,63,51,1990,57,44,13
6804,63,141,1990,6,2,4
6805,63,103,1990,5,3,2
6806,63,66,1990,860,419,441
6807,63,11,1990,19,14,5
6808,63,67,1990,13,5,8
6809,63,53,1990,42141,22216,19925
6810,63,105,1990,5,3,2
6811,63,30,1990,139,96,43
6812,63,29,1990,16,13,3
6813,63,172,1990,216,93,123
6814,63,54,1990,35548,18527,17021
6815,63,81,1990,3,1,2
6816,63,14,1990,21,9,12
6817,63,31,1990,63,41,22
6818,63,39,1990,11,5,6
6819,63,42,1990,3,2,1
6820,63,68,1990,10,5,5
6821,63,15,1990,5,3,2
6822,63,69,1990,31,14,17
6823,63,156,1990,3,1,2
6824,63,56,1990,112,53,59
6825,63,32,1990,221,141,80
6826,63,5,1990,36,19,17
6827,63,6,1990,7,0,7
6828,63,16,1990,21,7,14
6829,63,44,1990,6,2,4
6830,63,17,1990,13,6,7
6831,63,57,1990,51,35,16
6832,63,177,1990,4,2,2
6833,63,167,1990,11,9,2
6834,63,18,1990,12,2,10
6835,63,19,1990,8,3,5
6836,63,20,1990,5,2,3
6837,63,143,1990,45,18,27
6838,63,47,1990,3,2,1
6839,63,71,1990,11,4,7
6840,63,58,1990,6,2,4
6841,63,100,1990,2,1,1
6842,63,59,1990,9511,4993,4518
6843,63,144,1990,3,2,1
6844,63,73,1990,92,41,51
6845,63,48,1990,1,0,1
6846,63,112,1990,5,3,2
6847,63,33,1990,81,67,14
6848,63,61,1990,4,1,3
6849,63,35,1990,443,356,87
6850,63,36,1990,361,252,109
6851,63,37,1990,58,40,18
6852,63,64,1990,1343,718,625
6853,63,115,1990,3,2,1
6854,63,133,1990,3,1,2
6855,63,65,1990,19,8,11
6856,63,49,1990,146,69,77
6857,63,74,1990,350,161,189
6858,63,25,1990,14,2,12
6859,63,27,1990,2,1,1
6860,63,146,1990,4,1,3
6861,63,26,1990,47,14,33
6862,63,170,1990,3,2,1
6863,63,38,1990,156,127,29
6864,63,60,1990,6395,3643,2752
6865,63,142,1990,9,2,7
6866,63,50,1990,79,35,44
6867,63,171,1990,9,8,1
6868,63,132,1990,6,3,3
6869,127,3,1990,11,7,4
6870,127,67,1990,32,17,15
6871,127,10,1990,316,137,179
6872,127,172,1990,58,15,43
6873,127,81,1990,20,11,9
6874,127,68,1990,180,111,69
6875,127,69,1990,40,24,16
6876,127,5,1990,1276,264,1012
6877,127,57,1990,22,9,13
6878,127,121,1990,25,17,8
6879,127,122,1990,34,30,4
6880,127,7,1990,2,2,0
6881,127,124,1990,258,132,126
6882,127,8,1990,27,15,12
6883,127,162,1990,25,11,14
6884,127,9,1990,23,13,10
6885,127,36,1990,79,46,33
6886,127,128,1990,11,2,9
6887,127,115,1990,83,48,35
6888,127,65,1990,11,4,7
6889,127,130,1990,5,0,5
6890,127,50,1990,274,147,127
6891,165,153,1990,5,2,3
6892,165,136,1990,0,0,0
6893,165,172,1990,280,7,273
6894,165,137,1990,0,0,0
6895,165,151,1990,262,160,102
6896,165,138,1990,0,0,0
6897,165,119,1990,0,0,0
6898,165,155,1990,5240,2384,2856
6899,165,69,1990,135,61,74
6900,165,156,1990,1310,426,884
6901,165,157,1990,74272,30371,43901
6902,165,5,1990,405,161,244
6903,165,16,1990,0,0,0
6904,165,177,1990,7,4,3
6905,165,121,1990,0,0,0
6906,165,176,1990,7,1,6
6907,165,20,1990,2090,1039,1051
6908,165,159,1990,130316,61373,68943
6909,165,160,1990,1953,871,1082
6910,165,161,1990,142,34,108
6911,165,162,1990,2116,759,1357
6912,165,9,1990,0,0,0
6913,165,158,1990,24,8,16
6914,165,36,1990,75,50,25
6915,165,126,1990,0,0,0
6916,165,164,1990,737,248,489
6917,165,1,1990,0,0,0
6918,165,115,1990,239,188,51
6919,165,145,1990,0,0,0
6920,165,166,1990,43,14,29
6921,165,50,1990,611,266,345
6922,165,152,1990,35,13,22
6923,165,132,1990,0,0,0
6924,37,2,1990,26,2,24
6925,37,51,1990,6,2,4
6926,37,141,1990,8,2,6
6927,37,52,1990,0,0,0
6928,37,134,1990,11,2,9
6929,37,103,1990,20,11,9
6930,37,11,1990,37,18,19
6931,37,77,1990,0,0,0
6932,37,66,1990,281,170,111
6933,37,12,1990,4,1,3
6934,37,13,1990,0,0,0
6935,37,3,1990,0,0,0
6936,37,79,1990,0,0,0
6937,37,29,1990,60,42,18
6938,37,67,1990,62,35,27
6939,37,95,1990,0,0,0
6940,37,151,1990,0,0,0
6941,37,53,1990,47,14,33
6942,37,147,1990,0,0,0
6943,37,105,1990,4,2,2
6944,37,30,1990,362,165,197
6945,37,152,1990,0,0,0
6946,37,116,1990,0,0,0
6947,37,135,1990,0,0,0
6948,37,80,1990,0,0,0
6949,37,136,1990,8,3,5
6950,37,106,1990,2,1,1
6951,37,172,1990,49,23,26
6952,37,107,1990,3,1,2
6953,37,137,1990,1,0,1
6954,37,96,1990,0,0,0
6955,37,54,1990,95,34,61
6956,37,81,1990,23,5,18
6957,37,14,1990,4,1,3
6958,37,31,1990,26268,14334,11934
6959,37,176,1990,0,0,0
6960,37,137,1990,0,0,0
6961,37,39,1990,6,2,4
6962,37,82,1990,0,0,0
6963,37,83,1990,0,0,0
6964,37,108,1990,1,0,1
6965,37,142,1990,9,1,8
6966,37,97,1990,0,0,0
6967,37,40,1990,3,2,1
6968,37,148,1990,0,0,0
6969,37,120,1990,5,1,4
6970,37,41,1990,0,0,0
6971,37,42,1990,4,2,2
6972,37,68,1990,484,278,206
6973,37,155,1990,0,0,0
6974,37,15,1990,11,6,5
6975,37,69,1990,255,132,123
6976,37,156,1990,1,0,1
6977,37,56,1990,9,5,4
6978,37,84,1990,0,0,0
6979,37,98,1990,0,0,0
6980,37,157,1990,0,0,0
6981,37,158,1990,0,0,0
6982,37,85,1990,0,0,0
6983,37,99,1990,0,0,0
6984,37,32,1990,6010,3671,2339
6985,37,43,1990,0,0,0
6986,37,5,1990,7,3,4
6987,37,6,1990,11,1,10
6988,37,16,1990,10,1,9
6989,37,44,1990,1,0,1
6990,37,45,1990,0,0,0
6991,37,17,1990,15,5,10
6992,37,57,1990,41,14,27
6993,37,86,1990,0,0,0
6994,37,177,1990,6,2,4
6995,37,18,1990,9,1,8
6996,37,167,1990,21,15,6
6997,37,121,1990,1,0,1
6998,37,19,1990,10,3,7
6999,37,168,1990,3,2,1
7000,37,46,1990,5,4,1
7001,37,20,1990,14,3,11
7002,37,149,1990,0,0,0
7003,37,159,1990,0,0,0
7004,37,143,1990,7,1,6
7005,37,70,1990,0,0,0
7006,37,47,1990,9,7,2
7007,37,71,1990,14,6,8
7008,37,122,1990,0,0,0
7009,37,123,1990,0,0,0
7010,37,7,1990,0,0,0
7011,37,58,1990,1,1,0
7012,37,124,1990,0,0,0
7013,37,100,1990,3,2,1
7014,37,72,1990,0,0,0
7015,37,59,1990,10,5,5
7016,37,144,1990,3,1,2
7017,37,125,1990,0,0,0
7018,37,150,1990,0,0,0
7019,37,8,1990,0,0,0
7020,37,73,1990,11,3,8
7021,37,101,1990,0,0,0
7022,37,162,1990,1,0,1
7023,37,60,1990,54,13,41
7024,37,48,1990,3,2,1
7025,37,21,1990,0,0,0
7026,37,9,1990,2,0,2
7027,37,102,1990,0,0,0
7028,37,111,1990,0,0,0
7029,37,112,1990,5,2,3
7030,37,33,1990,1207,847,360
7031,37,61,1990,1,0,1
7032,37,22,1990,0,0,0
7033,37,35,1990,1115,600,515
7034,37,36,1990,622,425,197
7035,37,126,1990,0,0,0
7036,37,90,1990,0,0,0
7037,37,91,1990,0,0,0
7038,37,62,1990,0,0,0
7039,37,140,1990,0,0,0
7040,37,23,1990,2,0,2
7041,37,164,1990,0,0,0
7042,37,63,1990,383,156,227
7043,37,127,1990,0,0,0
7044,37,165,1990,0,0,0
7045,37,64,1990,15,7,8
7046,37,128,1990,0,0,0
7047,37,115,1990,6,2,4
7048,37,65,1990,10,5,5
7049,37,10,1990,0,0,0
7050,37,145,1990,0,0,0
7051,37,49,1990,8,5,3
7052,37,74,1990,18,8,10
7053,37,25,1990,37,4,33
7054,37,169,1990,0,0,0
7055,37,166,1990,0,0,0
7056,37,93,1990,0,0,0
7057,37,146,1990,6,1,5
7058,37,26,1990,10,1,9
7059,37,170,1990,0,0,0
7060,37,130,1990,0,0,0
7061,37,38,1990,2619,1607,1012
7062,37,27,1990,4,1,3
7063,37,50,1990,34,12,22
7064,37,131,1990,0,0,0
7065,37,114,1990,0,0,0
7066,37,171,1990,8,7,1
7067,37,1,1990,241,70,171
7068,37,28,1990,6,1,5
7069,37,132,1990,0,0,0
7070,37,133,1990,0,0,0
7071,64,2,1990,1,0,1
7072,64,51,1990,15,5,10
7073,64,141,1990,4,2,2
7074,64,134,1990,0,0,0
7075,64,103,1990,92,40,52
7076,64,11,1990,0,0,0
7077,64,77,1990,0,0,0
7078,64,66,1990,4461,2633,1828
7079,64,12,1990,0,0,0
7080,64,78,1990,0,0,0
7081,64,3,1990,0,0,0
7082,64,79,1990,0,0,0
7083,64,29,1990,16,8,8
7084,64,67,1990,250,134,116
7085,64,95,1990,0,0,0
7086,64,151,1990,0,0,0
7087,64,53,1990,68549,33513,35036
7088,64,147,1990,0,0,0
7089,64,105,1990,7,3,4
7090,64,30,1990,65,31,34
7091,64,152,1990,0,0,0
7092,64,116,1990,0,0,0
7093,64,153,1990,0,0,0
7094,64,135,1990,0,0,0
7095,64,136,1990,0,0,0
7096,64,106,1990,7,3,4
7097,64,172,1990,61,30,31
7098,64,107,1990,2,1,1
7099,64,117,1990,0,0,0
7100,64,137,1990,0,0,0
7101,64,96,1990,0,0,0
7102,64,54,1990,48018,23480,24538
7103,64,81,1990,2,1,1
7104,64,14,1990,0,0,0
7105,64,31,1990,396,283,113
7106,64,176,1990,0,0,0
7107,64,137,1990,0,0,0
7108,64,39,1990,14,7,7
7109,64,82,1990,0,0,0
7110,64,83,1990,3,1,2
7111,64,108,1990,0,0,0
7112,64,142,1990,14,7,7
7113,64,97,1990,0,0,0
7114,64,119,1990,0,0,0
7115,64,40,1990,0,0,0
7116,64,120,1990,0,0,0
7117,64,42,1990,2,1,1
7118,64,68,1990,1408,756,652
7119,64,139,1990,0,0,0
7120,64,155,1990,0,0,0
7121,64,15,1990,0,0,0
7122,64,69,1990,8402,4412,3990
7123,64,156,1990,5,2,3
7124,64,56,1990,45,21,24
7125,64,98,1990,0,0,0
7126,64,157,1990,0,0,0
7127,64,158,1990,0,0,0
7128,64,110,1990,0,0,0
7129,64,85,1990,0,0,0
7130,64,99,1990,0,0,0
7131,64,32,1990,385,257,128
7132,64,43,1990,0,0,0
7133,64,5,1990,11,5,6
7134,64,6,1990,8,4,4
7135,64,16,1990,12,6,6
7136,64,44,1990,2,1,1
7137,64,17,1990,3,1,2
7138,64,57,1990,4654,2639,2015
7139,64,86,1990,0,0,0
7140,64,177,1990,8,4,4
7141,64,18,1990,8,4,4
7142,64,167,1990,4,2,2
7143,64,121,1990,5,2,3
7144,64,19,1990,0,0,0
7145,64,168,1990,0,0,0
7146,64,46,1990,3,1,2
7147,64,20,1990,4,2,2
7148,64,159,1990,0,0,0
7149,64,143,1990,8,4,4
7150,64,70,1990,0,0,0
7151,64,47,1990,2,1,1
7152,64,71,1990,29,16,13
7153,64,122,1990,0,0,0
7154,64,123,1990,0,0,0
7155,64,7,1990,0,0,0
7156,64,160,1990,0,0,0
7157,64,58,1990,0,0,0
7158,64,161,1990,0,0,0
7159,64,124,1990,0,0,0
7160,64,100,1990,5,2,3
7161,64,59,1990,2646,1293,1353
7162,64,87,1990,0,0,0
7163,64,144,1990,3,1,2
7164,64,125,1990,0,0,0
7165,64,150,1990,0,0,0
7166,64,8,1990,0,0,0
7167,64,73,1990,261,138,123
7168,64,101,1990,0,0,0
7169,64,162,1990,2,1,1
7170,64,60,1990,6720,3285,3435
7171,64,48,1990,0,0,0
7172,64,21,1990,0,0,0
7173,64,9,1990,3,1,2
7174,64,102,1990,0,0,0
7175,64,111,1990,0,0,0
7176,64,112,1990,4,2,2
7177,64,33,1990,62,31,31
7178,64,61,1990,3,1,2
7179,64,22,1990,0,0,0
7180,64,35,1990,63,36,27
7181,64,36,1990,171,85,86
7182,64,126,1990,0,0,0
7183,64,62,1990,0,0,0
7184,64,140,1990,0,0,0
7185,64,23,1990,0,0,0
7186,64,164,1990,0,0,0
7187,64,63,1990,24825,12136,12689
7188,64,165,1990,0,0,0
7189,64,37,1990,35,17,18
7190,64,128,1990,0,0,0
7191,64,115,1990,5,2,3
7192,64,65,1990,128,64,64
7193,64,10,1990,0,0,0
7194,64,145,1990,0,0,0
7195,64,113,1990,0,0,0
7196,64,49,1990,248,114,134
7197,64,74,1990,798,396,402
7198,64,25,1990,1,0,1
7199,64,169,1990,0,0,0
7200,64,166,1990,0,0,0
7201,64,93,1990,0,0,0
7202,64,146,1990,2,1,1
7203,64,26,1990,5,2,3
7204,64,170,1990,0,0,0
7205,64,130,1990,0,0,0
7206,64,38,1990,89,44,45
7207,64,27,1990,0,0,0
7208,64,50,1990,75,39,36
7209,64,131,1990,0,0,0
7210,64,114,1990,0,0,0
7211,64,171,1990,2,1,1
7212,64,1,1990,0,0,0
7213,64,28,1990,0,0,0
7214,64,132,1990,0,0,0
7215,64,133,1990,0,0,0
7216,128,120,1990,460000,225139,234861
7217,128,119,1990,0,0,0
7218,128,28,1990,0,0,0
7219,115,2,1990,59,22,37
7220,115,51,1990,78,44,34
7221,115,141,1990,348,130,218
7222,115,134,1990,6602,1989,4613
7223,115,103,1990,623,397,226
7224,115,66,1990,3523,2009,1514
7225,115,13,1990,161,75,86
7226,115,3,1990,2469,706,1763
7227,115,79,1990,30,11,19
7228,115,29,1990,113,58,55
7229,115,67,1990,5864,3127,2737
7230,115,151,1990,192,69,123
7231,115,53,1990,147,105,42
7232,115,147,1990,18470,3275,15195
7233,115,105,1990,979,709,270
7234,115,30,1990,3836,2256,1580
7235,115,116,1990,2092,731,1361
7236,115,135,1990,2303,815,1488
7237,115,106,1990,650,242,408
7238,115,172,1990,8690,4886,3804
7239,115,107,1990,118,47,71
7240,115,117,1990,194,36,158
7241,115,137,1990,1302,537,765
7242,115,54,1990,479,225,254
7243,115,81,1990,317,66,251
7244,115,14,1990,944,578,366
7245,115,31,1990,953,439,514
7246,115,176,1990,137,133,4
7247,115,137,1990,7456,3731,3725
7248,115,39,1990,977,667,310
7249,115,142,1990,837,395,442
7250,115,119,1990,521,264,257
7251,115,40,1990,68,13,55
7252,115,120,1990,2873,1435,1438
7253,115,42,1990,576,422,154
7254,115,68,1990,5608,3389,2219
7255,115,139,1990,306,161,145
7256,115,69,1990,33946,18703,15243
7257,115,156,1990,6486,2627,3859
7258,115,55,1990,26,5,21
7259,115,56,1990,3191,1733,1458
7260,115,98,1990,90,36,54
7261,115,157,1990,78,36,42
7262,115,158,1990,30,27,3
7263,115,110,1990,54,38,16
7264,115,173,1990,1786,935,851
7265,115,43,1990,16,5,11
7266,115,5,1990,8356,3937,4419
7267,115,6,1990,680,411,269
7268,115,16,1990,142,36,106
7269,115,44,1990,5788,3216,2572
7270,115,17,1990,2441,1249,1192
7271,115,57,1990,10652,5293,5359
7272,115,86,1990,192,141,51
7273,115,177,1990,1070,492,578
7274,115,18,1990,54,30,24
7275,115,121,1990,2140,815,1325
7276,115,19,1990,90,33,57
7277,115,168,1990,0,0,0
7278,115,46,1990,199,64,135
7279,115,20,1990,903,517,386
7280,115,149,1990,187019,43281,143738
7281,115,159,1990,308,214,94
7282,115,143,1990,158,38,120
7283,115,47,1990,192,108,84
7284,115,71,1990,14,8,6
7285,115,122,1990,422,300,122
7286,115,123,1990,13336,2935,10401
7287,115,7,1990,54,25,29
7288,115,160,1990,104,64,40
7289,115,58,1990,163,111,52
7290,115,124,1990,4711,1694,3017
7291,115,100,1990,78,30,48
7292,115,72,1990,11,5,6
7293,115,144,1990,1058,467,591
7294,115,125,1990,346433,99765,246668
7295,115,150,1990,10904,4213,6691
7296,115,8,1990,125,61,64
7297,115,73,1990,17440,10193,7247
7298,115,101,1990,106,80,26
7299,115,162,1990,16073,3581,12492
7300,115,48,1990,533,317,216
7301,115,21,1990,33,19,14
7302,115,9,1990,1523,425,1098
7303,115,102,1990,59,36,23
7304,115,111,1990,116,72,44
7305,115,112,1990,199,111,88
7306,115,33,1990,1622,843,779
7307,115,61,1990,19125,10634,8491
7308,115,35,1990,773,406,367
7309,115,36,1990,1193,456,737
7310,115,126,1990,2094,1280,814
7311,115,90,1990,26,12,14
7312,115,23,1990,604,342,262
7313,115,164,1990,2683,292,2391
7314,115,63,1990,1964,1166,798
7315,115,127,1990,28,13,15
7316,115,165,1990,384,125,259
7317,115,37,1990,201,55,146
7318,115,128,1990,3233,1541,1692
7319,115,65,1990,488,272,216
7320,115,10,1990,963,564,399
7321,115,145,1990,2619,1394,1225
7322,115,148,1990,34114,9049,25065
7323,115,49,1990,116,50,66
7324,115,74,1990,4268,2354,1914
7325,115,25,1990,113,72,41
7326,115,60,1990,59,13,46
7327,115,93,1990,26,11,15
7328,115,146,1990,111,66,45
7329,115,26,1990,792,308,484
7330,115,130,1990,4621,2276,2345
7331,115,38,1990,1822,990,832
7332,115,27,1990,175,108,67
7333,115,50,1990,117362,69947,47415
7334,115,131,1990,26,12,14
7335,115,114,1990,111,38,73
7336,115,1,1990,156,114,42
7337,115,28,1990,83,69,14
7338,115,132,1990,6346,3127,3219
7339,115,133,1990,61875,26812,35063
7340,129,136,1990,0,0,0
7341,129,137,1990,0,0,0
7342,129,142,1990,0,0,0
7343,129,119,1990,0,0,0
7344,129,120,1990,0,0,0
7345,129,5,1990,0,0,0
7346,129,121,1990,0,0,0
7347,129,143,1990,0,0,0
7348,129,160,1990,0,0,0
7349,129,162,1990,0,0,0
7350,129,145,1990,0,0,0
7351,129,130,1990,0,0,0
7352,65,2,1990,24,7,17
7353,65,51,1990,162,79,83
7354,65,141,1990,11518,4862,6656
7355,65,52,1990,2008,1083,925
7356,65,134,1990,1201,567,634
7357,65,103,1990,42923,22753,20170
7358,65,11,1990,282,134,148
7359,65,66,1990,2259,1256,1003
7360,65,12,1990,35,20,15
7361,65,78,1990,5,2,3
7362,65,13,1990,3,1,2
7363,65,3,1990,248,43,205
7364,65,79,1990,3,2,1
7365,65,29,1990,54,35,19
7366,65,67,1990,16881,9056,7825
7367,65,95,1990,3,1,2
7368,65,151,1990,30,9,21
7369,65,53,1990,643,334,309
7370,65,105,1990,13454,8092,5362
7371,65,30,1990,1084,527,557
7372,65,152,1990,96,36,60
7373,65,116,1990,5,2,3
7374,65,153,1990,1274,776,498
7375,65,135,1990,428,200,228
7376,65,136,1990,7,2,5
7377,65,106,1990,11887,6592,5295
7378,65,172,1990,8432,3962,4470
7379,65,107,1990,12548,8133,4415
7380,65,137,1990,93,31,62
7381,65,96,1990,644,369,275
7382,65,54,1990,218,105,113
7383,65,81,1990,21854,12590,9264
7384,65,14,1990,149,73,76
7385,65,31,1990,685,408,277
7386,65,176,1990,17,8,9
7387,65,137,1990,621,259,362
7388,65,39,1990,3729,2055,1674
7389,65,118,1990,1,0,1
7390,65,82,1990,359,264,95
7391,65,83,1990,15160,11533,3627
7392,65,108,1990,3734,2216,1518
7393,65,142,1990,1040,349,691
7394,65,97,1990,1195,803,392
7395,65,138,1990,6040,3485,2555
7396,65,119,1990,6,2,4
7397,65,40,1990,18,13,5
7398,65,120,1990,118,52,66
7399,65,42,1990,2803,1693,1110
7400,65,68,1990,100111,54683,45428
7401,65,139,1990,22,12,10
7402,65,155,1990,2779,766,2013
7403,65,15,1990,102,52,50
7404,65,69,1990,80772,42594,38178
7405,65,156,1990,436,132,304
7406,65,56,1990,639,258,381
7407,65,84,1990,0,0,0
7408,65,98,1990,975,631,344
7409,65,157,1990,2316,1149,1167
7410,65,158,1990,539,68,471
7411,65,110,1990,8,5,3
7412,65,85,1990,38,19,19
7413,65,99,1990,1169,815,354
7414,65,32,1990,587,348,239
7415,65,43,1990,138,74,64
7416,65,5,1990,4147,1995,2152
7417,65,6,1990,1771,703,1068
7418,65,16,1990,638,225,413
7419,65,44,1990,2044,1166,878
7420,65,17,1990,656,217,439
7421,65,57,1990,12204,4789,7415
7422,65,86,1990,20,13,7
7423,65,177,1990,1640,858,782
7424,65,18,1990,910,191,719
7425,65,167,1990,8,3,5
7426,65,121,1990,230,130,100
7427,65,19,1990,41,17,24
7428,65,168,1990,17,11,6
7429,65,46,1990,50,28,22
7430,65,20,1990,1282,330,952
7431,65,159,1990,620,146,474
7432,65,143,1990,78,29,49
7433,65,70,1990,58,33,25
7434,65,47,1990,37,20,17
7435,65,71,1990,658,358,300
7436,65,122,1990,39,28,11
7437,65,123,1990,3,2,1
7438,65,160,1990,351,53,298
7439,65,58,1990,95,56,39
7440,65,161,1990,702,160,542
7441,65,124,1990,19,9,10
7442,65,100,1990,9649,5650,3999
7443,65,72,1990,82,39,43
7444,65,59,1990,0,0,0
7445,65,144,1990,133341,61977,71364
7446,65,125,1990,101,58,43
7447,65,150,1990,7,4,3
7448,65,8,1990,45,26,19
7449,65,73,1990,13912,7553,6359
7450,65,101,1990,1002,576,426
7451,65,162,1990,704,196,508
7452,65,60,1990,39,19,20
7453,65,48,1990,3145,1759,1386
7454,65,21,1990,1,0,1
7455,65,9,1990,2213,491,1722
7456,65,102,1990,1236,704,532
7457,65,111,1990,907,552,355
7458,65,112,1990,18828,11211,7617
7459,65,33,1990,4206,2105,2101
7460,65,61,1990,35909,18857,17052
7461,65,22,1990,5,2,3
7462,65,35,1990,2145,1034,1111
7463,65,36,1990,3120,1814,1306
7464,65,126,1990,23,8,15
7465,65,91,1990,3,2,1
7466,65,62,1990,9,4,5
7467,65,140,1990,14,8,6
7468,65,23,1990,157,60,97
7469,65,164,1990,3334,611,2723
7470,65,63,1990,0,0,0
7471,65,127,1990,3,2,1
7472,65,165,1990,212,54,158
7473,65,37,1990,110,56,54
7474,65,64,1990,49,26,23
7475,65,128,1990,18,6,12
7476,65,115,1990,740,389,351
7477,65,10,1990,45,21,24
7478,65,145,1990,36,10,26
7479,65,113,1990,11,8,3
7480,65,49,1990,5755,3373,2382
7481,65,74,1990,32884,16577,16307
7482,65,25,1990,1927,464,1463
7483,65,169,1990,1,1,0
7484,65,166,1990,41,9,32
7485,65,93,1990,13,8,5
7486,65,146,1990,574,207,367
7487,65,26,1990,454,164,290
7488,65,170,1990,1,1,0
7489,65,130,1990,11,6,5
7490,65,38,1990,408,239,169
7491,65,27,1990,14,7,7
7492,65,50,1990,61463,33232,28231
7493,65,131,1990,28,14,14
7494,65,114,1990,10922,5694,5228
7495,65,171,1990,27,17,10
7496,65,1,1990,363,198,165
7497,65,28,1990,21,4,17
7498,65,132,1990,13,7,6
7499,65,133,1990,23,12,11
7500,10,2,1990,0,0,0
7501,10,13,1990,4,2,2
7502,10,3,1990,7,2,5
7503,10,4,1990,2,1,1
7504,10,172,1990,37,7,30
7505,10,14,1990,2,1,1
7506,10,42,1990,0,0,0
7507,10,68,1990,50,19,31
7508,10,69,1990,21,7,14
7509,10,56,1990,1,0,1
7510,10,85,1990,0,0,0
7511,10,5,1990,39329,17182,22147
7512,10,6,1990,1,0,1
7513,10,16,1990,0,0,0
7514,10,17,1990,0,0,0
7515,10,57,1990,3,0,3
7516,10,177,1990,9,3,6
7517,10,18,1990,3,1,2
7518,10,19,1990,20,10,10
7519,10,20,1990,8,4,4
7520,10,143,1990,0,0,0
7521,10,7,1990,17,9,8
7522,10,21,1990,3,2,1
7523,10,8,1990,4,1,3
7524,10,48,1990,1,0,1
7525,10,9,1990,173,87,86
7526,10,61,1990,0,0,0
7527,10,22,1990,3,1,2
7528,10,36,1990,1,0,1
7529,10,23,1990,15,7,8
7530,10,127,1990,0,0,0
7531,10,115,1990,3,1,2
7532,10,65,1990,0,0,0
7533,10,49,1990,29,11,18
7534,10,74,1990,6,2,4
7535,10,25,1990,0,0,0
7536,10,27,1990,19,9,10
7537,10,26,1990,0,0,0
7538,10,142,1990,1,0,1
7539,10,50,1990,48,17,31
7540,145,136,1990,196164,98462,97702
7541,145,172,1990,1678,815,863
7542,145,137,1990,15855,7800,8055
7543,145,120,1990,942295,478499,463796
7544,145,119,1990,64790,31481,33309
7545,145,5,1990,2259,1097,1162
7546,145,121,1990,6118,2973,3145
7547,145,143,1990,2388,1160,1228
7548,145,160,1990,1058,514,544
7549,145,162,1990,23208,11280,11928
7550,145,128,1990,0,0,0
7551,145,129,1990,0,0,0
7552,145,130,1990,74433,37131,37302
7553,145,142,1990,21455,10424,11031
7554,113,105,1990,2100,967,1133
7555,113,172,1990,2055,946,1109
7556,113,110,1990,5114,2354,2760
7557,113,73,1990,1312,604,708
7558,49,2,1990,3368,1479,1889
7559,49,51,1990,293,133,160
7560,49,141,1990,1320,442,878
7561,49,52,1990,0,0,0
7562,49,134,1990,340,185,155
7563,49,76,1990,6,1,5
7564,49,103,1990,1913,951,962
7565,49,11,1990,267,139,128
7566,49,66,1990,4731,2060,2671
7567,49,12,1990,148,104,44
7568,49,78,1990,12,2,10
7569,49,13,1990,42,16,26
7570,49,3,1990,2307,1053,1254
7571,49,79,1990,79,22,57
7572,49,29,1990,352,230,122
7573,49,67,1990,943,456,487
7574,49,95,1990,4,0,4
7575,49,151,1990,17,6,11
7576,49,4,1990,7,1,6
7577,49,53,1990,40488,20103,20385
7578,49,147,1990,38,24,14
7579,49,105,1990,2747,1689,1058
7580,49,30,1990,2756,1421,1335
7581,49,152,1990,26,9,17
7582,49,116,1990,65,30,35
7583,49,153,1990,231,124,107
7584,49,135,1990,84,27,57
7585,49,136,1990,22,4,18
7586,49,106,1990,21091,10401,10690
7587,49,172,1990,6920,4067,2853
7588,49,173,1990,440,251,189
7589,49,107,1990,5749,2653,3096
7590,49,117,1990,7,3,4
7591,49,137,1990,125,58,67
7592,49,96,1990,162,85,77
7593,49,54,1990,4108,1971,2137
7594,49,81,1990,1170,477,693
7595,49,14,1990,355,130,225
7596,49,31,1990,252,163,89
7597,49,176,1990,44,13,31
7598,49,137,1990,784,343,441
7599,49,39,1990,30009,14261,15748
7600,49,118,1990,44,26,18
7601,49,82,1990,36,17,19
7602,49,83,1990,192,94,98
7603,49,108,1990,746,359,387
7604,49,142,1990,1638,581,1057
7605,49,97,1990,1832,865,967
7606,49,138,1990,8,6,2
7607,49,119,1990,2399,1125,1274
7608,49,40,1990,8056,4521,3535
7609,49,148,1990,12,7,5
7610,49,120,1990,9356,4302,5054
7611,49,42,1990,153578,88298,65280
7612,49,68,1990,4401,1807,2594
7613,49,139,1990,3,0,3
7614,49,155,1990,1965,789,1176
7615,49,15,1990,103,60,43
7616,49,69,1990,29981,16418,13563
7617,49,156,1990,770,316,454
7618,49,55,1990,0,0,0
7619,49,56,1990,8526,3380,5146
7620,49,84,1990,31,4,27
7621,49,98,1990,517,240,277
7622,49,157,1990,88,34,54
7623,49,158,1990,61,23,38
7624,49,110,1990,83,51,32
7625,49,85,1990,84,36,48
7626,49,99,1990,165,82,83
7627,49,32,1990,11100,5373,5727
7628,49,43,1990,2773,1350,1423
7629,49,5,1990,8730,5171,3559
7630,49,6,1990,40154,18131,22023
7631,49,16,1990,38795,16694,22101
7632,49,44,1990,870,335,535
7633,49,17,1990,1192,458,734
7634,49,57,1990,4979,1592,3387
7635,49,86,1990,153,62,91
7636,49,177,1990,1793,1044,749
7637,49,18,1990,839,361,478
7638,49,167,1990,135,92,43
7639,49,121,1990,995,550,445
7640,49,19,1990,635,294,341
7641,49,168,1990,36,27,9
7642,49,46,1990,1811,1065,746
7643,49,20,1990,15745,6967,8778
7644,49,149,1990,16,11,5
7645,49,159,1990,438,226,212
7646,49,143,1990,293,105,188
7647,49,70,1990,0,0,0
7648,49,47,1990,616,361,255
7649,49,71,1990,94,49,45
7650,49,122,1990,57,38,19
7651,49,123,1990,31,14,17
7652,49,7,1990,5,3,2
7653,49,160,1990,40,7,33
7654,49,58,1990,68,31,37
7655,49,161,1990,15,1,14
7656,49,124,1990,104,67,37
7657,49,100,1990,847,452,395
7658,49,72,1990,11,2,9
7659,49,59,1990,0,0,0
7660,49,144,1990,3529,1415,2114
7661,49,125,1990,154,96,58
7662,49,150,1990,37,17,20
7663,49,8,1990,121,55,66
7664,49,73,1990,3561,1486,2075
7665,49,101,1990,317,184,133
7666,49,162,1990,550,154,396
7667,49,60,1990,1856,875,981
7668,49,48,1990,33367,19398,13969
7669,49,21,1990,5,3,2
7670,49,9,1990,2435,1062,1373
7671,49,102,1990,157,76,81
7672,49,111,1990,102,53,49
7673,49,112,1990,3560,1840,1720
7674,49,33,1990,31527,20384,11143
7675,49,61,1990,1975,884,1091
7676,49,22,1990,18,10,8
7677,49,35,1990,9253,4971,4282
7678,49,36,1990,5125,3355,1770
7679,49,126,1990,88,42,46
7680,49,90,1990,0,0,0
7681,49,91,1990,22,6,16
7682,49,92,1990,10,2,8
7683,49,62,1990,7,2,5
7684,49,140,1990,6,1,5
7685,49,23,1990,656,315,341
7686,49,164,1990,180,72,108
7687,49,63,1990,0,0,0
7688,49,127,1990,36,26,10
7689,49,165,1990,170,75,95
7690,49,37,1990,190,123,67
7691,49,64,1990,536,244,292
7692,49,128,1990,10279,4806,5473
7693,49,115,1990,798,344,454
7694,49,129,1990,0,0,0
7695,49,65,1990,3990,1617,2373
7696,49,10,1990,4599,2559,2040
7697,49,145,1990,557,243,314
7698,49,113,1990,16,8,8
7699,49,74,1990,1877,853,1024
7700,49,25,1990,11128,5556,5572
7701,49,169,1990,51,32,19
7702,49,166,1990,182,70,112
7703,49,93,1990,183,103,80
7704,49,146,1990,2143,652,1491
7705,49,26,1990,25061,11774,13287
7706,49,170,1990,44,30,14
7707,49,130,1990,1880,935,945
7708,49,38,1990,1146,788,358
7709,49,27,1990,275,135,140
7710,49,50,1990,11473,4094,7379
7711,49,131,1990,664,337,327
7712,49,114,1990,1749,831,918
7713,49,171,1990,121,77,44
7714,49,1,1990,8563,4445,4118
7715,49,28,1990,135,58,77
7716,49,132,1990,192,99,93
7717,49,133,1990,199,101,98
7718,74,2,1990,1756,692,1064
7719,74,51,1990,1333,530,803
7720,74,141,1990,5334,2049,3285
7721,74,52,1990,20,8,12
7722,74,134,1990,3772,1720,2052
7723,74,76,1990,20,3,17
7724,74,103,1990,4509,2301,2208
7725,74,11,1990,374,182,192
7726,74,66,1990,48450,30675,17775
7727,74,12,1990,119,62,57
7728,74,78,1990,75,37,38
7729,74,13,1990,78,34,44
7730,74,3,1990,730,159,571
7731,74,79,1990,44,21,23
7732,74,29,1990,140,93,47
7733,74,67,1990,9525,5186,4339
7734,74,95,1990,11,4,7
7735,74,151,1990,174,68,106
7736,74,4,1990,58,25,33
7737,74,53,1990,41166,19934,21232
7738,74,147,1990,19,8,11
7739,74,105,1990,13295,9146,4149
7740,74,30,1990,2439,1535,904
7741,74,152,1990,206,82,124
7742,74,116,1990,306,163,143
7743,74,153,1990,1084,537,547
7744,74,135,1990,2245,1359,886
7745,74,136,1990,157,77,80
7746,74,106,1990,4716,2368,2348
7747,74,172,1990,8082,4567,3515
7748,74,107,1990,5057,2978,2079
7749,74,117,1990,15,7,8
7750,74,137,1990,3193,1434,1759
7751,74,96,1990,412,245,167
7752,74,54,1990,21387,11062,10325
7753,74,81,1990,1035,634,401
7754,74,14,1990,204,76,128
7755,74,31,1990,9776,5387,4389
7756,74,176,1990,106,53,53
7757,74,137,1990,805,338,467
7758,74,39,1990,3655,2253,1402
7759,74,118,1990,38,22,16
7760,74,82,1990,66,48,18
7761,74,83,1990,4751,3498,1253
7762,74,108,1990,1470,890,580
7763,74,142,1990,3959,1592,2367
7764,74,97,1990,369,210,159
7765,74,138,1990,23,10,13
7766,74,119,1990,995,491,504
7767,74,40,1990,195,134,61
7768,74,148,1990,44,28,16
7769,74,120,1990,1595,788,807
7770,74,42,1990,3408,2531,877
7771,74,68,1990,87249,48468,38781
7772,74,139,1990,136,80,56
7773,74,155,1990,157,14,143
7774,74,15,1990,293,135,158
7775,74,69,1990,161440,91339,70101
7776,74,156,1990,1464,724,740
7777,74,56,1990,5583,2520,3063
7778,74,84,1990,35,19,16
7779,74,98,1990,472,277,195
7780,74,157,1990,375,82,293
7781,74,158,1990,126,35,91
7782,74,110,1990,96,63,33
7783,74,85,1990,993,664,329
7784,74,99,1990,250,160,90
7785,74,32,1990,11002,5364,5638
7786,74,43,1990,133,68,65
7787,74,5,1990,7360,3539,3821
7788,74,6,1990,4686,2031,2655
7789,74,16,1990,3291,993,2298
7790,74,44,1990,1367,789,578
7791,74,17,1990,1754,750,1004
7792,74,57,1990,208147,90992,117155
7793,74,86,1990,430,245,185
7794,74,177,1990,3892,2500,1392
7795,74,18,1990,279,104,175
7796,74,167,1990,224,148,76
7797,74,121,1990,1576,850,726
7798,74,19,1990,176,74,102
7799,74,168,1990,39,28,11
7800,74,46,1990,422,300,122
7801,74,20,1990,3516,1056,2460
7802,74,149,1990,80,41,39
7803,74,159,1990,272,106,166
7804,74,143,1990,636,242,394
7805,74,70,1990,2790,1669,1121
7806,74,47,1990,383,256,127
7807,74,71,1990,1272,695,577
7808,74,122,1990,870,515,355
7809,74,123,1990,43,21,22
7810,74,7,1990,31,8,23
7811,74,160,1990,173,49,124
7812,74,58,1990,127,64,63
7813,74,161,1990,74,20,54
7814,74,124,1990,1750,1294,456
7815,74,100,1990,2539,1606,933
7816,74,72,1990,116,63,53
7817,74,59,1990,0,0,0
7818,74,144,1990,8362,4414,3948
7819,74,125,1990,709,395,314
7820,74,150,1990,127,72,55
7821,74,8,1990,353,162,191
7822,74,73,1990,14877,8258,6619
7823,74,101,1990,244,151,93
7824,74,162,1990,1315,404,911
7825,74,60,1990,36819,16236,20583
7826,74,48,1990,1612,923,689
7827,74,21,1990,15,3,12
7828,74,9,1990,1918,530,1388
7829,74,102,1990,258,147,111
7830,74,111,1990,356,192,164
7831,74,112,1990,4829,3069,1760
7832,74,33,1990,9473,5715,3758
7833,74,61,1990,89576,40878,48698
7834,74,22,1990,11,4,7
7835,74,35,1990,6255,3683,2572
7836,74,36,1990,5876,3756,2120
7837,74,126,1990,619,319,300
7838,74,90,1990,0,0,0
7839,74,91,1990,54,18,36
7840,74,92,1990,0,0,0
7841,74,62,1990,0,0,0
7842,74,140,1990,37,21,16
7843,74,23,1990,393,178,215
7844,74,164,1990,893,333,560
7845,74,63,1990,38963,17689,21274
7846,74,127,1990,173,120,53
7847,74,165,1990,408,83,325
7848,74,37,1990,3313,1962,1351
7849,74,64,1990,3460,2043,1417
7850,74,128,1990,2647,1279,1368
7851,74,115,1990,4029,2178,1851
7852,74,129,1990,0,0,0
7853,74,65,1990,54716,25955,28761
7854,74,10,1990,18837,7454,11383
7855,74,145,1990,426,155,271
7856,74,113,1990,67,47,20
7857,74,49,1990,6101,3480,2621
7858,74,25,1990,1309,517,792
7859,74,169,1990,26,15,11
7860,74,166,1990,454,189,265
7861,74,93,1990,191,106,85
7862,74,146,1990,5067,1547,3520
7863,74,26,1990,51936,23001,28935
7864,74,170,1990,18,14,4
7865,74,130,1990,367,204,163
7866,74,38,1990,1593,1129,464
7867,74,27,1990,124,49,75
7868,74,50,1990,22512,11087,11425
7869,74,131,1990,522,268,254
7870,74,114,1990,950,505,445
7871,74,171,1990,96,56,40
7872,74,1,1990,7338,3727,3611
7873,74,28,1990,171,70,101
7874,74,132,1990,165,82,83
7875,74,133,1990,462,270,192
7876,25,2,1990,0,0,0
7877,25,16,1990,3825,1893,1932
7878,25,128,1990,200,98,102
7879,25,145,1990,0,0,0
7880,169,2,1990,8485,4759,3726
7881,169,141,1990,198,110,88
7882,169,12,1990,257,143,114
7883,169,66,1990,98,54,44
7884,169,11,1990,257,143,114
7885,169,29,1990,893,500,393
7886,169,172,1990,74,41,33
7887,169,39,1990,199,111,88
7888,169,15,1990,872,488,384
7889,169,69,1990,205,114,91
7890,169,5,1990,935,524,411
7891,169,6,1990,1813,1017,796
7892,169,16,1990,97,54,43
7893,169,167,1990,1101,617,484
7894,169,176,1990,238,133,105
7895,169,168,1990,20042,11242,8800
7896,169,21,1990,57,31,26
7897,169,73,1990,78,43,35
7898,169,9,1990,178,99,79
7899,169,33,1990,58,32,26
7900,169,36,1990,363565,204299,159266
7901,169,74,1990,81,45,36
7902,169,26,1990,1175,659,516
7903,169,170,1990,1084,608,476
7904,169,38,1990,3990,2238,1752
7905,169,50,1990,477,267,210
7906,169,171,1990,18848,10572,8276
7907,169,132,1990,38,20,18
7908,131,134,1990,717,290,427
7909,131,147,1990,80,26,54
7910,131,116,1990,232210,117918,114292
7911,131,117,1990,343,137,206
7912,131,137,1990,15007,7383,7624
7913,131,137,1990,19354,10142,9212
7914,131,69,1990,605,257,348
7915,131,5,1990,4968,2137,2831
7916,131,57,1990,360,153,207
7917,131,121,1990,33613,19211,14402
7918,131,149,1990,79,26,53
7919,131,123,1990,7218,3305,3913
7920,131,124,1990,113,43,70
7921,131,125,1990,144353,72912,71441
7922,131,150,1990,370,146,224
7923,131,9,1990,407,170,237
7924,131,126,1990,68609,33591,35018
7925,131,127,1990,214,85,129
7926,131,128,1990,467,186,281
7927,131,115,1990,409,161,248
7928,131,148,1990,51,17,34
7929,131,130,1990,19706,9408,10298
7930,131,50,1990,682,292,390
7931,131,132,1990,18188,9839,8349
7932,131,133,1990,488,196,292
7933,166,67,1990,24,8,16
7934,166,135,1990,334,127,207
7935,166,153,1990,19,8,11
7936,166,136,1990,342,117,225
7937,166,172,1990,247,48,199
7938,166,137,1990,123,50,73
7939,166,137,1990,277,148,129
7940,166,151,1990,24038,10803,13235
7941,166,138,1990,50,20,30
7942,166,68,1990,1816,855,961
7943,166,139,1990,430,201,229
7944,166,155,1990,510,234,276
7945,166,69,1990,75,43,32
7946,166,156,1990,12685,7313,5372
7947,166,157,1990,1553,739,814
7948,166,159,1990,81,42,39
7949,166,160,1990,1539,667,872
7950,166,161,1990,68,40,28
7951,166,162,1990,9708,4275,5433
7952,166,158,1990,62,36,26
7953,166,126,1990,880,447,433
7954,166,140,1990,19,10,9
7955,166,164,1990,483,224,259
7956,166,165,1990,49,27,22
7957,166,152,1990,6133,2759,3374
7958,93,79,1990,2411,1158,1253
7959,93,172,1990,469,227,242
7960,93,81,1990,40,18,22
7961,93,69,1990,137,71,66
7962,93,84,1990,16589,8885,7704
7963,93,110,1990,5140,3030,2110
7964,93,5,1990,768,379,389
7965,93,86,1990,811,417,394
7966,93,162,1990,271,104,167
7967,93,91,1990,1306,633,673
7968,93,92,1990,11629,6381,5248
7969,93,50,1990,2157,1080,1077
7970,146,141,1990,13757,6912,6845
7971,146,135,1990,0,0,0
7972,146,68,1990,3870,1944,1926
7973,146,69,1990,903,454,449
7974,146,16,1990,0,0,0
7975,146,57,1990,1622,815,807
7976,146,143,1990,1224,615,609
7977,146,160,1990,200,100,100
7978,146,161,1990,376,189,187
7979,146,144,1990,7275,3655,3620
7980,146,162,1990,116,58,58
7981,146,164,1990,325,163,162
7982,146,25,1990,375,188,187
7983,146,142,1990,607,305,302
7984,26,2,1990,7652,3777,3875
7985,26,51,1990,801,375,426
7986,26,141,1990,156,40,116
7987,26,12,1990,4062,1860,2202
7988,26,103,1990,34,16,18
7989,26,66,1990,6979,3539,3440
7990,26,3,1990,79,6,73
7991,26,11,1990,192,114,78
7992,26,67,1990,4703,2416,2287
7993,26,53,1990,6811,3030,3781
7994,26,105,1990,83,48,35
7995,26,30,1990,462767,237888,224879
7996,26,29,1990,72,52,20
7997,26,10,1990,18,1,17
7998,26,106,1990,10,6,4
7999,26,172,1990,529,240,289
8000,26,107,1990,11,7,4
8001,26,137,1990,7,2,5
8002,26,96,1990,13,5,8
8003,26,54,1990,53,28,25
8004,26,81,1990,10,4,6
8005,26,14,1990,9195,4775,4420
8006,26,31,1990,274,129,145
8007,26,39,1990,814,399,415
8008,26,120,1990,23,8,15
8009,26,40,1990,27,16,11
8010,26,42,1990,404,206,198
8011,26,68,1990,10280,5045,5235
8012,26,15,1990,1575,860,715
8013,26,69,1990,176820,88287,88533
8014,26,156,1990,34,4,30
8015,26,56,1990,101752,53969,47783
8016,26,173,1990,14,7,7
8017,26,32,1990,126,69,57
8018,26,43,1990,10,5,5
8019,26,5,1990,126,44,82
8020,26,6,1990,23816,9921,13895
8021,26,16,1990,33620,15446,18174
8022,26,44,1990,130,62,68
8023,26,17,1990,658,300,358
8024,26,57,1990,1958,879,1079
8025,26,177,1990,972,460,512
8026,26,167,1990,1209,632,577
8027,26,18,1990,217,74,143
8028,26,121,1990,42,14,28
8029,26,176,1990,7,3,4
8030,26,19,1990,69,23,46
8031,26,168,1990,423,174,249
8032,26,20,1990,273,130,143
8033,26,46,1990,15,10,5
8034,26,143,1990,743,303,440
8035,26,47,1990,63,36,27
8036,26,71,1990,11,5,6
8037,26,58,1990,10,6,4
8038,26,100,1990,37,18,19
8039,26,144,1990,113,43,70
8040,26,21,1990,6,3,3
8041,26,73,1990,9916,5017,4899
8042,26,162,1990,70,9,61
8043,26,48,1990,860,415,445
8044,26,9,1990,275,104,171
8045,26,112,1990,13,7,6
8046,26,33,1990,826,412,414
8047,26,61,1990,54,26,28
8048,26,22,1990,7,2,5
8049,26,35,1990,5018,2828,2190
8050,26,36,1990,11430,5094,6336
8051,26,23,1990,3344,1582,1762
8052,26,164,1990,16,5,11
8053,26,37,1990,76,38,38
8054,26,1,1990,7,4,3
8055,26,64,1990,35,17,18
8056,26,128,1990,114,38,76
8057,26,115,1990,71,32,39
8058,26,65,1990,292,145,147
8059,26,145,1990,63,13,50
8060,26,148,1990,18,11,7
8061,26,49,1990,1291,653,638
8062,26,74,1990,8109,4091,4018
8063,26,25,1990,5247,2505,2742
8064,26,169,1990,64,14,50
8065,26,27,1990,3344,1582,1762
8066,26,146,1990,132,45,87
8067,26,170,1990,492,130,362
8068,26,38,1990,1011,669,342
8069,26,60,1990,37647,18396,19251
8070,26,142,1990,2318,1004,1314
8071,26,50,1990,6483,3343,3140
8072,26,131,1990,53,5,48
8073,26,114,1990,10,4,6
8074,26,171,1990,1992,966,1026
8075,26,28,1990,16,6,10
8076,170,2,1990,321,163,158
8077,170,12,1990,11793,6511,5282
8078,170,11,1990,11254,6128,5126
8079,170,29,1990,3259,1230,2029
8080,170,69,1990,1567,980,587
8081,170,6,1990,2699,1460,1239
8082,170,167,1990,31076,17071,14005
8083,170,36,1990,118324,70285,48039
8084,170,169,1990,1456,742,714
8085,170,38,1990,12676,6638,6038
8086,170,171,1990,110271,60266,50005
8087,94,78,1990,840,405,435
8088,94,83,1990,349,168,181
8089,94,85,1990,2430,1172,1258
8090,94,50,1990,246,118,128
8091,130,141,1990,35,8,27
8092,130,3,1990,49,39,10
8093,130,67,1990,44,19,25
8094,130,116,1990,48841,18152,30689
8095,130,172,1990,137,39,98
8096,130,137,1990,65659,33546,32113
8097,130,81,1990,144,29,115
8098,130,39,1990,170,77,93
8099,130,120,1990,162,79,83
8100,130,119,1990,0,0,0
8101,130,68,1990,241,83,158
8102,130,155,1990,29,0,29
8103,130,69,1990,226,98,128
8104,130,156,1990,29,19,10
8105,130,56,1990,40,19,21
8106,130,32,1990,10,9,1
8107,130,5,1990,1313,381,932
8108,130,57,1990,390,34,356
8109,130,177,1990,68,19,49
8110,130,121,1990,32265,18040,14225
8111,130,176,1990,51,9,42
8112,130,143,1990,49,29,20
8113,130,123,1990,184,87,97
8114,130,161,1990,39,9,30
8115,130,125,1990,226,120,106
8116,130,73,1990,208,96,112
8117,130,162,1990,115,66,49
8118,130,48,1990,9,0,9
8119,130,9,1990,216,39,177
8120,130,36,1990,295,154,141
8121,130,126,1990,214634,102433,112201
8122,130,164,1990,58,12,46
8123,130,128,1990,378,117,261
8124,130,133,1990,84,38,46
8125,130,65,1990,59,36,23
8126,130,129,1990,0,0,0
8127,130,145,1990,124116,62650,61466
8128,130,49,1990,29,0,29
8129,130,166,1990,105,42,63
8130,130,142,1990,44,9,35
8131,130,50,1990,1034,488,546
8132,130,131,1990,31528,13620,17908
8133,130,132,1990,194,106,88
8134,38,2,1990,2552,607,1945
8135,38,12,1990,81482,46567,34915
8136,38,11,1990,35141,20083,15058
8137,38,30,1990,2094,722,1372
8138,38,29,1990,403448,230571,172877
8139,38,172,1990,7924,3036,4888
8140,38,40,1990,10585,6049,4536
8141,38,15,1990,76612,43784,32828
8142,38,69,1990,1308,643,665
8143,38,5,1990,4609,961,3648
8144,38,6,1990,2580,510,2070
8145,38,17,1990,4532,2348,2184
8146,38,167,1990,330947,189137,141810
8147,38,18,1990,4486,108,4378
8148,38,168,1990,37304,21319,15985
8149,38,20,1990,2132,125,2007
8150,38,46,1990,20185,11536,8649
8151,38,47,1990,25282,14448,10834
8152,38,144,1990,2100,631,1469
8153,38,33,1990,3718,2141,1577
8154,38,36,1990,5018098,2867854,2150244
8155,38,1,1990,14964,6773,8191
8156,38,25,1990,4494,187,4307
8157,38,169,1990,34861,19923,14938
8158,38,26,1990,1637,247,1390
8159,38,170,1990,31201,17831,13370
8160,38,171,1990,131997,75436,56561
8161,27,2,1990,1630,469,1161
8162,27,13,1990,231,173,58
8163,27,3,1990,154869,15692,139177
8164,27,10,1990,44420,33087,11333
8165,27,136,1990,1063,306,757
8166,27,120,1990,2708,780,1928
8167,27,119,1990,3846,1108,2738
8168,27,68,1990,434,211,223
8169,27,5,1990,458294,104695,353599
8170,27,18,1990,26078,10502,15576
8171,27,19,1990,13095,3802,9293
8172,27,20,1990,5513,1588,3925
8173,27,144,1990,1948,561,1387
8174,27,8,1990,1730,498,1232
8175,27,73,1990,1320,829,491
8176,27,162,1990,1417,408,1009
8177,27,9,1990,158710,36752,121958
8178,27,22,1990,61,51,10
8179,27,23,1990,465,186,279
8180,27,128,1990,2578,743,1835
8181,27,129,1990,3951,1499,2452
8182,27,145,1990,32088,12171,19917
8183,27,25,1990,13462,3878,9584
8184,27,146,1990,1175,338,837
8185,27,26,1990,9781,2818,6963
8186,27,142,1990,165980,62372,103608
8187,27,50,1990,12229,5159,7070
8188,27,28,1990,44514,12822,31692
8189,50,2,1990,2076,543,1533
8190,50,51,1990,156,65,91
8191,50,141,1990,3594,1241,2353
8192,50,52,1990,6,1,5
8193,50,134,1990,825,318,507
8194,50,75,1990,95,37,58
8195,50,76,1990,542,226,316
8196,50,103,1990,947,413,534
8197,50,11,1990,81,33,48
8198,50,77,1990,111,48,63
8199,50,66,1990,20222,14724,5498
8200,50,12,1990,77,31,46
8201,50,78,1990,250,100,150
8202,50,13,1990,583,219,364
8203,50,3,1990,102380,47917,54463
8204,50,79,1990,21736,10985,10751
8205,50,29,1990,310,106,204
8206,50,67,1990,16085,10476,5609
8207,50,95,1990,1194,761,433
8208,50,151,1990,32,11,21
8209,50,4,1990,11,2,9
8210,50,53,1990,1816,599,1217
8211,50,147,1990,1955,877,1078
8212,50,105,1990,9560,5484,4076
8213,50,30,1990,1670,767,903
8214,50,152,1990,12,3,9
8215,50,116,1990,281,115,166
8216,50,153,1990,45,18,27
8217,50,135,1990,451,173,278
8218,50,80,1990,150,65,85
8219,50,136,1990,25,4,21
8220,50,106,1990,717,302,415
8221,50,172,1990,23384,12458,10926
8222,50,173,1990,72371,34790,37581
8223,50,107,1990,5546,3509,2037
8224,50,117,1990,7,2,5
8225,50,137,1990,456,179,277
8226,50,96,1990,50,21,29
8227,50,54,1990,1897,656,1241
8228,50,81,1990,150,63,87
8229,50,14,1990,76295,36744,39551
8230,50,31,1990,8523,4698,3825
8231,50,176,1990,0,0,0
8232,50,137,1990,1195,447,748
8233,50,39,1990,13911,8878,5033
8234,50,118,1990,33,12,21
8235,50,82,1990,941,374,567
8236,50,83,1990,72,28,44
8237,50,108,1990,423,179,244
8238,50,142,1990,22368,10488,11880
8239,50,97,1990,81,37,44
8240,50,138,1990,6,2,4
8241,50,119,1990,914,367,547
8242,50,40,1990,545,174,371
8243,50,148,1990,118,46,72
8244,50,120,1990,1086,429,657
8245,50,41,1990,38,17,21
8246,50,42,1990,5179,4091,1088
8247,50,68,1990,52367,33236,19131
8248,50,139,1990,17,6,11
8249,50,155,1990,1354,599,755
8250,50,15,1990,76,30,46
8251,50,69,1990,213058,125949,87109
8252,50,156,1990,31872,16363,15509
8253,50,55,1990,11215,5919,5296
8254,50,56,1990,14266,6869,7397
8255,50,84,1990,1366,555,811
8256,50,98,1990,69,31,38
8257,50,157,1990,36,11,25
8258,50,158,1990,53,19,34
8259,50,110,1990,19978,11018,8960
8260,50,85,1990,21,10,11
8261,50,99,1990,59,27,32
8262,50,32,1990,12192,5051,7141
8263,50,43,1990,419,143,276
8264,50,5,1990,399526,204751,194775
8265,50,6,1990,31563,13113,18450
8266,50,16,1990,15166,6005,9161
8267,50,44,1990,611877,330985,280892
8268,50,45,1990,9974,5271,4703
8269,50,17,1990,11935,5749,6186
8270,50,57,1990,88822,44668,44154
8271,50,86,1990,138898,71869,67029
8272,50,177,1990,27561,14997,12564
8273,50,18,1990,2469,896,1573
8274,50,167,1990,121,60,61
8275,50,121,1990,109722,53237,56485
8276,50,19,1990,820,287,533
8277,50,168,1990,18,8,10
8278,50,46,1990,1160,303,857
8279,50,20,1990,8712,3584,5128
8280,50,149,1990,45,20,25
8281,50,159,1990,219,71,148
8282,50,143,1990,6468,2752,3716
8283,50,70,1990,7,2,5
8284,50,47,1990,1182,363,819
8285,50,71,1990,691,392,299
8286,50,122,1990,110,54,56
8287,50,123,1990,10474,5042,5432
8288,50,7,1990,27,10,17
8289,50,160,1990,16,4,12
8290,50,58,1990,30631,15964,14667
8291,50,161,1990,3,0,3
8292,50,124,1990,22883,10868,12015
8293,50,100,1990,704,297,407
8294,50,72,1990,60,16,44
8295,50,59,1990,197,59,138
8296,50,87,1990,1290,567,723
8297,50,144,1990,8857,3725,5132
8298,50,125,1990,467,187,280
8299,50,150,1990,172,66,106
8300,50,8,1990,828,204,624
8301,50,73,1990,28913,16815,12098
8302,50,101,1990,31,15,16
8303,50,162,1990,45984,22996,22988
8304,50,60,1990,347,133,214
8305,50,48,1990,8506,5127,3379
8306,50,21,1990,281,83,198
8307,50,9,1990,228321,110463,117858
8308,50,102,1990,68,30,38
8309,50,111,1990,70,28,42
8310,50,112,1990,567,271,296
8311,50,33,1990,71908,30551,41357
8312,50,61,1990,19323,10398,8925
8313,50,22,1990,148,52,96
8314,50,35,1990,3873,1828,2045
8315,50,36,1990,4247,1615,2632
8316,50,126,1990,331,139,192
8317,50,90,1990,910,368,542
8318,50,91,1990,1153,486,667
8319,50,92,1990,990,393,597
8320,50,140,1990,11,6,5
8321,50,23,1990,4198,1980,2218
8322,50,164,1990,100,34,66
8323,50,63,1990,1586,513,1073
8324,50,127,1990,2896,1657,1239
8325,50,165,1990,6161,3265,2896
8326,50,37,1990,1431,709,722
8327,50,64,1990,334,127,207
8328,50,128,1990,6078,2508,3570
8329,50,115,1990,66921,35936,30985
8330,50,65,1990,37827,21680,16147
8331,50,10,1990,38424,17626,20798
8332,50,145,1990,1489,505,984
8333,50,113,1990,36,15,21
8334,50,49,1990,10818,7166,3652
8335,50,74,1990,12338,8124,4214
8336,50,25,1990,2761,1114,1647
8337,50,169,1990,13,4,9
8338,50,166,1990,76,22,54
8339,50,93,1990,17191,10216,6975
8340,50,146,1990,2367,927,1440
8341,50,26,1990,25947,11218,14729
8342,50,170,1990,12,5,7
8343,50,94,1990,17,6,11
8344,50,130,1990,49648,23620,26028
8345,50,38,1990,3233,835,2398
8346,50,27,1990,754,248,506
8347,50,131,1990,29112,13879,15233
8348,50,114,1990,134,56,78
8349,50,171,1990,73,30,43
8350,50,1,1990,19674,9818,9856
8351,50,28,1990,1745,560,1185
8352,50,132,1990,16558,8325,8233
8353,50,133,1990,20857,10948,9909
8354,114,103,1990,14559,8901,5658
8355,114,105,1990,10581,3189,7392
8356,114,106,1990,1161,602,559
8357,114,68,1990,865,453,412
8358,114,69,1990,2573,1341,1232
8359,114,57,1990,15780,9729,6051
8360,114,100,1990,719,360,359
8361,114,111,1990,1241,210,1031
8362,114,112,1990,555,276,279
8363,114,33,1990,4067,2200,1867
8364,114,61,1990,1216,864,352
8365,114,35,1990,811,391,420
8366,114,65,1990,34478,17867,16611
8367,114,50,1990,535,272,263
8368,171,12,1990,23261,11579,11682
8369,171,11,1990,9213,4681,4532
8370,171,29,1990,37057,19844,17213
8371,171,69,1990,19362,10719,8643
8372,171,167,1990,30344,17258,13086
8373,171,168,1990,5481,2793,2688
8374,171,36,1990,1267201,718811,548390
8375,171,169,1990,4971,2528,2443
8376,171,170,1990,330,144,186
8377,171,38,1990,180213,100617,79596
8378,1,3,1990,225,10,215
8379,1,10,1990,46,22,24
8380,1,172,1990,612,289,323
8381,1,68,1990,21,7,14
8382,1,5,1990,116,82,34
8383,1,177,1990,124,43,81
8384,1,176,1990,56,25,31
8385,1,8,1990,106,56,50
8386,1,9,1990,30,4,26
8387,1,50,1990,256,116,140
8388,28,120,1990,15804,6629,9175
8389,28,119,1990,0,0,0
8390,28,6,1990,0,0,0
8391,28,16,1990,4943,2200,2743
8392,28,1,1990,706,296,410
8393,28,128,1990,36771,15729,21042
8394,28,129,1990,0,0,0
8395,28,145,1990,18648,8306,10342
8396,28,25,1990,2238,996,1242
8397,28,142,1990,8579,3819,4760
8398,132,134,1990,123807,61728,62079
8399,132,147,1990,469,294,175
8400,132,116,1990,0,0,0
8401,132,135,1990,10,2,8
8402,132,172,1990,100,28,72
8403,132,137,1990,116,64,52
8404,132,137,1990,27297,13176,14121
8405,132,68,1990,65,24,41
8406,132,69,1990,311,138,173
8407,132,156,1990,484,144,340
8408,132,5,1990,4284,2129,2155
8409,132,177,1990,146,47,99
8410,132,121,1990,433,157,276
8411,132,123,1990,17073,6632,10441
8412,132,160,1990,220,54,166
8413,132,125,1990,41455,20764,20691
8414,132,150,1990,2360,1087,1273
8415,132,162,1990,160,47,113
8416,132,126,1990,0,0,0
8417,132,164,1990,115,16,99
8418,132,115,1990,6328,3088,3240
8419,132,133,1990,34829,17995,16834
8420,132,130,1990,349,135,214
8421,132,142,1990,235,101,134
8422,132,50,1990,1987,897,1090
8423,132,131,1990,6930,3051,3879
8424,133,147,1990,2945,1264,1681
8425,133,123,1990,69618,29478,40140
8426,133,125,1990,482855,214238,268617
8427,133,115,1990,11426,4918,6508
8428,133,50,1990,19136,8217,10919
8429,133,132,1990,18966,7715,11251
8430,2,9,1995,17225,7503,9722
8431,2,169,1995,36733,16000,20733
8432,2,171,1995,1836,800,1036
8433,51,56,1995,43331,24520,18811
8434,51,57,1995,12200,6139,6061
8435,51,26,1995,2690,919,1771
8436,51,60,1995,732,405,327
8437,141,68,1995,1321,614,707
8438,141,69,1995,3661,1674,1987
8439,141,16,1995,4249,2185,2064
8440,141,57,1995,1942,907,1035
8441,141,18,1995,2272,1038,1234
8442,141,19,1995,1308,488,820
8443,141,20,1995,1395,783,612
8444,141,143,1995,2154,959,1195
8445,141,36,1995,3545,2205,1340
8446,141,23,1995,3497,1285,2212
8447,141,128,1995,6248,2737,3511
8448,141,145,1995,5362,2353,3009
8449,141,25,1995,3312,1490,1822
8450,141,50,1995,1430,656,774
8451,141,28,1995,2480,1016,1464
8452,52,103,1995,118,56,62
8453,52,67,1995,241,113,128
8454,52,106,1995,63,30,33
8455,52,39,1995,111,53,58
8456,52,68,1995,4216,1984,2232
8457,52,69,1995,351,165,186
8458,52,57,1995,130,61,69
8459,52,144,1995,383,181,202
8460,52,73,1995,209,98,111
8461,52,61,1995,5364,2531,2833
8462,52,65,1995,26972,12686,14286
8463,52,49,1995,52,24,28
8464,52,74,1995,69,33,36
8465,52,50,1995,975,459,516
8466,52,114,1995,78,37,41
8467,134,153,1995,4147,1996,2151
8468,134,136,1995,14,8,6
8469,134,137,1995,477,267,210
8470,134,137,1995,14957,7392,7565
8471,134,157,1995,152,83,69
8472,134,125,1995,113,54,59
8473,134,150,1995,401,198,203
8474,134,61,1995,6156,2323,3833
8475,134,126,1995,115,63,52
8476,134,140,1995,3617,1820,1797
8477,134,115,1995,2832,1397,1435
8478,134,132,1995,139,84,55
8479,75,83,1995,397,141,256
8480,75,110,1995,233,96,137
8481,75,86,1995,283,121,162
8482,75,87,1995,174,52,122
8483,75,90,1995,549,191,358
8484,75,50,1995,254,167,87
8485,76,78,1995,4,2,2
8486,76,79,1995,226,104,122
8487,76,95,1995,10,5,5
8488,76,172,1995,84,44,40
8489,76,81,1995,15,8,7
8490,76,82,1995,3170,1722,1448
8491,76,83,1995,1044,618,426
8492,76,120,1995,38,21,17
8493,76,68,1995,33,18,15
8494,76,109,1995,4,2,2
8495,76,69,1995,57,29,28
8496,76,156,1995,18,9,9
8497,76,84,1995,137,65,72
8498,76,110,1995,3489,1898,1591
8499,76,85,1995,19,10,9
8500,76,99,1995,5,3,2
8501,76,5,1995,49,25,24
8502,76,57,1995,54,28,26
8503,76,86,1995,1832,1190,642
8504,76,177,1995,10,5,5
8505,76,20,1995,46,24,22
8506,76,100,1995,4,2,2
8507,76,87,1995,890,451,439
8508,76,73,1995,15,8,7
8509,76,77,1995,6,3,3
8510,76,162,1995,34,18,16
8511,76,9,1995,4,2,2
8512,76,88,1995,37,19,18
8513,76,90,1995,430,226,204
8514,76,75,1995,25,13,12
8515,76,91,1995,474,260,214
8516,76,92,1995,616,276,340
8517,76,115,1995,28,15,13
8518,76,65,1995,8,4,4
8519,76,113,1995,23,13,10
8520,76,25,1995,171,89,82
8521,76,93,1995,474,245,229
8522,76,94,1995,5,3,2
8523,76,142,1995,10,5,5
8524,76,50,1995,720,370,350
8525,103,2,1995,20,18,2
8526,103,51,1995,144,60,84
8527,103,141,1995,224,90,134
8528,103,52,1995,1,0,1
8529,103,134,1995,20,13,7
8530,103,66,1995,3201,1847,1354
8531,103,13,1995,27,9,18
8532,103,11,1995,1207,617,590
8533,103,79,1995,16,16,0
8534,103,67,1995,1138,580,558
8535,103,105,1995,33642,19163,14479
8536,103,95,1995,12,10,2
8537,103,30,1995,796,374,422
8538,103,29,1995,653,372,281
8539,103,153,1995,50,31,19
8540,103,10,1995,6,0,6
8541,103,106,1995,214736,105883,108853
8542,103,172,1995,5850,2743,3107
8543,103,107,1995,3162,1703,1459
8544,103,137,1995,90,43,47
8545,103,96,1995,359,180,179
8546,103,54,1995,2119,1108,1011
8547,103,81,1995,1873,963,910
8548,103,14,1995,101,56,45
8549,103,31,1995,3852,2450,1402
8550,103,39,1995,527,284,243
8551,103,82,1995,9,9,0
8552,103,83,1995,849,619,230
8553,103,108,1995,1501,770,731
8554,103,97,1995,169,87,82
8555,103,120,1995,69,40,29
8556,103,40,1995,106,69,37
8557,103,42,1995,152,108,44
8558,103,68,1995,6229,3270,2959
8559,103,69,1995,12672,6807,5865
8560,103,55,1995,31,20,11
8561,103,56,1995,2666,1486,1180
8562,103,84,1995,24,24,0
8563,103,98,1995,158,65,93
8564,103,157,1995,1,1,0
8565,103,85,1995,80,18,62
8566,103,99,1995,140,74,66
8567,103,173,1995,9,0,9
8568,103,32,1995,2503,1393,1110
8569,103,43,1995,18,17,1
8570,103,5,1995,210,117,93
8571,103,6,1995,295,146,149
8572,103,16,1995,79,48,31
8573,103,44,1995,140,67,73
8574,103,17,1995,1317,664,653
8575,103,57,1995,273401,141854,131547
8576,103,86,1995,26,0,26
8577,103,177,1995,5181,2596,2585
8578,103,18,1995,156,57,99
8579,103,121,1995,6,4,2
8580,103,176,1995,30,0,30
8581,103,20,1995,2409,1195,1214
8582,103,46,1995,264,175,89
8583,103,143,1995,110,44,66
8584,103,70,1995,166,60,106
8585,103,47,1995,1400,905,495
8586,103,71,1995,208,154,54
8587,103,122,1995,14,14,0
8588,103,58,1995,4,3,1
8589,103,100,1995,2686,1328,1358
8590,103,72,1995,22,21,1
8591,103,144,1995,455,273,182
8592,103,125,1995,24,24,0
8593,103,150,1995,4,0,4
8594,103,73,1995,876,399,477
8595,103,77,1995,1,1,0
8596,103,101,1995,167,82,85
8597,103,162,1995,91,66,25
8598,103,48,1995,126,30,96
8599,103,9,1995,10,0,10
8600,103,102,1995,357,143,214
8601,103,111,1995,286164,161343,124821
8602,103,112,1995,50888,28186,22702
8603,103,33,1995,21429,11538,9891
8604,103,61,1995,11298,5458,5840
8605,103,88,1995,184,98,86
8606,103,35,1995,2985,1721,1264
8607,103,36,1995,4483,2539,1944
8608,103,62,1995,36,5,31
8609,103,23,1995,171,66,105
8610,103,1,1995,11,4,7
8611,103,64,1995,1741,920,821
8612,103,128,1995,4,0,4
8613,103,115,1995,271,147,124
8614,103,133,1995,3,3,0
8615,103,65,1995,179945,100436,79509
8616,103,145,1995,18,0,18
8617,103,113,1995,11,10,1
8618,103,49,1995,497,231,266
8619,103,74,1995,1919,910,1009
8620,103,25,1995,3607,1750,1857
8621,103,93,1995,73,26,47
8622,103,146,1995,97,33,64
8623,103,26,1995,1914,1039,875
8624,103,130,1995,1,1,0
8625,103,38,1995,5809,3174,2635
8626,103,60,1995,8143,4240,3903
8627,103,142,1995,510,236,274
8628,103,50,1995,2184,1232,952
8629,103,131,1995,1,0,1
8630,103,152,1995,25,21,4
8631,103,114,1995,125366,64121,61245
8632,103,132,1995,1,0,1
8633,11,12,1995,560521,324534,235987
8634,11,29,1995,929,635,294
8635,11,15,1995,27684,18196,9488
8636,11,69,1995,700,386,314
8637,11,56,1995,3387,2026,1361
8638,11,6,1995,10242,5764,4478
8639,11,16,1995,0,0,0
8640,11,167,1995,835,620,215
8641,11,20,1995,1198,703,495
8642,11,36,1995,36037,24937,11100
8643,11,25,1995,3422,1964,1458
8644,11,26,1995,2075,1480,595
8645,11,170,1995,871,596,275
8646,11,38,1995,5665,3858,1807
8647,11,171,1995,1220,880,340
8648,77,172,1995,435,193,242
8649,77,107,1995,4446,2702,1744
8650,77,82,1995,134,91,43
8651,77,83,1995,2829,2017,812
8652,77,84,1995,285,227,58
8653,77,110,1995,202,98,104
8654,77,85,1995,660,482,178
8655,77,5,1995,98,34,64
8656,77,86,1995,439,314,125
8657,77,73,1995,2885,1403,1482
8658,77,101,1995,48,26,22
8659,77,112,1995,540,245,295
8660,77,61,1995,183,86,97
8661,77,92,1995,178,115,63
8662,77,113,1995,997,499,498
8663,77,26,1995,63,4,59
8664,66,2,1995,5357,1725,3632
8665,66,51,1995,1955,966,989
8666,66,141,1995,802,189,613
8667,66,52,1995,2,0,2
8668,66,134,1995,212,95,117
8669,66,76,1995,5,5,0
8670,66,103,1995,947,462,485
8671,66,11,1995,1896,919,977
8672,66,77,1995,0,0,0
8673,66,12,1995,668,317,351
8674,66,78,1995,15,7,8
8675,66,13,1995,13,7,6
8676,66,3,1995,1701,556,1145
8677,66,79,1995,13,7,6
8678,66,29,1995,1036,753,283
8679,66,67,1995,1600,820,780
8680,66,95,1995,25,13,12
8681,66,151,1995,50,16,34
8682,66,4,1995,16,7,9
8683,66,53,1995,104186,51277,52909
8684,66,147,1995,17,9,8
8685,66,105,1995,3223,2052,1171
8686,66,30,1995,9777,5414,4363
8687,66,152,1995,76,33,43
8688,66,116,1995,60,25,35
8689,66,153,1995,25,15,10
8690,66,135,1995,407,148,259
8691,66,80,1995,0,0,0
8692,66,136,1995,8,3,5
8693,66,106,1995,782,408,374
8694,66,172,1995,10934,5941,4993
8695,66,173,1995,174,88,86
8696,66,174,1995,10,7,3
8697,66,107,1995,975,577,398
8698,66,117,1995,0,0,0
8699,66,137,1995,284,124,160
8700,66,96,1995,112,68,44
8701,66,54,1995,49385,25858,23527
8702,66,81,1995,547,374,173
8703,66,14,1995,201,93,108
8704,66,31,1995,34176,20684,13492
8705,66,176,1995,1749,1075,674
8706,66,137,1995,436,192,244
8707,66,39,1995,882,493,389
8708,66,118,1995,5,2,3
8709,66,82,1995,32,23,9
8710,66,83,1995,1943,1357,586
8711,66,108,1995,411,227,184
8712,66,142,1995,9253,3333,5920
8713,66,97,1995,43,25,18
8714,66,138,1995,7,3,4
8715,66,119,1995,65,36,29
8716,66,40,1995,232,169,63
8717,66,148,1995,15,9,6
8718,66,120,1995,793,457,336
8719,66,41,1995,0,0,0
8720,66,42,1995,993,708,285
8721,66,68,1995,5572,3000,2572
8722,66,139,1995,16,6,10
8723,66,155,1995,391,40,351
8724,66,15,1995,2061,974,1087
8725,66,69,1995,113756,67229,46527
8726,66,156,1995,1538,641,897
8727,66,55,1995,0,0,0
8728,66,56,1995,2488,882,1606
8729,66,84,1995,9,6,3
8730,66,98,1995,232,112,120
8731,66,157,1995,188,39,149
8732,66,158,1995,43,5,38
8733,66,110,1995,12,9,3
8734,66,85,1995,39,22,17
8735,66,99,1995,61,36,25
8736,66,32,1995,16251,10694,5557
8737,66,43,1995,117,63,54
8738,66,5,1995,8436,3450,4986
8739,66,6,1995,9629,4115,5514
8740,66,16,1995,3433,1272,2161
8741,66,44,1995,614,268,346
8742,66,17,1995,1593,685,908
8743,66,57,1995,20946,11921,9025
8744,66,86,1995,130,73,57
8745,66,177,1995,1846,1279,567
8746,66,18,1995,465,140,325
8747,66,167,1995,686,420,266
8748,66,121,1995,611,406,205
8749,66,19,1995,158,56,102
8750,66,168,1995,403,262,141
8751,66,46,1995,502,341,161
8752,66,20,1995,1145,451,694
8753,66,149,1995,3,3,0
8754,66,159,1995,170,28,142
8755,66,143,1995,287,115,172
8756,66,70,1995,235,141,94
8757,66,47,1995,565,369,196
8758,66,71,1995,474,218,256
8759,66,122,1995,47,34,13
8760,66,123,1995,24,11,13
8761,66,7,1995,6,2,4
8762,66,160,1995,61,17,44
8763,66,58,1995,68,38,30
8764,66,161,1995,21,2,19
8765,66,124,1995,72,37,35
8766,66,100,1995,939,537,402
8767,66,72,1995,16,9,7
8768,66,59,1995,13573,6783,6790
8769,66,144,1995,1197,533,664
8770,66,125,1995,42,23,19
8771,66,150,1995,114,68,46
8772,66,8,1995,365,129,236
8773,66,73,1995,5267,2651,2616
8774,66,101,1995,130,77,53
8775,66,162,1995,5273,1592,3681
8776,66,60,1995,13623,6049,7574
8777,66,48,1995,601,361,240
8778,66,21,1995,20,9,11
8779,66,9,1995,2991,1019,1972
8780,66,102,1995,39,24,15
8781,66,111,1995,142,80,62
8782,66,112,1995,1049,689,360
8783,66,33,1995,38190,21738,16452
8784,66,61,1995,1071,436,635
8785,66,88,1995,4,2,2
8786,66,22,1995,17,7,10
8787,66,35,1995,28168,17267,10901
8788,66,36,1995,19246,10618,8628
8789,66,126,1995,132,58,74
8790,66,90,1995,2,2,0
8791,66,91,1995,9,3,6
8792,66,92,1995,7,3,4
8793,66,62,1995,1,1,0
8794,66,140,1995,2,1,1
8795,66,23,1995,297,121,176
8796,66,164,1995,208,67,141
8797,66,63,1995,121286,60816,60470
8798,66,127,1995,27,16,11
8799,66,165,1995,166,39,127
8800,66,37,1995,16884,10680,6204
8801,66,64,1995,14355,8678,5677
8802,66,128,1995,756,293,463
8803,66,115,1995,1736,953,783
8804,66,65,1995,2562,1364,1198
8805,66,10,1995,610,273,337
8806,66,145,1995,395,102,293
8807,66,113,1995,13,6,7
8808,66,49,1995,2207,1267,940
8809,66,74,1995,9820,5214,4606
8810,66,25,1995,2063,757,1306
8811,66,169,1995,177,98,79
8812,66,166,1995,136,50,86
8813,66,93,1995,43,26,17
8814,66,146,1995,2294,680,1614
8815,66,26,1995,99359,45970,53389
8816,66,170,1995,87,57,30
8817,66,130,1995,170,79,91
8818,66,38,1995,5115,3548,1567
8819,66,27,1995,109,57,52
8820,66,50,1995,6845,3130,3715
8821,66,131,1995,98,47,51
8822,66,114,1995,175,94,81
8823,66,171,1995,469,256,213
8824,66,1,1995,2078,1088,990
8825,66,28,1995,59,24,35
8826,66,132,1995,71,41,30
8827,66,133,1995,186,93,93
8828,12,2,1995,223,65,158
8829,12,11,1995,205368,116135,89233
8830,12,29,1995,549,422,127
8831,12,40,1995,581,309,272
8832,12,15,1995,61233,32075,29158
8833,12,69,1995,341,193,148
8834,12,6,1995,1832,680,1152
8835,12,167,1995,4336,2559,1777
8836,12,168,1995,3061,1600,1461
8837,12,36,1995,34436,23516,10920
8838,12,169,1995,298,179,119
8839,12,26,1995,2540,659,1881
8840,12,170,1995,2065,1169,896
8841,12,38,1995,3372,2494,878
8842,12,171,1995,20391,10701,9690
8843,78,76,1995,10,6,4
8844,78,103,1995,8,5,3
8845,78,66,1995,18,11,7
8846,78,79,1995,171,64,107
8847,78,67,1995,14,6,8
8848,78,147,1995,0,0,0
8849,78,105,1995,41,23,18
8850,78,95,1995,22,15,7
8851,78,30,1995,0,0,0
8852,78,80,1995,9,5,4
8853,78,10,1995,16,8,8
8854,78,106,1995,8,4,4
8855,78,172,1995,80,29,51
8856,78,107,1995,30,17,13
8857,78,96,1995,38,22,16
8858,78,81,1995,79,48,31
8859,78,39,1995,22,10,12
8860,78,82,1995,41,19,22
8861,78,83,1995,64,31,33
8862,78,108,1995,12,9,3
8863,78,97,1995,4,3,1
8864,78,40,1995,0,0,0
8865,78,68,1995,89,37,52
8866,78,69,1995,190,90,100
8867,78,156,1995,44,20,24
8868,78,56,1995,63,25,38
8869,78,84,1995,27,13,14
8870,78,98,1995,8,6,2
8871,78,110,1995,550,283,267
8872,78,85,1995,15759,6389,9370
8873,78,99,1995,10,5,5
8874,78,173,1995,35,14,21
8875,78,5,1995,194,84,110
8876,78,44,1995,62,23,39
8877,78,57,1995,86,32,54
8878,78,86,1995,3282,2262,1020
8879,78,177,1995,22,16,6
8880,78,121,1995,5,3,2
8881,78,100,1995,51,20,31
8882,78,73,1995,33,17,16
8883,78,101,1995,8,4,4
8884,78,162,1995,61,19,42
8885,78,48,1995,11,3,8
8886,78,9,1995,13,6,7
8887,78,102,1995,15,9,6
8888,78,112,1995,41,19,22
8889,78,33,1995,10,7,3
8890,78,61,1995,5,3,2
8891,78,35,1995,12,0,12
8892,78,36,1995,14,8,6
8893,78,90,1995,12,7,5
8894,78,91,1995,41,23,18
8895,78,92,1995,21,7,14
8896,78,115,1995,54,20,34
8897,78,133,1995,0,0,0
8898,78,65,1995,40,12,28
8899,78,148,1995,0,0,0
8900,78,49,1995,21,13,8
8901,78,74,1995,120,50,70
8902,78,93,1995,299,155,144
8903,78,94,1995,1284,726,558
8904,78,130,1995,0,0,0
8905,78,38,1995,0,0,0
8906,78,142,1995,8,5,3
8907,78,50,1995,1834,829,1005
8908,78,114,1995,2,2,0
8909,13,2,1995,236,69,167
8910,13,3,1995,24630,3630,21000
8911,13,10,1995,5119,3328,1791
8912,13,136,1995,154,45,109
8913,13,120,1995,392,116,276
8914,13,119,1995,558,165,393
8915,13,68,1995,118,54,64
8916,13,5,1995,74599,19109,55490
8917,13,18,1995,4019,1551,2468
8918,13,19,1995,1913,573,1340
8919,13,20,1995,800,236,564
8920,13,144,1995,282,83,199
8921,13,8,1995,250,74,176
8922,13,73,1995,156,86,70
8923,13,162,1995,205,60,145
8924,13,9,1995,25280,6354,18926
8925,13,22,1995,13,10,3
8926,13,23,1995,108,40,68
8927,13,128,1995,374,110,264
8928,13,129,1995,586,218,368
8929,13,145,1995,4760,1776,2984
8930,13,25,1995,1955,579,1376
8931,13,27,1995,1359,769,590
8932,13,146,1995,170,50,120
8933,13,26,1995,1420,420,1000
8934,13,142,1995,23628,8570,15058
8935,13,50,1995,1493,603,890
8936,13,28,1995,6464,1916,4548
8937,3,13,1995,10375,4772,5603
8938,3,105,1995,5387,2478,2909
8939,3,172,1995,131427,60456,70971
8940,3,5,1995,18075,8314,9761
8941,3,177,1995,9330,4291,5039
8942,3,8,1995,11361,5226,6135
8943,3,48,1995,7022,3230,3792
8944,3,1,1995,29184,13424,15760
8945,3,50,1995,16056,7385,8671
8946,79,76,1995,246,164,82
8947,79,78,1995,59,32,27
8948,79,95,1995,0,0,0
8949,79,172,1995,0,0,0
8950,79,81,1995,0,0,0
8951,79,82,1995,492,336,156
8952,79,84,1995,616,401,215
8953,79,110,1995,2792,1668,1124
8954,79,85,1995,0,0,0
8955,79,5,1995,481,235,246
8956,79,86,1995,679,456,223
8957,79,90,1995,0,0,0
8958,79,91,1995,3621,2250,1371
8959,79,92,1995,4014,2307,1707
8960,79,113,1995,0,0,0
8961,79,93,1995,1910,1157,753
8962,79,50,1995,3262,1762,1500
8963,29,2,1995,216,64,152
8964,29,141,1995,41,6,35
8965,29,12,1995,14826,6310,8516
8966,29,103,1995,92,53,39
8967,29,66,1995,53,33,20
8968,29,11,1995,6295,2534,3761
8969,29,67,1995,33,12,21
8970,29,105,1995,83,54,29
8971,29,30,1995,47,21,26
8972,29,81,1995,34,2,32
8973,29,31,1995,91,57,34
8974,29,39,1995,168,64,104
8975,29,120,1995,18,1,17
8976,29,40,1995,3397,1970,1427
8977,29,42,1995,1688,825,863
8978,29,15,1995,9348,3973,5375
8979,29,69,1995,50,21,29
8980,29,56,1995,139,83,56
8981,29,32,1995,323,182,141
8982,29,5,1995,37,6,31
8983,29,6,1995,38,7,31
8984,29,44,1995,20,13,7
8985,29,17,1995,297,148,149
8986,29,57,1995,17,2,15
8987,29,167,1995,76868,40006,36862
8988,29,18,1995,22,1,21
8989,29,176,1995,80,48,32
8990,29,168,1995,5751,2984,2767
8991,29,20,1995,50,0,50
8992,29,46,1995,10983,6813,4170
8993,29,47,1995,18210,11779,6431
8994,29,48,1995,56,23,33
8995,29,9,1995,37,0,37
8996,29,33,1995,365,185,180
8997,29,35,1995,17,9,8
8998,29,36,1995,749767,416651,333116
8999,29,63,1995,27,9,18
9000,29,37,1995,26,16,10
9001,29,1,1995,282,138,144
9002,29,65,1995,34,16,18
9003,29,49,1995,271,119,152
9004,29,74,1995,26,13,13
9005,29,25,1995,63,0,63
9006,29,169,1995,6240,3065,3175
9007,29,27,1995,19,9,10
9008,29,26,1995,18,1,17
9009,29,170,1995,6005,3090,2915
9010,29,38,1995,248032,128693,119339
9011,29,50,1995,409,231,178
9012,29,114,1995,25,19,6
9013,29,171,1995,16225,8417,7808
9014,29,28,1995,24,4,20
9015,67,2,1995,79,39,40
9016,67,51,1995,2143,1051,1092
9017,67,141,1995,24149,10488,13661
9018,67,52,1995,0,0,0
9019,67,134,1995,985,459,526
9020,67,76,1995,0,0,0
9021,67,103,1995,1152,620,532
9022,67,11,1995,6,3,3
9023,67,66,1995,1917,949,968
9024,67,12,1995,6,3,3
9025,67,78,1995,13,6,7
9026,67,13,1995,55,0,55
9027,67,3,1995,820,274,546
9028,67,79,1995,20,16,4
9029,67,29,1995,149,97,52
9030,67,95,1995,0,0,0
9031,67,151,1995,1380,539,841
9032,67,4,1995,158,59,99
9033,67,53,1995,306,151,155
9034,67,147,1995,24,12,12
9035,67,105,1995,2304,1449,855
9036,67,30,1995,1069,649,420
9037,67,152,1995,487,189,298
9038,67,116,1995,1506,707,799
9039,67,153,1995,459,294,165
9040,67,135,1995,2173,1024,1149
9041,67,80,1995,0,0,0
9042,67,136,1995,202,86,116
9043,67,106,1995,4983,2379,2604
9044,67,172,1995,5889,2918,2971
9045,67,107,1995,2318,1389,929
9046,67,117,1995,0,0,0
9047,67,137,1995,4892,1910,2982
9048,67,96,1995,136,70,66
9049,67,54,1995,72,37,35
9050,67,81,1995,495,328,167
9051,67,14,1995,77,45,32
9052,67,31,1995,55,30,25
9053,67,176,1995,1674,996,678
9054,67,137,1995,47249,22148,25101
9055,67,39,1995,2442,1298,1144
9056,67,118,1995,76,37,39
9057,67,82,1995,97,48,49
9058,67,83,1995,1792,1240,552
9059,67,108,1995,1598,981,617
9060,67,142,1995,1627,483,1144
9061,67,97,1995,272,162,110
9062,67,138,1995,1692,660,1032
9063,67,119,1995,1,0,1
9064,67,40,1995,57,31,26
9065,67,148,1995,0,0,0
9066,67,120,1995,2711,1058,1653
9067,67,42,1995,1541,919,622
9068,67,68,1995,123438,64414,59024
9069,67,139,1995,306,148,158
9070,67,155,1995,194,69,125
9071,67,15,1995,183,93,90
9072,67,69,1995,65226,30996,34230
9073,67,156,1995,2903,1395,1508
9074,67,55,1995,0,0,0
9075,67,56,1995,18488,8534,9954
9076,67,84,1995,0,0,0
9077,67,98,1995,5692,2337,3355
9078,67,157,1995,793,248,545
9079,67,158,1995,121,67,54
9080,67,110,1995,92,69,23
9081,67,85,1995,1784,855,929
9082,67,99,1995,96,64,32
9083,67,32,1995,1593,838,755
9084,67,43,1995,116,63,53
9085,67,5,1995,6415,2575,3840
9086,67,6,1995,2480,1109,1371
9087,67,16,1995,59,29,30
9088,67,44,1995,2195,1209,986
9089,67,17,1995,4018,1761,2257
9090,67,57,1995,163850,74555,89295
9091,67,86,1995,264,167,97
9092,67,177,1995,3490,1731,1759
9093,67,18,1995,271,96,175
9094,67,167,1995,14,7,7
9095,67,121,1995,534,314,220
9096,67,19,1995,136,58,78
9097,67,168,1995,7,3,4
9098,67,46,1995,75,47,28
9099,67,20,1995,3592,1283,2309
9100,67,149,1995,8,5,3
9101,67,159,1995,369,111,258
9102,67,143,1995,216,84,132
9103,67,70,1995,3,2,1
9104,67,47,1995,76,49,27
9105,67,71,1995,12473,5236,7237
9106,67,122,1995,1049,772,277
9107,67,123,1995,29,11,18
9108,67,7,1995,2,2,0
9109,67,160,1995,270,125,145
9110,67,58,1995,258,134,124
9111,67,161,1995,868,186,682
9112,67,124,1995,3397,2400,997
9113,67,100,1995,1637,1024,613
9114,67,72,1995,77,31,46
9115,67,59,1995,10,4,6
9116,67,144,1995,267838,126931,140907
9117,67,125,1995,189,144,45
9118,67,150,1995,29,16,13
9119,67,8,1995,50,25,25
9120,67,73,1995,71295,32839,38456
9121,67,101,1995,134,95,39
9122,67,162,1995,1434,553,881
9123,67,60,1995,120,55,65
9124,67,48,1995,978,454,524
9125,67,21,1995,2,2,0
9126,67,9,1995,4078,1319,2759
9127,67,102,1995,105,71,34
9128,67,111,1995,166,113,53
9129,67,112,1995,1865,1183,682
9130,67,33,1995,6931,4174,2757
9131,67,61,1995,16854,8167,8687
9132,67,22,1995,0,0,0
9133,67,35,1995,2714,1642,1072
9134,67,36,1995,546,320,226
9135,67,126,1995,2462,1113,1349
9136,67,90,1995,0,0,0
9137,67,91,1995,0,0,0
9138,67,92,1995,0,0,0
9139,67,62,1995,13,3,10
9140,67,140,1995,35,22,13
9141,67,23,1995,146,86,60
9142,67,164,1995,1633,663,970
9143,67,63,1995,275,132,143
9144,67,127,1995,56,35,21
9145,67,165,1995,1493,583,910
9146,67,37,1995,106,64,42
9147,67,64,1995,23,10,13
9148,67,128,1995,1661,648,1013
9149,67,115,1995,2744,1541,1203
9150,67,65,1995,38946,18993,19953
9151,67,10,1995,238,128,110
9152,67,145,1995,175,74,101
9153,67,113,1995,274,193,81
9154,67,49,1995,2712,1374,1338
9155,67,74,1995,5128,2416,2712
9156,67,25,1995,1702,693,1009
9157,67,169,1995,6,2,4
9158,67,166,1995,1271,496,775
9159,67,93,1995,0,0,0
9160,67,146,1995,14184,5118,9066
9161,67,26,1995,163108,81060,82048
9162,67,170,1995,1,0,1
9163,67,130,1995,208,93,115
9164,67,38,1995,523,344,179
9165,67,27,1995,0,0,0
9166,67,50,1995,22892,10413,12479
9167,67,131,1995,228,111,117
9168,67,114,1995,337,155,182
9169,67,171,1995,8,4,4
9170,67,1,1995,3562,2111,1451
9171,67,28,1995,110,36,74
9172,67,132,1995,221,114,107
9173,67,133,1995,174,96,78
9174,95,172,1995,823,350,473
9175,95,97,1995,6661,3093,3568
9176,95,69,1995,47,17,30
9177,95,98,1995,14350,7172,7178
9178,95,85,1995,37,17,20
9179,95,99,1995,4100,1960,2140
9180,95,173,1995,49,24,25
9181,95,5,1995,256,114,142
9182,95,86,1995,424,171,253
9183,95,20,1995,37,10,27
9184,95,100,1995,2782,1254,1528
9185,95,162,1995,31,6,25
9186,95,50,1995,297,111,186
9187,151,136,1995,198,91,107
9188,151,137,1995,542,251,291
9189,151,68,1995,510,245,265
9190,151,156,1995,2902,1374,1528
9191,151,160,1995,366,173,193
9192,151,162,1995,21661,8599,13062
9193,151,166,1995,23369,15199,8170
9194,151,152,1995,4830,1960,2870
9195,4,3,1995,28,9,19
9196,4,10,1995,18,8,10
9197,4,172,1995,496,232,264
9198,4,39,1995,21,7,14
9199,4,68,1995,17,8,9
9200,4,69,1995,15,6,9
9201,4,5,1995,24485,4142,20343
9202,4,57,1995,7,2,5
9203,4,177,1995,69,25,44
9204,4,8,1995,392,134,258
9205,4,73,1995,11,3,8
9206,4,9,1995,12,0,12
9207,4,49,1995,13,5,8
9208,4,74,1995,13,3,10
9209,4,50,1995,19,11,8
9210,53,66,1995,292,159,133
9211,53,54,1995,27272,14015,13257
9212,53,68,1995,238,130,108
9213,53,69,1995,812,438,374
9214,53,32,1995,237,165,72
9215,53,57,1995,189,110,79
9216,53,59,1995,4701,2410,2291
9217,53,35,1995,524,427,97
9218,53,36,1995,228,179,49
9219,53,63,1995,21815,11209,10606
9220,53,37,1995,5736,2908,2828
9221,53,64,1995,3080,1894,1186
9222,53,60,1995,3126,1628,1498
9223,147,134,1995,889,433,456
9224,147,10,1995,480,228,252
9225,147,172,1995,1055,37,1018
9226,147,137,1995,849,410,439
9227,147,39,1995,98,46,52
9228,147,69,1995,320,143,177
9229,147,5,1995,2375,1077,1298
9230,147,44,1995,178,80,98
9231,147,57,1995,155,54,101
9232,147,121,1995,179,83,96
9233,147,149,1995,816,385,431
9234,147,122,1995,161,66,95
9235,147,123,1995,1150,464,686
9236,147,124,1995,471,187,284
9237,147,125,1995,297,130,167
9238,147,150,1995,462,217,245
9239,147,73,1995,181,73,108
9240,147,162,1995,187,85,102
9241,147,48,1995,111,48,63
9242,147,9,1995,175,76,99
9243,147,61,1995,132,50,82
9244,147,127,1995,67,19,48
9245,147,115,1995,9329,3239,6090
9246,147,133,1995,7917,3527,4390
9247,147,148,1995,174,66,108
9248,147,49,1995,124,48,76
9249,147,130,1995,411,184,227
9250,147,50,1995,2034,1112,922
9251,147,131,1995,743,348,395
9252,147,132,1995,3213,1458,1755
9253,105,2,1995,0,0,0
9254,105,141,1995,0,0,0
9255,105,52,1995,0,0,0
9256,105,134,1995,5612,2618,2994
9257,105,103,1995,27974,12583,15391
9258,105,66,1995,3988,2162,1826
9259,105,78,1995,0,0,0
9260,105,13,1995,0,0,0
9261,105,3,1995,0,0,0
9262,105,11,1995,0,0,0
9263,105,79,1995,0,0,0
9264,105,67,1995,1649,707,942
9265,105,53,1995,0,0,0
9266,105,95,1995,0,0,0
9267,105,30,1995,346,175,171
9268,105,116,1995,0,0,0
9269,105,29,1995,0,0,0
9270,105,135,1995,0,0,0
9271,105,153,1995,0,0,0
9272,105,106,1995,19708,8107,11601
9273,105,172,1995,9429,4314,5115
9274,105,107,1995,3196,1501,1695
9275,105,137,1995,0,0,0
9276,105,137,1995,0,0,0
9277,105,96,1995,314,126,188
9278,105,54,1995,0,0,0
9279,105,81,1995,894,410,484
9280,105,31,1995,1347,614,733
9281,105,151,1995,0,0,0
9282,105,39,1995,489,203,286
9283,105,82,1995,0,0,0
9284,105,83,1995,190,130,60
9285,105,108,1995,903,358,545
9286,105,97,1995,443,111,332
9287,105,138,1995,0,0,0
9288,105,120,1995,0,0,0
9289,105,40,1995,0,0,0
9290,105,42,1995,167,88,79
9291,105,68,1995,8249,3439,4810
9292,105,109,1995,683,312,371
9293,105,139,1995,0,0,0
9294,105,15,1995,0,0,0
9295,105,69,1995,22641,11013,11628
9296,105,156,1995,0,0,0
9297,105,56,1995,3133,1165,1968
9298,105,84,1995,0,0,0
9299,105,98,1995,106,40,66
9300,105,157,1995,0,0,0
9301,105,110,1995,1350,702,648
9302,105,85,1995,135,71,64
9303,105,99,1995,208,52,156
9304,105,32,1995,4074,2330,1744
9305,105,43,1995,0,0,0
9306,105,5,1995,730,297,433
9307,105,6,1995,0,0,0
9308,105,16,1995,0,0,0
9309,105,44,1995,165,46,119
9310,105,17,1995,1961,745,1216
9311,105,57,1995,62623,28456,34167
9312,105,86,1995,41,11,30
9313,105,177,1995,78935,37976,40959
9314,105,167,1995,0,0,0
9315,105,18,1995,0,0,0
9316,105,121,1995,0,0,0
9317,105,176,1995,0,0,0
9318,105,19,1995,0,0,0
9319,105,20,1995,17058,6665,10393
9320,105,46,1995,0,0,0
9321,105,159,1995,0,0,0
9322,105,143,1995,0,0,0
9323,105,70,1995,0,0,0
9324,105,47,1995,0,0,0
9325,105,71,1995,0,0,0
9326,105,122,1995,0,0,0
9327,105,123,1995,0,0,0
9328,105,7,1995,0,0,0
9329,105,160,1995,0,0,0
9330,105,58,1995,0,0,0
9331,105,100,1995,1027,433,594
9332,105,72,1995,0,0,0
9333,105,59,1995,0,0,0
9334,105,144,1995,0,0,0
9335,105,125,1995,1162,379,783
9336,105,21,1995,0,0,0
9337,105,150,1995,0,0,0
9338,105,8,1995,0,0,0
9339,105,73,1995,3522,1329,2193
9340,105,101,1995,415,149,266
9341,105,162,1995,0,0,0
9342,105,48,1995,187,41,146
9343,105,9,1995,150,47,103
9344,105,102,1995,767,321,446
9345,105,111,1995,25143,13330,11813
9346,105,112,1995,8278,3236,5042
9347,105,33,1995,10351,5585,4766
9348,105,61,1995,244319,115822,128497
9349,105,158,1995,0,0,0
9350,105,35,1995,5069,2637,2432
9351,105,36,1995,8882,5122,3760
9352,105,126,1995,0,0,0
9353,105,90,1995,0,0,0
9354,105,91,1995,0,0,0
9355,105,92,1995,0,0,0
9356,105,62,1995,0,0,0
9357,105,140,1995,0,0,0
9358,105,23,1995,0,0,0
9359,105,164,1995,0,0,0
9360,105,63,1995,0,0,0
9361,105,127,1995,0,0,0
9362,105,165,1995,0,0,0
9363,105,37,1995,0,0,0
9364,105,1,1995,0,0,0
9365,105,64,1995,0,0,0
9366,105,115,1995,0,0,0
9367,105,133,1995,0,0,0
9368,105,65,1995,51448,23551,27897
9369,105,113,1995,177,73,104
9370,105,49,1995,587,197,390
9371,105,74,1995,2919,1158,1761
9372,105,25,1995,3864,1803,2061
9373,105,169,1995,0,0,0
9374,105,166,1995,0,0,0
9375,105,93,1995,0,0,0
9376,105,27,1995,0,0,0
9377,105,146,1995,0,0,0
9378,105,26,1995,862,453,409
9379,105,170,1995,0,0,0
9380,105,130,1995,0,0,0
9381,105,38,1995,0,0,0
9382,105,60,1995,0,0,0
9383,105,142,1995,3796,1840,1956
9384,105,50,1995,3947,1641,2306
9385,105,131,1995,0,0,0
9386,105,152,1995,0,0,0
9387,105,114,1995,24081,11251,12830
9388,105,171,1995,0,0,0
9389,30,2,1995,223,70,153
9390,30,51,1995,316,151,165
9391,30,141,1995,105,45,60
9392,30,52,1995,0,0,0
9393,30,134,1995,4,1,3
9394,30,75,1995,16,6,10
9395,30,76,1995,2,0,2
9396,30,103,1995,30,17,13
9397,30,11,1995,1179,600,579
9398,30,77,1995,2,0,2
9399,30,66,1995,62,27,35
9400,30,12,1995,466,256,210
9401,30,78,1995,2,1,1
9402,30,13,1995,3,1,2
9403,30,3,1995,150,69,81
9404,30,79,1995,2,2,0
9405,30,29,1995,198,159,39
9406,30,67,1995,98,38,60
9407,30,95,1995,1,1,0
9408,30,151,1995,9,3,6
9409,30,4,1995,7,3,4
9410,30,53,1995,36,13,23
9411,30,147,1995,11,4,7
9412,30,105,1995,25,14,11
9413,30,152,1995,5,2,3
9414,30,116,1995,7,3,4
9415,30,153,1995,3,1,2
9416,30,135,1995,3,0,3
9417,30,80,1995,1,0,1
9418,30,136,1995,2,0,2
9419,30,106,1995,7,3,4
9420,30,172,1995,443,196,247
9421,30,107,1995,6,3,3
9422,30,137,1995,9,2,7
9423,30,96,1995,2,0,2
9424,30,54,1995,29,14,15
9425,30,81,1995,91,32,59
9426,30,14,1995,126,58,68
9427,30,31,1995,313,194,119
9428,30,176,1995,1,0,1
9429,30,137,1995,6,1,5
9430,30,39,1995,21,6,15
9431,30,118,1995,2,0,2
9432,30,82,1995,0,0,0
9433,30,83,1995,8,5,3
9434,30,108,1995,4,2,2
9435,30,142,1995,50,12,38
9436,30,97,1995,2,1,1
9437,30,119,1995,2,0,2
9438,30,40,1995,16,11,5
9439,30,148,1995,2,2,0
9440,30,120,1995,30,3,27
9441,30,42,1995,19,10,9
9442,30,68,1995,165,66,99
9443,30,139,1995,5,3,2
9444,30,155,1995,4,2,2
9445,30,15,1995,117,64,53
9446,30,69,1995,625,307,318
9447,30,156,1995,5,2,3
9448,30,55,1995,3,2,1
9449,30,56,1995,1945,870,1075
9450,30,98,1995,2,2,0
9451,30,157,1995,5,1,4
9452,30,158,1995,2,1,1
9453,30,110,1995,2,0,2
9454,30,85,1995,2,0,2
9455,30,99,1995,1,0,1
9456,30,32,1995,122,73,49
9457,30,43,1995,34,15,19
9458,30,5,1995,149,30,119
9459,30,6,1995,127,22,105
9460,30,16,1995,265,70,195
9461,30,44,1995,5,3,2
9462,30,45,1995,0,0,0
9463,30,17,1995,114,41,73
9464,30,57,1995,312,105,207
9465,30,86,1995,2,2,0
9466,30,177,1995,44,22,22
9467,30,18,1995,94,12,82
9468,30,167,1995,271,191,80
9469,30,121,1995,4,2,2
9470,30,19,1995,28,7,21
9471,30,168,1995,26,16,10
9472,30,46,1995,34,27,7
9473,30,20,1995,323,73,250
9474,30,159,1995,2,1,1
9475,30,143,1995,67,29,38
9476,30,70,1995,2,0,2
9477,30,47,1995,30,26,4
9478,30,71,1995,3,2,1
9479,30,122,1995,1,0,1
9480,30,123,1995,0,0,0
9481,30,7,1995,1,0,1
9482,30,160,1995,0,0,0
9483,30,58,1995,9,5,4
9484,30,161,1995,2,0,2
9485,30,124,1995,0,0,0
9486,30,100,1995,7,4,3
9487,30,72,1995,2,1,1
9488,30,59,1995,11,5,6
9489,30,144,1995,30,10,20
9490,30,125,1995,10,4,6
9491,30,150,1995,2,0,2
9492,30,8,1995,2,0,2
9493,30,73,1995,72,25,47
9494,30,101,1995,17,2,15
9495,30,162,1995,38,5,33
9496,30,60,1995,1247,568,679
9497,30,48,1995,24,10,14
9498,30,21,1995,1,0,1
9499,30,9,1995,25,2,23
9500,30,102,1995,4,1,3
9501,30,111,1995,1,0,1
9502,30,112,1995,10,3,7
9503,30,33,1995,558,390,168
9504,30,61,1995,24,10,14
9505,30,22,1995,3,1,2
9506,30,35,1995,1393,841,552
9507,30,36,1995,8936,6940,1996
9508,30,126,1995,1,0,1
9509,30,62,1995,2,2,0
9510,30,23,1995,8,3,5
9511,30,164,1995,3,2,1
9512,30,63,1995,895,478,417
9513,30,127,1995,0,0,0
9514,30,165,1995,0,0,0
9515,30,37,1995,107,83,24
9516,30,64,1995,14,7,7
9517,30,128,1995,2,0,2
9518,30,115,1995,35,20,15
9519,30,65,1995,346,161,185
9520,30,10,1995,4,1,3
9521,30,145,1995,17,2,15
9522,30,113,1995,0,0,0
9523,30,49,1995,37,15,22
9524,30,74,1995,46,21,25
9525,30,25,1995,606,110,496
9526,30,169,1995,29,17,12
9527,30,166,1995,0,0,0
9528,30,93,1995,0,0,0
9529,30,146,1995,30,6,24
9530,30,26,1995,1377,434,943
9531,30,170,1995,61,42,19
9532,30,94,1995,2,0,2
9533,30,130,1995,2,0,2
9534,30,38,1995,2451,1859,592
9535,30,27,1995,14,6,8
9536,30,50,1995,692,299,393
9537,30,131,1995,8,0,8
9538,30,114,1995,5,3,2
9539,30,171,1995,163,108,55
9540,30,1,1995,381,118,263
9541,30,28,1995,30,7,23
9542,30,132,1995,5,2,3
9543,30,133,1995,9,3,6
9544,152,151,1995,2554,1276,1278
9545,152,156,1995,30522,19874,10648
9546,152,160,1995,75987,41822,34165
9547,152,162,1995,3161,1695,1466
9548,152,164,1995,2466,1125,1341
9549,152,166,1995,7625,5373,2252
9550,116,67,1995,621,318,303
9551,116,137,1995,41447,21295,20152
9552,116,68,1995,310,159,151
9553,116,121,1995,216,94,122
9554,116,126,1995,160197,82134,78063
9555,116,130,1995,1546,793,753
9556,116,131,1995,9780,5017,4763
9557,153,134,1995,1899,930,969
9558,153,103,1995,8,6,2
9559,153,67,1995,19,9,10
9560,153,105,1995,104,51,53
9561,153,172,1995,41,21,20
9562,153,81,1995,92,46,46
9563,153,68,1995,137,68,69
9564,153,139,1995,14,6,8
9565,153,155,1995,10,6,4
9566,153,69,1995,33,15,18
9567,153,156,1995,74,38,36
9568,153,157,1995,80,39,41
9569,153,57,1995,253,109,144
9570,153,177,1995,3,3,0
9571,153,71,1995,8,6,2
9572,153,160,1995,12,6,6
9573,153,100,1995,5,2,3
9574,153,125,1995,64,35,29
9575,153,73,1995,72,33,39
9576,153,162,1995,114,57,57
9577,153,112,1995,4,2,2
9578,153,61,1995,1031,505,526
9579,153,158,1995,839,346,493
9580,153,36,1995,74,37,37
9581,153,140,1995,3111,1620,1491
9582,153,164,1995,384,168,216
9583,153,165,1995,26,15,11
9584,153,65,1995,40,20,20
9585,153,74,1995,24,11,13
9586,153,38,1995,37,18,19
9587,153,50,1995,22,10,12
9588,135,134,1995,0,0,0
9589,135,136,1995,88874,45134,43740
9590,135,137,1995,0,0,0
9591,135,137,1995,0,0,0
9592,135,151,1995,0,0,0
9593,135,138,1995,0,0,0
9594,135,68,1995,10986,5067,5919
9595,135,139,1995,0,0,0
9596,135,69,1995,0,0,0
9597,135,56,1995,0,0,0
9598,135,157,1995,0,0,0
9599,135,57,1995,0,0,0
9600,135,159,1995,0,0,0
9601,135,160,1995,0,0,0
9602,135,73,1995,0,0,0
9603,135,162,1995,97818,41552,56266
9604,135,164,1995,0,0,0
9605,135,50,1995,0,0,0
9606,80,103,1995,7,4,3
9607,80,66,1995,30,6,24
9608,80,78,1995,110,53,57
9609,80,79,1995,121,33,88
9610,80,67,1995,7,3,4
9611,80,105,1995,42,22,20
9612,80,95,1995,208,96,112
9613,80,107,1995,136,50,86
9614,80,96,1995,165,47,118
9615,80,81,1995,437,198,239
9616,80,39,1995,11,4,7
9617,80,83,1995,39,8,31
9618,80,42,1995,6,3,3
9619,80,68,1995,22,8,14
9620,80,69,1995,81,26,55
9621,80,84,1995,9,4,5
9622,80,110,1995,114,58,56
9623,80,85,1995,11,4,7
9624,80,99,1995,678,353,325
9625,80,5,1995,84,39,45
9626,80,6,1995,6,1,5
9627,80,44,1995,150,72,78
9628,80,17,1995,7,6,1
9629,80,57,1995,54,7,47
9630,80,86,1995,4987,2810,2177
9631,80,177,1995,13,3,10
9632,80,121,1995,21,15,6
9633,80,100,1995,24,13,11
9634,80,73,1995,22,3,19
9635,80,101,1995,448,251,197
9636,80,162,1995,6,0,6
9637,80,9,1995,66,23,43
9638,80,102,1995,81,38,43
9639,80,112,1995,8,6,2
9640,80,88,1995,28,15,13
9641,80,91,1995,6,3,3
9642,80,92,1995,18,4,14
9643,80,115,1995,22,11,11
9644,80,133,1995,11,3,8
9645,80,65,1995,16,9,7
9646,80,74,1995,47,11,36
9647,80,93,1995,211,99,112
9648,80,50,1995,1411,633,778
9649,80,131,1995,8,8,0
9650,80,132,1995,6,1,5
9651,136,135,1995,33673,15517,18156
9652,136,137,1995,777,358,419
9653,136,137,1995,200,92,108
9654,136,68,1995,963,444,519
9655,136,139,1995,318,146,172
9656,136,143,1995,1191,549,642
9657,136,162,1995,16104,7421,8683
9658,136,145,1995,19071,8793,10278
9659,106,103,1995,39251,19600,19651
9660,106,105,1995,5611,2952,2659
9661,106,172,1995,1691,764,927
9662,106,107,1995,2734,1503,1231
9663,106,81,1995,1751,832,919
9664,106,83,1995,197,106,91
9665,106,108,1995,5512,3045,2467
9666,106,68,1995,2625,1268,1357
9667,106,69,1995,5371,2715,2656
9668,106,85,1995,40,17,23
9669,106,57,1995,4062,1838,2224
9670,106,100,1995,1223,609,614
9671,106,111,1995,919,478,441
9672,106,112,1995,21265,12883,8382
9673,106,65,1995,9183,4412,4771
9674,106,114,1995,1816,869,947
9675,172,3,1995,857,529,328
9676,172,105,1995,11819,5423,6396
9677,172,10,1995,1251,870,381
9678,172,173,1995,1011,389,622
9679,172,5,1995,1975,851,1124
9680,172,177,1995,1706,699,1007
9681,172,174,1995,4494,1928,2566
9682,172,9,1995,899,382,517
9683,172,112,1995,2147,985,1162
9684,172,36,1995,580,258,322
9685,172,1,1995,289747,143422,146325
9686,172,50,1995,2036,783,1253
9687,107,103,1995,2471,1112,1359
9688,107,105,1995,1809,1023,786
9689,107,106,1995,1810,918,892
9690,107,172,1995,1392,602,790
9691,107,96,1995,757,400,357
9692,107,81,1995,1375,558,817
9693,107,83,1995,350,183,167
9694,107,108,1995,11917,5701,6216
9695,107,97,1995,306,146,160
9696,107,68,1995,1851,855,996
9697,107,69,1995,2455,1096,1359
9698,107,98,1995,305,174,131
9699,107,99,1995,276,142,134
9700,107,57,1995,2565,928,1637
9701,107,177,1995,546,228,318
9702,107,100,1995,2072,1025,1047
9703,107,73,1995,383,163,220
9704,107,102,1995,1966,1054,912
9705,107,112,1995,3342,1453,1889
9706,107,36,1995,518,299,219
9707,107,65,1995,5620,2552,3068
9708,107,74,1995,634,238,396
9709,107,50,1995,1009,458,551
9710,107,114,1995,362,152,210
9711,117,68,1995,538,232,306
9712,117,121,1995,86,47,39
9713,117,122,1995,10701,5772,4929
9714,117,131,1995,162,84,78
9715,137,134,1995,18270,9616,8654
9716,137,135,1995,4003,1728,2275
9717,137,136,1995,3743,1375,2368
9718,137,172,1995,327,28,299
9719,137,137,1995,110720,58067,52653
9720,137,81,1995,190,139,51
9721,137,151,1995,5250,2729,2521
9722,137,138,1995,560,272,288
9723,137,68,1995,6041,2920,3121
9724,137,139,1995,1121,611,510
9725,137,69,1995,205,118,87
9726,137,20,1995,414,167,247
9727,137,160,1995,9493,3673,5820
9728,137,161,1995,1115,274,841
9729,137,61,1995,511,230,281
9730,137,36,1995,913,588,325
9731,137,126,1995,5503,2613,2890
9732,137,164,1995,4436,1136,3300
9733,137,166,1995,863,495,368
9734,137,134,1995,276402,139247,137155
9735,137,116,1995,128458,64715,63743
9736,137,137,1995,5912,2958,2954
9737,137,126,1995,1132791,570688,562103
9738,137,129,1995,137306,69171,68135
9739,137,145,1995,15271,7718,7553
9740,137,130,1995,19780,10000,9780
9741,96,2,1995,11,6,5
9742,96,51,1995,2,0,2
9743,96,141,1995,21,12,9
9744,96,134,1995,2,2,0
9745,96,12,1995,2,1,1
9746,96,103,1995,864,433,431
9747,96,66,1995,71,21,50
9748,96,78,1995,8,2,6
9749,96,13,1995,1,0,1
9750,96,3,1995,6,5,1
9751,96,11,1995,4,2,2
9752,96,79,1995,6,2,4
9753,96,67,1995,169,69,100
9754,96,4,1995,2,1,1
9755,96,105,1995,304,154,150
9756,96,95,1995,123,57,66
9757,96,30,1995,37,20,17
9758,96,29,1995,4,2,2
9759,96,135,1995,6,4,2
9760,96,80,1995,6,1,5
9761,96,10,1995,1,0,1
9762,96,106,1995,1127,541,586
9763,96,172,1995,190,69,121
9764,96,107,1995,4147,2066,2081
9765,96,137,1995,5,2,3
9766,96,137,1995,2,2,0
9767,96,54,1995,16,7,9
9768,96,81,1995,3558,1658,1900
9769,96,14,1995,2,0,2
9770,96,151,1995,1,1,0
9771,96,39,1995,39,15,24
9772,96,82,1995,3,3,0
9773,96,83,1995,556,354,202
9774,96,108,1995,683,301,382
9775,96,97,1995,26046,13085,12961
9776,96,120,1995,1,0,1
9777,96,40,1995,2,2,0
9778,96,42,1995,14,8,6
9779,96,68,1995,482,208,274
9780,96,109,1995,6,3,3
9781,96,139,1995,1,1,0
9782,96,15,1995,8,4,4
9783,96,69,1995,1077,440,637
9784,96,156,1995,1,0,1
9785,96,55,1995,2,2,0
9786,96,56,1995,22,7,15
9787,96,84,1995,5,2,3
9788,96,98,1995,1602,760,842
9789,96,110,1995,16,7,9
9790,96,85,1995,41,15,26
9791,96,99,1995,2241,1236,1005
9792,96,173,1995,1604,730,874
9793,96,32,1995,49,22,27
9794,96,43,1995,1,1,0
9795,96,5,1995,31,12,19
9796,96,6,1995,63,13,50
9797,96,16,1995,8,3,5
9798,96,44,1995,19,8,11
9799,96,17,1995,101,35,66
9800,96,57,1995,1214,459,755
9801,96,86,1995,209,110,99
9802,96,177,1995,169,70,99
9803,96,167,1995,4,4,0
9804,96,18,1995,6,2,4
9805,96,121,1995,4,0,4
9806,96,176,1995,20,9,11
9807,96,20,1995,62,21,41
9808,96,46,1995,1,1,0
9809,96,143,1995,8,4,4
9810,96,70,1995,2,1,1
9811,96,47,1995,6,2,4
9812,96,71,1995,8,6,2
9813,96,174,1995,1,0,1
9814,96,122,1995,2,2,0
9815,96,7,1995,1,1,0
9816,96,100,1995,1778,936,842
9817,96,72,1995,1,0,1
9818,96,87,1995,2,2,0
9819,96,144,1995,8,4,4
9820,96,125,1995,2,2,0
9821,96,21,1995,2,0,2
9822,96,8,1995,5,1,4
9823,96,73,1995,332,129,203
9824,96,77,1995,22,7,15
9825,96,101,1995,131695,64634,67061
9826,96,162,1995,2,1,1
9827,96,48,1995,40,15,25
9828,96,9,1995,5,0,5
9829,96,102,1995,7652,3567,4085
9830,96,111,1995,48,32,16
9831,96,112,1995,2045,953,1092
9832,96,33,1995,224,118,106
9833,96,61,1995,46,18,28
9834,96,88,1995,216,88,128
9835,96,22,1995,2,1,1
9836,96,35,1995,55,30,25
9837,96,36,1995,390,249,141
9838,96,126,1995,1,1,0
9839,96,90,1995,1,1,0
9840,96,91,1995,1,1,0
9841,96,92,1995,1,0,1
9842,96,23,1995,6,2,4
9843,96,164,1995,1,1,0
9844,96,37,1995,15,5,10
9845,96,1,1995,1,0,1
9846,96,128,1995,1,1,0
9847,96,115,1995,37,20,17
9848,96,133,1995,1,1,0
9849,96,65,1995,1392,594,798
9850,96,145,1995,1,0,1
9851,96,113,1995,11,5,6
9852,96,148,1995,1,0,1
9853,96,49,1995,80,33,47
9854,96,74,1995,360,153,207
9855,96,25,1995,7,1,6
9856,96,93,1995,21,13,8
9857,96,146,1995,2,2,0
9858,96,26,1995,5,2,3
9859,96,130,1995,6,2,4
9860,96,38,1995,102,64,38
9861,96,60,1995,18,7,11
9862,96,142,1995,11,3,8
9863,96,50,1995,339,136,203
9864,96,131,1995,2,2,0
9865,96,114,1995,196,90,106
9866,96,171,1995,1,1,0
9867,54,51,1995,83,42,41
9868,54,141,1995,0,0,0
9869,54,103,1995,166,107,59
9870,54,66,1995,1440,861,579
9871,54,29,1995,0,0,0
9872,54,67,1995,205,116,89
9873,54,53,1995,506365,265425,240940
9874,54,105,1995,119,81,38
9875,54,30,1995,138,87,51
9876,54,106,1995,110,72,38
9877,54,172,1995,0,0,0
9878,54,107,1995,0,0,0
9879,54,31,1995,428,336,92
9880,54,39,1995,38,23,15
9881,54,142,1995,0,0,0
9882,54,40,1995,3,2,1
9883,54,42,1995,13,9,4
9884,54,68,1995,651,390,261
9885,54,69,1995,6825,4025,2800
9886,54,56,1995,68,35,33
9887,54,32,1995,1393,995,398
9888,54,5,1995,0,0,0
9889,54,6,1995,0,0,0
9890,54,16,1995,0,0,0
9891,54,44,1995,5,3,2
9892,54,17,1995,0,0,0
9893,54,57,1995,1941,1110,831
9894,54,177,1995,0,0,0
9895,54,18,1995,0,0,0
9896,54,167,1995,0,0,0
9897,54,46,1995,11,9,2
9898,54,20,1995,0,0,0
9899,54,143,1995,0,0,0
9900,54,47,1995,9,7,2
9901,54,71,1995,7,5,2
9902,54,100,1995,8,5,3
9903,54,59,1995,0,0,0
9904,54,144,1995,0,0,0
9905,54,73,1995,250,159,91
9906,54,162,1995,0,0,0
9907,54,60,1995,11990,5743,6247
9908,54,48,1995,16,10,6
9909,54,112,1995,50,35,15
9910,54,33,1995,660,549,111
9911,54,61,1995,13,9,4
9912,54,35,1995,166,113,53
9913,54,36,1995,0,0,0
9914,54,63,1995,0,0,0
9915,54,37,1995,279,221,58
9916,54,64,1995,26764,17465,9299
9917,54,115,1995,0,0,0
9918,54,65,1995,31,22,9
9919,54,145,1995,0,0,0
9920,54,49,1995,276,174,102
9921,54,74,1995,622,345,277
9922,54,25,1995,0,0,0
9923,54,26,1995,0,0,0
9924,54,38,1995,0,0,0
9925,54,50,1995,186,116,70
9926,54,132,1995,0,0,0
9927,81,51,1995,184,86,98
9928,81,141,1995,78,38,40
9929,81,134,1995,165,68,97
9930,81,103,1995,283,143,140
9931,81,30,1995,225,137,88
9932,81,106,1995,298,142,156
9933,81,172,1995,499,119,380
9934,81,107,1995,268,140,128
9935,81,31,1995,308,181,127
9936,81,83,1995,203,118,85
9937,81,108,1995,102,54,48
9938,81,68,1995,249,126,123
9939,81,69,1995,570,288,282
9940,81,84,1995,137,67,70
9941,81,98,1995,116,62,54
9942,81,85,1995,1564,462,1102
9943,81,32,1995,118,71,47
9944,81,57,1995,373,105,268
9945,81,86,1995,497,264,233
9946,81,20,1995,94,43,51
9947,81,100,1995,674,351,323
9948,81,101,1995,451,291,160
9949,81,102,1995,140,96,44
9950,81,112,1995,145,86,59
9951,81,33,1995,160,107,53
9952,81,88,1995,206,115,91
9953,81,35,1995,116,83,33
9954,81,36,1995,3404,2181,1223
9955,81,65,1995,8112,4190,3922
9956,81,38,1995,1036,716,320
9957,81,50,1995,84,35,49
9958,14,2,1995,3,0,3
9959,14,51,1995,98,41,57
9960,14,141,1995,13,6,7
9961,14,103,1995,30,13,17
9962,14,11,1995,413,196,217
9963,14,66,1995,125,72,53
9964,14,12,1995,13,8,5
9965,14,13,1995,38,18,20
9966,14,3,1995,229,5,224
9967,14,29,1995,119,93,26
9968,14,67,1995,92,49,43
9969,14,151,1995,3,0,3
9970,14,53,1995,24,13,11
9971,14,147,1995,3,2,1
9972,14,105,1995,21,13,8
9973,14,30,1995,2165,1515,650
9974,14,116,1995,2,0,2
9975,14,135,1995,20,9,11
9976,14,106,1995,17,11,6
9977,14,172,1995,563,286,277
9978,14,107,1995,44,33,11
9979,14,96,1995,2,2,0
9980,14,54,1995,30,18,12
9981,14,81,1995,13,6,7
9982,14,31,1995,238,156,82
9983,14,176,1995,12,8,4
9984,14,137,1995,241,131,110
9985,14,39,1995,60,34,26
9986,14,118,1995,2,2,0
9987,14,83,1995,4,3,1
9988,14,108,1995,3,2,1
9989,14,142,1995,1824,759,1065
9990,14,97,1995,4,2,2
9991,14,119,1995,2,2,0
9992,14,40,1995,10,8,2
9993,14,120,1995,29,18,11
9994,14,42,1995,174,130,44
9995,14,68,1995,323,193,130
9996,14,15,1995,5376,2530,2846
9997,14,69,1995,914,518,396
9998,14,156,1995,30,15,15
9999,14,55,1995,2,0,2
10000,14,56,1995,8340,3658,4682
10001,14,85,1995,2,2,0
10002,14,99,1995,2,0,2
10003,14,32,1995,122,74,48
10004,14,43,1995,12,9,3
10005,14,5,1995,967,397,570
10006,14,6,1995,423,162,261
10007,14,16,1995,111,36,75
10008,14,44,1995,273,181,92
10009,14,17,1995,135,61,74
10010,14,57,1995,170,87,83
10011,14,86,1995,6,3,3
10012,14,177,1995,30,18,12
10013,14,18,1995,156,58,98
10014,14,167,1995,84,52,32
10015,14,121,1995,30,15,15
10016,14,19,1995,82,36,46
10017,14,168,1995,9,5,4
10018,14,46,1995,58,41,17
10019,14,20,1995,969,439,530
10020,14,143,1995,81,34,47
10021,14,47,1995,33,27,6
10022,14,71,1995,4,3,1
10023,14,122,1995,3,2,1
10024,14,123,1995,3,2,1
10025,14,58,1995,12,5,7
10026,14,124,1995,4,2,2
10027,14,100,1995,23,15,8
10028,14,144,1995,23,11,12
10029,14,125,1995,4,3,1
10030,14,150,1995,2,0,2
10031,14,8,1995,20,3,17
10032,14,73,1995,170,100,70
10033,14,101,1995,4,2,2
10034,14,162,1995,108,47,61
10035,14,60,1995,7,5,2
10036,14,48,1995,71,46,25
10037,14,21,1995,23,9,14
10038,14,9,1995,183,13,170
10039,14,102,1995,7,2,5
10040,14,111,1995,3,3,0
10041,14,112,1995,12,8,4
10042,14,33,1995,249,187,62
10043,14,61,1995,23,16,7
10044,14,88,1995,2,0,2
10045,14,22,1995,4,2,2
10046,14,35,1995,1902,1356,546
10047,14,36,1995,4574,2689,1885
10048,14,23,1995,82,38,44
10049,14,164,1995,3,2,1
10050,14,63,1995,891,481,410
10051,14,127,1995,3,2,1
10052,14,165,1995,2,0,2
10053,14,37,1995,48,30,18
10054,14,64,1995,6,3,3
10055,14,128,1995,4,2,2
10056,14,115,1995,1747,956,791
10057,14,65,1995,55,40,15
10058,14,10,1995,3474,2794,680
10059,14,145,1995,183,93,90
10060,14,113,1995,2,2,0
10061,14,49,1995,321,211,110
10062,14,74,1995,133,86,47
10063,14,25,1995,1146,277,869
10064,14,169,1995,3,2,1
10065,14,93,1995,6,5,1
10066,14,146,1995,13,5,8
10067,14,26,1995,215,114,101
10068,14,170,1995,4,3,1
10069,14,130,1995,7,2,5
10070,14,38,1995,1153,777,376
10071,14,27,1995,54,22,32
10072,14,50,1995,12804,6905,5899
10073,14,131,1995,51,27,24
10074,14,114,1995,2,2,0
10075,14,171,1995,26,15,11
10076,14,1,1995,23,19,4
10077,14,28,1995,6,3,3
10078,14,132,1995,48,31,17
10079,14,133,1995,108,63,45
10080,31,2,1995,77,20,57
10081,31,51,1995,66,24,42
10082,31,141,1995,121,16,105
10083,31,52,1995,6,3,3
10084,31,134,1995,50,6,44
10085,31,76,1995,2,0,2
10086,31,103,1995,114,57,57
10087,31,11,1995,340,132,208
10088,31,77,1995,0,0,0
10089,31,66,1995,2717,1448,1269
10090,31,12,1995,68,30,38
10091,31,78,1995,0,0,0
10092,31,13,1995,9,1,8
10093,31,3,1995,12,2,10
10094,31,79,1995,5,4,1
10095,31,29,1995,483,268,215
10096,31,67,1995,279,118,161
10097,31,95,1995,1,1,0
10098,31,151,1995,10,1,9
10099,31,4,1995,0,0,0
10100,31,53,1995,533,197,336
10101,31,147,1995,1,0,1
10102,31,105,1995,42,16,26
10103,31,30,1995,1731,600,1131
10104,31,152,1995,2,1,1
10105,31,116,1995,0,0,0
10106,31,153,1995,5,2,3
10107,31,135,1995,2,1,1
10108,31,80,1995,0,0,0
10109,31,136,1995,3,0,3
10110,31,106,1995,11,4,7
10111,31,172,1995,454,176,278
10112,31,173,1995,9,6,3
10113,31,107,1995,27,11,16
10114,31,117,1995,1,0,1
10115,31,137,1995,24,4,20
10116,31,96,1995,4,1,3
10117,31,54,1995,626,248,378
10118,31,81,1995,185,37,148
10119,31,14,1995,20,4,16
10120,31,176,1995,32,24,8
10121,31,137,1995,12,2,10
10122,31,39,1995,48,18,30
10123,31,118,1995,2,1,1
10124,31,82,1995,0,0,0
10125,31,83,1995,2,1,1
10126,31,108,1995,15,5,10
10127,31,142,1995,58,13,45
10128,31,97,1995,5,2,3
10129,31,138,1995,1,1,0
10130,31,119,1995,1,0,1
10131,31,40,1995,23,13,10
10132,31,148,1995,1,1,0
10133,31,120,1995,29,5,24
10134,31,42,1995,123,60,63
10135,31,68,1995,1336,639,697
10136,31,139,1995,0,0,0
10137,31,155,1995,3,2,1
10138,31,15,1995,132,55,77
10139,31,69,1995,3563,1730,1833
10140,31,156,1995,16,4,12
10141,31,55,1995,0,0,0
10142,31,56,1995,667,284,383
10143,31,84,1995,0,0,0
10144,31,98,1995,3,1,2
10145,31,157,1995,9,1,8
10146,31,158,1995,3,0,3
10147,31,110,1995,1,0,1
10148,31,85,1995,8,4,4
10149,31,99,1995,1,1,0
10150,31,32,1995,2290,1101,1189
10151,31,43,1995,7,3,4
10152,31,5,1995,90,27,63
10153,31,6,1995,70,20,50
10154,31,16,1995,98,19,79
10155,31,44,1995,25,8,17
10156,31,17,1995,52,16,36
10157,31,57,1995,382,116,266
10158,31,86,1995,2,1,1
10159,31,177,1995,72,33,39
10160,31,18,1995,38,5,33
10161,31,167,1995,682,341,341
10162,31,121,1995,16,6,10
10163,31,19,1995,21,7,14
10164,31,168,1995,56,27,29
10165,31,46,1995,49,29,20
10166,31,20,1995,76,13,63
10167,31,149,1995,2,0,2
10168,31,159,1995,3,2,1
10169,31,143,1995,37,10,27
10170,31,70,1995,0,0,0
10171,31,47,1995,61,34,27
10172,31,71,1995,6,2,4
10173,31,122,1995,9,3,6
10174,31,123,1995,7,4,3
10175,31,7,1995,0,0,0
10176,31,160,1995,6,1,5
10177,31,58,1995,3,1,2
10178,31,161,1995,1,0,1
10179,31,124,1995,1,0,1
10180,31,100,1995,29,13,16
10181,31,72,1995,1,0,1
10182,31,59,1995,43,13,30
10183,31,144,1995,39,6,33
10184,31,125,1995,1,0,1
10185,31,150,1995,3,1,2
10186,31,8,1995,6,2,4
10187,31,73,1995,203,69,134
10188,31,101,1995,6,1,5
10189,31,162,1995,25,4,21
10190,31,60,1995,197,39,158
10191,31,48,1995,36,16,20
10192,31,21,1995,0,0,0
10193,31,9,1995,34,6,28
10194,31,102,1995,4,1,3
10195,31,111,1995,12,5,7
10196,31,112,1995,25,5,20
10197,31,33,1995,9124,5568,3556
10198,31,61,1995,15,6,9
10199,31,22,1995,10,6,4
10200,31,35,1995,4417,2142,2275
10201,31,36,1995,4924,2693,2231
10202,31,126,1995,5,1,4
10203,31,90,1995,2,0,2
10204,31,91,1995,1,0,1
10205,31,92,1995,0,0,0
10206,31,62,1995,1,1,0
10207,31,140,1995,0,0,0
10208,31,23,1995,6,1,5
10209,31,164,1995,12,2,10
10210,31,63,1995,1772,712,1060
10211,31,127,1995,1,0,1
10212,31,165,1995,1,1,0
10213,31,37,1995,105379,48717,56662
10214,31,64,1995,96,44,52
10215,31,128,1995,2,1,1
10216,31,115,1995,57,26,31
10217,31,65,1995,63,25,38
10218,31,10,1995,12,3,9
10219,31,145,1995,25,6,19
10220,31,113,1995,1,0,1
10221,31,49,1995,78,26,52
10222,31,74,1995,142,57,85
10223,31,25,1995,162,20,142
10224,31,169,1995,24,14,10
10225,31,166,1995,6,2,4
10226,31,93,1995,1,0,1
10227,31,146,1995,58,9,49
10228,31,26,1995,82,21,61
10229,31,170,1995,18,10,8
10230,31,130,1995,6,3,3
10231,31,38,1995,12298,6183,6115
10232,31,27,1995,12,2,10
10233,31,50,1995,526,160,366
10234,31,131,1995,7,2,5
10235,31,114,1995,13,4,9
10236,31,171,1995,66,34,32
10237,31,1,1995,5386,1702,3684
10238,31,28,1995,41,6,35
10239,31,132,1995,7,1,6
10240,31,133,1995,8,3,5
10241,39,2,1995,1648,745,903
10242,39,51,1995,45,26,19
10243,39,141,1995,717,211,506
10244,39,52,1995,1,0,1
10245,39,134,1995,77,36,41
10246,39,76,1995,0,0,0
10247,39,103,1995,899,464,435
10248,39,11,1995,430,201,229
10249,39,77,1995,3,1,2
10250,39,66,1995,1400,738,662
10251,39,12,1995,90,61,29
10252,39,78,1995,7,6,1
10253,39,13,1995,81,40,41
10254,39,3,1995,320,196,124
10255,39,79,1995,21,8,13
10256,39,29,1995,135,99,36
10257,39,67,1995,980,502,478
10258,39,95,1995,5,3,2
10259,39,151,1995,24,8,16
10260,39,4,1995,8,1,7
10261,39,53,1995,17628,8655,8973
10262,39,147,1995,48,27,21
10263,39,105,1995,1154,749,405
10264,39,30,1995,445,256,189
10265,39,152,1995,12,4,8
10266,39,116,1995,132,73,59
10267,39,153,1995,12,5,7
10268,39,135,1995,84,32,52
10269,39,136,1995,2,0,2
10270,39,106,1995,1198,598,600
10271,39,172,1995,2441,1371,1070
10272,39,173,1995,492,246,246
10273,39,174,1995,3,2,1
10274,39,107,1995,1424,660,764
10275,39,117,1995,17,5,12
10276,39,137,1995,58,29,29
10277,39,96,1995,68,22,46
10278,39,54,1995,542,259,283
10279,39,81,1995,102,56,46
10280,39,14,1995,131,77,54
10281,39,31,1995,203,130,73
10282,39,176,1995,211,124,87
10283,39,137,1995,120,49,71
10284,39,118,1995,15,8,7
10285,39,82,1995,7,3,4
10286,39,83,1995,56,38,18
10287,39,108,1995,269,147,122
10288,39,142,1995,1076,356,720
10289,39,97,1995,38,22,16
10290,39,138,1995,0,0,0
10291,39,119,1995,79,44,35
10292,39,40,1995,234,161,73
10293,39,148,1995,39,16,23
10294,39,120,1995,820,349,471
10295,39,41,1995,8533,5133,3400
10296,39,42,1995,3503,2309,1194
10297,39,68,1995,3345,1542,1803
10298,39,109,1995,3,1,2
10299,39,139,1995,5,2,3
10300,39,155,1995,360,129,231
10301,39,15,1995,78,40,38
10302,39,69,1995,25297,13857,11440
10303,39,156,1995,678,249,429
10304,39,56,1995,916,260,656
10305,39,84,1995,5,3,2
10306,39,98,1995,78,41,37
10307,39,157,1995,38,16,22
10308,39,158,1995,20,3,17
10309,39,110,1995,86,61,25
10310,39,85,1995,90,36,54
10311,39,99,1995,52,34,18
10312,39,32,1995,1426,658,768
10313,39,43,1995,4471,2333,2138
10314,39,5,1995,3498,1997,1501
10315,39,6,1995,9753,3531,6222
10316,39,16,1995,7703,3057,4646
10317,39,44,1995,1024,416,608
10318,39,17,1995,1251,433,818
10319,39,57,1995,2768,826,1942
10320,39,86,1995,103,53,50
10321,39,177,1995,1129,728,401
10322,39,18,1995,773,301,472
10323,39,167,1995,41,31,10
10324,39,121,1995,803,431,372
10325,39,19,1995,529,229,300
10326,39,168,1995,2,1,1
10327,39,46,1995,341,208,133
10328,39,20,1995,10077,4373,5704
10329,39,149,1995,36,24,12
10330,39,159,1995,78,39,39
10331,39,143,1995,121,44,77
10332,39,70,1995,11,6,5
10333,39,47,1995,479,296,183
10334,39,71,1995,145,69,76
10335,39,122,1995,18,7,11
10336,39,123,1995,43,24,19
10337,39,7,1995,3,2,1
10338,39,160,1995,16,6,10
10339,39,58,1995,53,23,30
10340,39,161,1995,15,7,8
10341,39,124,1995,97,49,48
10342,39,100,1995,350,202,148
10343,39,72,1995,6,2,4
10344,39,59,1995,1933,918,1015
10345,39,144,1995,3943,1669,2274
10346,39,125,1995,94,51,43
10347,39,150,1995,24,16,8
10348,39,8,1995,78,34,44
10349,39,73,1995,3612,1579,2033
10350,39,101,1995,79,43,36
10351,39,162,1995,389,157,232
10352,39,60,1995,1237,606,631
10353,39,48,1995,14633,9023,5610
10354,39,21,1995,7,5,2
10355,39,9,1995,8498,3806,4692
10356,39,102,1995,31,13,18
10357,39,111,1995,41,22,19
10358,39,112,1995,396,233,163
10359,39,33,1995,9520,6107,3413
10360,39,61,1995,561,266,295
10361,39,88,1995,3,2,1
10362,39,22,1995,18,12,6
10363,39,35,1995,1435,812,623
10364,39,36,1995,2544,1677,867
10365,39,126,1995,70,36,34
10366,39,90,1995,0,0,0
10367,39,91,1995,2,1,1
10368,39,92,1995,8,1,7
10369,39,62,1995,1,1,0
10370,39,140,1995,0,0,0
10371,39,23,1995,120,58,62
10372,39,164,1995,58,22,36
10373,39,63,1995,5796,2753,3043
10374,39,127,1995,18,12,6
10375,39,165,1995,164,70,94
10376,39,37,1995,113,70,43
10377,39,64,1995,60,35,25
10378,39,128,1995,6085,2812,3273
10379,39,115,1995,794,396,398
10380,39,129,1995,0,0,0
10381,39,65,1995,2136,1015,1121
10382,39,10,1995,6510,3020,3490
10383,39,145,1995,140,38,102
10384,39,113,1995,23,10,13
10385,39,49,1995,17707,10406,7301
10386,39,74,1995,1655,825,830
10387,39,25,1995,921,498,423
10388,39,169,1995,7,4,3
10389,39,166,1995,66,16,50
10390,39,93,1995,126,68,58
10391,39,146,1995,567,135,432
10392,39,26,1995,24783,11594,13189
10393,39,170,1995,4,3,1
10394,39,130,1995,605,367,238
10395,39,38,1995,650,401,249
10396,39,27,1995,124,52,72
10397,39,50,1995,11553,4746,6807
10398,39,131,1995,616,330,286
10399,39,114,1995,184,90,94
10400,39,171,1995,40,27,13
10401,39,1,1995,6865,3207,3658
10402,39,28,1995,107,51,56
10403,39,132,1995,259,152,107
10404,39,133,1995,209,106,103
10405,118,120,1995,10943,6114,4829
10406,118,128,1995,82625,38421,44204
10407,118,28,1995,236,122,114
10408,82,76,1995,243,115,128
10409,82,78,1995,6,4,2
10410,82,79,1995,80,37,43
10411,82,172,1995,19,6,13
10412,82,81,1995,6,6,0
10413,82,68,1995,38,13,25
10414,82,109,1995,11,9,2
10415,82,69,1995,14,9,5
10416,82,110,1995,91,41,50
10417,82,85,1995,732,375,357
10418,82,5,1995,13,5,8
10419,82,86,1995,62,41,21
10420,82,20,1995,16,4,12
10421,82,87,1995,78,37,41
10422,82,73,1995,5,3,2
10423,82,77,1995,22,15,7
10424,82,162,1995,24,15,9
10425,82,88,1995,8,1,7
10426,82,90,1995,30,18,12
10427,82,75,1995,9,3,6
10428,82,91,1995,135,68,67
10429,82,92,1995,60,26,34
10430,82,113,1995,9,4,5
10431,82,25,1995,8,3,5
10432,82,93,1995,147,61,86
10433,82,50,1995,304,148,156
10434,83,76,1995,296,150,146
10435,83,103,1995,2935,1248,1687
10436,83,66,1995,1072,177,895
10437,83,78,1995,101,59,42
10438,83,13,1995,24,4,20
10439,83,67,1995,544,213,331
10440,83,4,1995,10,0,10
10441,83,53,1995,7,0,7
10442,83,105,1995,1055,578,477
10443,83,30,1995,397,173,224
10444,83,116,1995,4,4,0
10445,83,135,1995,4,0,4
10446,83,153,1995,4,4,0
10447,83,136,1995,4,0,4
10448,83,106,1995,2101,744,1357
10449,83,172,1995,4013,1766,2247
10450,83,107,1995,5217,2556,2661
10451,83,96,1995,1724,1051,673
10452,83,81,1995,7580,3327,4253
10453,83,31,1995,14,7,7
10454,83,39,1995,78,13,65
10455,83,82,1995,27,7,20
10456,83,108,1995,1055,582,473
10457,83,97,1995,407,199,208
10458,83,42,1995,50,16,34
10459,83,68,1995,2804,1084,1720
10460,83,69,1995,5647,2279,3368
10461,83,56,1995,105,37,68
10462,83,98,1995,528,157,371
10463,83,110,1995,50,16,34
10464,83,85,1995,207931,73279,134652
10465,83,99,1995,481,236,245
10466,83,32,1995,57,23,34
10467,83,5,1995,319,144,175
10468,83,6,1995,78,7,71
10469,83,16,1995,7,0,7
10470,83,44,1995,57,26,31
10471,83,17,1995,206,42,164
10472,83,57,1995,7731,2265,5466
10473,83,86,1995,468,157,311
10474,83,177,1995,1395,643,752
10475,83,167,1995,4,0,4
10476,83,20,1995,797,304,493
10477,83,58,1995,37,23,14
10478,83,100,1995,1930,1097,833
10479,83,144,1995,24,10,14
10480,83,73,1995,642,190,452
10481,83,77,1995,367,180,187
10482,83,101,1995,461,237,224
10483,83,162,1995,47,10,37
10484,83,48,1995,75,26,49
10485,83,9,1995,185,30,155
10486,83,102,1995,777,343,434
10487,83,111,1995,68,23,45
10488,83,112,1995,2212,898,1314
10489,83,33,1995,528,461,67
10490,83,61,1995,178,56,122
10491,83,88,1995,9738,5289,4449
10492,83,35,1995,34,16,18
10493,83,36,1995,319,196,123
10494,83,90,1995,85,23,62
10495,83,75,1995,155,65,90
10496,83,23,1995,27,0,27
10497,83,63,1995,200,80,120
10498,83,115,1995,269,112,157
10499,83,65,1995,8168,2970,5198
10500,83,113,1995,115,75,40
10501,83,49,1995,410,323,87
10502,83,74,1995,2377,863,1514
10503,83,25,1995,85,37,48
10504,83,93,1995,111,53,58
10505,83,26,1995,81,39,42
10506,83,94,1995,4,0,4
10507,83,38,1995,135,82,53
10508,83,60,1995,7,0,7
10509,83,50,1995,646,229,417
10510,83,114,1995,1805,1090,715
10511,108,2,1995,21,8,13
10512,108,51,1995,19,9,10
10513,108,141,1995,18,5,13
10514,108,134,1995,16,10,6
10515,108,103,1995,1954,814,1140
10516,108,66,1995,205,90,115
10517,108,78,1995,18,8,10
10518,108,11,1995,15,7,8
10519,108,67,1995,320,157,163
10520,108,105,1995,1035,573,462
10521,108,30,1995,73,40,33
10522,108,135,1995,17,6,11
10523,108,106,1995,5002,2291,2711
10524,108,172,1995,934,377,557
10525,108,107,1995,55897,29542,26355
10526,108,96,1995,351,189,162
10527,108,54,1995,31,11,20
10528,108,81,1995,1120,501,619
10529,108,31,1995,118,33,85
10530,108,39,1995,69,22,47
10531,108,83,1995,133,74,59
10532,108,97,1995,196,103,93
10533,108,42,1995,48,30,18
10534,108,68,1995,813,399,414
10535,108,155,1995,13,3,10
10536,108,69,1995,1612,785,827
10537,108,156,1995,15,5,10
10538,108,56,1995,27,6,21
10539,108,98,1995,162,83,79
10540,108,85,1995,36,11,25
10541,108,99,1995,176,97,79
10542,108,173,1995,37,16,21
10543,108,32,1995,81,50,31
10544,108,5,1995,86,28,58
10545,108,6,1995,72,21,51
10546,108,16,1995,14,1,13
10547,108,44,1995,75,32,43
10548,108,17,1995,195,75,120
10549,108,57,1995,1424,575,849
10550,108,86,1995,15,8,7
10551,108,177,1995,275,116,159
10552,108,18,1995,27,6,21
10553,108,176,1995,182,82,100
10554,108,20,1995,166,59,107
10555,108,100,1995,797,433,364
10556,108,144,1995,18,7,11
10557,108,73,1995,310,137,173
10558,108,101,1995,147,72,75
10559,108,162,1995,19,1,18
10560,108,48,1995,89,45,44
10561,108,9,1995,20,2,18
10562,108,102,1995,361,176,185
10563,108,111,1995,91,43,48
10564,108,112,1995,4125,1791,2334
10565,108,33,1995,117,59,58
10566,108,61,1995,137,52,85
10567,108,88,1995,188,91,97
10568,108,35,1995,114,63,51
10569,108,36,1995,559,357,202
10570,108,23,1995,34,13,21
10571,108,37,1995,19,10,9
10572,108,1,1995,18,8,10
10573,108,115,1995,46,14,32
10574,108,65,1995,2556,1243,1313
10575,108,49,1995,131,62,69
10576,108,74,1995,734,249,485
10577,108,25,1995,25,7,18
10578,108,93,1995,17,10,7
10579,108,38,1995,151,85,66
10580,108,60,1995,15,6,9
10581,108,142,1995,32,10,22
10582,108,50,1995,807,379,428
10583,108,114,1995,359,134,225
10584,142,2,1995,188,38,150
10585,142,51,1995,96,35,61
10586,142,141,1995,573,384,189
10587,142,134,1995,21,11,10
10588,142,76,1995,13,7,6
10589,142,12,1995,23,1,22
10590,142,103,1995,243,97,146
10591,142,66,1995,557,308,249
10592,142,78,1995,11,9,2
10593,142,13,1995,325,185,140
10594,142,3,1995,143,22,121
10595,142,11,1995,143,91,52
10596,142,67,1995,521,265,256
10597,142,53,1995,33,16,17
10598,142,105,1995,112,68,44
10599,142,30,1995,58,32,26
10600,142,116,1995,36,4,32
10601,142,29,1995,216,126,90
10602,142,135,1995,109,16,93
10603,142,10,1995,199,82,117
10604,142,136,1995,264,95,169
10605,142,106,1995,20,11,9
10606,142,172,1995,501,131,370
10607,142,107,1995,52,8,44
10608,142,117,1995,527,84,443
10609,142,137,1995,39,10,29
10610,142,137,1995,94,35,59
10611,142,54,1995,96,16,80
10612,142,14,1995,77,36,41
10613,142,31,1995,191,108,83
10614,142,151,1995,35,1,34
10615,142,39,1995,240,121,119
10616,142,108,1995,9,7,2
10617,142,97,1995,151,89,62
10618,142,120,1995,503,300,203
10619,142,119,1995,359,180,179
10620,142,40,1995,16,8,8
10621,142,42,1995,178,110,68
10622,142,68,1995,2490,1173,1317
10623,142,118,1995,247,97,150
10624,142,155,1995,28,6,22
10625,142,69,1995,7378,3413,3965
10626,142,156,1995,186,43,143
10627,142,55,1995,7,3,4
10628,142,56,1995,1077,626,451
10629,142,98,1995,7,4,3
10630,142,157,1995,138,10,128
10631,142,32,1995,106,61,45
10632,142,5,1995,823,316,507
10633,142,6,1995,118,52,66
10634,142,16,1995,4401,2394,2007
10635,142,44,1995,87,53,34
10636,142,17,1995,728,301,427
10637,142,57,1995,3710,1741,1969
10638,142,177,1995,1105,539,566
10639,142,167,1995,143,79,64
10640,142,18,1995,3473,1647,1826
10641,142,121,1995,112,31,81
10642,142,176,1995,93,38,55
10643,142,19,1995,2064,831,1233
10644,142,168,1995,45,11,34
10645,142,20,1995,2232,1276,956
10646,142,159,1995,36,9,27
10647,142,143,1995,3176,1450,1726
10648,142,122,1995,38,1,37
10649,142,123,1995,21,4,17
10650,142,7,1995,12,3,9
10651,142,160,1995,192,39,153
10652,142,161,1995,128,33,95
10653,142,100,1995,57,38,19
10654,142,72,1995,59,31,28
10655,142,144,1995,627,482,145
10656,142,125,1995,13,5,8
10657,142,21,1995,401,147,254
10658,142,150,1995,277,186,91
10659,142,73,1995,863,431,432
10660,142,162,1995,567,135,432
10661,142,48,1995,94,38,56
10662,142,9,1995,403,133,270
10663,142,33,1995,329,153,176
10664,142,61,1995,38,21,17
10665,142,158,1995,66,1,65
10666,142,22,1995,278,118,160
10667,142,35,1995,194,102,92
10668,142,36,1995,7112,4633,2479
10669,142,126,1995,44,10,34
10670,142,23,1995,5065,1919,3146
10671,142,164,1995,334,66,268
10672,142,127,1995,14,5,9
10673,142,165,1995,42,25,17
10674,142,37,1995,56,33,23
10675,142,128,1995,6209,2846,3363
10676,142,115,1995,170,73,97
10677,142,133,1995,30,6,24
10678,142,65,1995,362,173,189
10679,142,129,1995,0,0,0
10680,142,145,1995,11817,5375,6442
10681,142,49,1995,297,131,166
10682,142,74,1995,1334,640,694
10683,142,25,1995,5198,2415,2783
10684,142,169,1995,68,17,51
10685,142,27,1995,475,185,290
10686,142,146,1995,513,277,236
10687,142,26,1995,685,177,508
10688,142,170,1995,27,6,21
10689,142,130,1995,75,10,65
10690,142,38,1995,92,56,36
10691,142,60,1995,113,46,67
10692,142,50,1995,2573,1173,1400
10693,142,131,1995,126,25,101
10694,142,152,1995,55,5,50
10695,142,171,1995,80,18,62
10696,142,28,1995,3850,1633,2217
10697,142,132,1995,22,7,15
10698,97,103,1995,211,91,120
10699,97,66,1995,14,9,5
10700,97,3,1995,9,0,9
10701,97,79,1995,50,26,24
10702,97,67,1995,72,36,36
10703,97,105,1995,264,158,106
10704,97,95,1995,231,124,107
10705,97,106,1995,294,158,136
10706,97,172,1995,224,81,143
10707,97,107,1995,375,210,165
10708,97,96,1995,1188,615,573
10709,97,81,1995,82,39,43
10710,97,83,1995,41,20,21
10711,97,108,1995,126,69,57
10712,97,68,1995,175,89,86
10713,97,69,1995,347,140,207
10714,97,98,1995,7224,3926,3298
10715,97,99,1995,12650,7200,5450
10716,97,173,1995,10,6,4
10717,97,5,1995,14,6,8
10718,97,6,1995,17,6,11
10719,97,44,1995,18,7,11
10720,97,17,1995,123,64,59
10721,97,57,1995,312,97,215
10722,97,86,1995,13,6,7
10723,97,177,1995,38,10,28
10724,97,100,1995,1948,1077,871
10725,97,73,1995,53,18,35
10726,97,101,1995,4219,2176,2043
10727,97,102,1995,456,245,211
10728,97,111,1995,26,13,13
10729,97,112,1995,209,93,116
10730,97,61,1995,16,4,12
10731,97,88,1995,84,41,43
10732,97,36,1995,23,13,10
10733,97,65,1995,664,280,384
10734,97,49,1995,29,13,16
10735,97,74,1995,69,29,40
10736,97,50,1995,106,40,66
10737,97,114,1995,94,35,59
10738,138,135,1995,268,92,176
10739,138,68,1995,1529,857,672
10740,138,139,1995,86,39,47
10741,138,162,1995,121,58,63
10742,138,140,1995,501,203,298
10743,138,65,1995,429,180,249
10744,119,134,1995,433,195,238
10745,119,116,1995,1141,552,589
10746,119,172,1995,53,8,45
10747,119,117,1995,60,34,26
10748,119,137,1995,816,378,438
10749,119,120,1995,687,330,357
10750,119,68,1995,159,84,75
10751,119,5,1995,54,31,23
10752,119,121,1995,202,81,121
10753,119,123,1995,228,127,101
10754,119,125,1995,2218,1137,1081
10755,119,126,1995,703,337,366
10756,119,128,1995,1607,738,869
10757,119,115,1995,143,55,88
10758,119,133,1995,125,37,88
10759,119,129,1995,1109,497,612
10760,119,145,1995,155,70,85
10761,119,130,1995,682,255,427
10762,119,50,1995,38,24,14
10763,119,131,1995,296,147,149
10764,119,132,1995,121,45,76
10765,40,2,1995,0,0,0
10766,40,51,1995,0,0,0
10767,40,141,1995,0,0,0
10768,40,52,1995,0,0,0
10769,40,134,1995,0,0,0
10770,40,76,1995,0,0,0
10771,40,103,1995,0,0,0
10772,40,11,1995,655,236,419
10773,40,66,1995,0,0,0
10774,40,12,1995,1824,718,1106
10775,40,13,1995,0,0,0
10776,40,3,1995,0,0,0
10777,40,79,1995,0,0,0
10778,40,29,1995,19313,10511,8802
10779,40,67,1995,0,0,0
10780,40,95,1995,0,0,0
10781,40,151,1995,0,0,0
10782,40,4,1995,0,0,0
10783,40,53,1995,0,0,0
10784,40,105,1995,0,0,0
10785,40,30,1995,0,0,0
10786,40,153,1995,0,0,0
10787,40,135,1995,0,0,0
10788,40,106,1995,0,0,0
10789,40,172,1995,92,48,44
10790,40,173,1995,0,0,0
10791,40,107,1995,0,0,0
10792,40,137,1995,0,0,0
10793,40,96,1995,0,0,0
10794,40,54,1995,0,0,0
10795,40,81,1995,0,0,0
10796,40,14,1995,0,0,0
10797,40,31,1995,0,0,0
10798,40,176,1995,0,0,0
10799,40,137,1995,0,0,0
10800,40,39,1995,39,13,26
10801,40,83,1995,0,0,0
10802,40,108,1995,0,0,0
10803,40,142,1995,0,0,0
10804,40,97,1995,0,0,0
10805,40,120,1995,0,0,0
10806,40,41,1995,0,0,0
10807,40,42,1995,1010,468,542
10808,40,68,1995,65,36,29
10809,40,155,1995,0,0,0
10810,40,15,1995,1884,920,964
10811,40,69,1995,716,356,360
10812,40,156,1995,0,0,0
10813,40,55,1995,0,0,0
10814,40,56,1995,0,0,0
10815,40,98,1995,0,0,0
10816,40,157,1995,0,0,0
10817,40,110,1995,0,0,0
10818,40,99,1995,0,0,0
10819,40,32,1995,56,28,28
10820,40,43,1995,0,0,0
10821,40,5,1995,39,14,25
10822,40,6,1995,0,0,0
10823,40,16,1995,0,0,0
10824,40,44,1995,0,0,0
10825,40,17,1995,0,0,0
10826,40,57,1995,0,0,0
10827,40,86,1995,0,0,0
10828,40,177,1995,0,0,0
10829,40,18,1995,0,0,0
10830,40,167,1995,5712,2998,2714
10831,40,121,1995,0,0,0
10832,40,19,1995,0,0,0
10833,40,168,1995,843,431,412
10834,40,46,1995,5196,2878,2318
10835,40,20,1995,0,0,0
10836,40,143,1995,0,0,0
10837,40,70,1995,0,0,0
10838,40,47,1995,2639,1380,1259
10839,40,71,1995,0,0,0
10840,40,122,1995,0,0,0
10841,40,123,1995,0,0,0
10842,40,58,1995,0,0,0
10843,40,161,1995,0,0,0
10844,40,124,1995,0,0,0
10845,40,100,1995,0,0,0
10846,40,72,1995,0,0,0
10847,40,59,1995,0,0,0
10848,40,144,1995,0,0,0
10849,40,125,1995,0,0,0
10850,40,150,1995,0,0,0
10851,40,8,1995,0,0,0
10852,40,73,1995,0,0,0
10853,40,101,1995,0,0,0
10854,40,162,1995,0,0,0
10855,40,60,1995,0,0,0
10856,40,48,1995,0,0,0
10857,40,21,1995,0,0,0
10858,40,9,1995,0,0,0
10859,40,102,1995,0,0,0
10860,40,111,1995,0,0,0
10861,40,112,1995,0,0,0
10862,40,33,1995,366,222,144
10863,40,61,1995,0,0,0
10864,40,22,1995,0,0,0
10865,40,35,1995,0,0,0
10866,40,36,1995,236214,139527,96687
10867,40,126,1995,0,0,0
10868,40,90,1995,0,0,0
10869,40,23,1995,0,0,0
10870,40,164,1995,0,0,0
10871,40,63,1995,0,0,0
10872,40,165,1995,0,0,0
10873,40,37,1995,0,0,0
10874,40,64,1995,0,0,0
10875,40,128,1995,0,0,0
10876,40,115,1995,0,0,0
10877,40,65,1995,0,0,0
10878,40,10,1995,0,0,0
10879,40,145,1995,0,0,0
10880,40,113,1995,0,0,0
10881,40,49,1995,139,60,79
10882,40,74,1995,0,0,0
10883,40,25,1995,0,0,0
10884,40,169,1995,604,305,299
10885,40,166,1995,0,0,0
10886,40,93,1995,0,0,0
10887,40,146,1995,0,0,0
10888,40,26,1995,0,0,0
10889,40,170,1995,684,369,315
10890,40,130,1995,0,0,0
10891,40,38,1995,33755,16217,17538
10892,40,27,1995,0,0,0
10893,40,50,1995,48,18,30
10894,40,131,1995,0,0,0
10895,40,114,1995,0,0,0
10896,40,171,1995,1848,848,1000
10897,40,1,1995,0,0,0
10898,40,28,1995,0,0,0
10899,40,132,1995,0,0,0
10900,40,133,1995,0,0,0
10901,148,134,1995,143,63,80
10902,148,147,1995,64,29,35
10903,148,116,1995,132,59,73
10904,148,137,1995,9,4,5
10905,148,137,1995,180,73,107
10906,148,120,1995,3,1,2
10907,148,149,1995,111,52,59
10908,148,159,1995,5,2,3
10909,148,125,1995,18085,7645,10440
10910,148,126,1995,52,21,31
10911,148,128,1995,128,53,75
10912,148,115,1995,9097,4876,4221
10913,148,130,1995,8,3,5
10914,120,116,1995,25,10,15
10915,120,137,1995,63,26,37
10916,120,119,1995,34949,16269,18680
10917,120,118,1995,1901,747,1154
10918,120,126,1995,93,38,55
10919,120,128,1995,459615,228486,231129
10920,120,129,1995,235512,105553,129959
10921,120,145,1995,33008,14794,18214
10922,120,130,1995,135,55,80
10923,120,28,1995,89,36,53
10924,41,105,1995,6,2,4
10925,41,30,1995,1,0,1
10926,41,172,1995,0,0,0
10927,41,107,1995,39,16,23
10928,41,54,1995,1,0,1
10929,41,39,1995,2071,901,1170
10930,41,120,1995,0,0,0
10931,41,69,1995,17,9,8
10932,41,156,1995,1,0,1
10933,41,43,1995,183,85,98
10934,41,5,1995,24,15,9
10935,41,121,1995,2,0,2
10936,41,47,1995,0,0,0
10937,41,48,1995,98,51,47
10938,41,112,1995,0,0,0
10939,41,33,1995,20,8,12
10940,41,35,1995,1,0,1
10941,41,36,1995,1,1,0
10942,41,63,1995,0,0,0
10943,41,115,1995,2,2,0
10944,41,49,1995,39,16,23
10945,41,146,1995,2,0,2
10946,41,50,1995,92,51,41
10947,42,2,1995,144,72,72
10948,42,51,1995,17,6,11
10949,42,141,1995,305,34,271
10950,42,52,1995,1,0,1
10951,42,134,1995,49,18,31
10952,42,76,1995,0,0,0
10953,42,103,1995,120,52,68
10954,42,11,1995,10,5,5
10955,42,77,1995,0,0,0
10956,42,66,1995,258,107,151
10957,42,12,1995,4,3,1
10958,42,78,1995,2,2,0
10959,42,13,1995,3,2,1
10960,42,3,1995,231,64,167
10961,42,79,1995,6,1,5
10962,42,29,1995,16,10,6
10963,42,67,1995,144,62,82
10964,42,95,1995,1,1,0
10965,42,151,1995,1,0,1
10966,42,4,1995,0,0,0
10967,42,53,1995,100,47,53
10968,42,147,1995,2,1,1
10969,42,105,1995,203,115,88
10970,42,30,1995,348,143,205
10971,42,152,1995,1,1,0
10972,42,116,1995,4,1,3
10973,42,153,1995,3,1,2
10974,42,135,1995,15,6,9
10975,42,136,1995,2,0,2
10976,42,106,1995,175,84,91
10977,42,172,1995,1106,546,560
10978,42,107,1995,242,112,130
10979,42,117,1995,2,1,1
10980,42,137,1995,12,7,5
10981,42,96,1995,16,7,9
10982,42,54,1995,52,25,27
10983,42,81,1995,74,26,48
10984,42,14,1995,53,11,42
10985,42,31,1995,272,136,136
10986,42,176,1995,2,2,0
10987,42,137,1995,144,49,95
10988,42,39,1995,577,240,337
10989,42,118,1995,1,1,0
10990,42,82,1995,1,0,1
10991,42,83,1995,22,9,13
10992,42,108,1995,35,16,19
10993,42,142,1995,276,31,245
10994,42,97,1995,11,5,6
10995,42,138,1995,0,0,0
10996,42,119,1995,5,3,2
10997,42,40,1995,3285,1784,1501
10998,42,148,1995,0,0,0
10999,42,120,1995,394,169,225
11000,42,68,1995,727,279,448
11001,42,139,1995,1,1,0
11002,42,155,1995,96,8,88
11003,42,15,1995,5,3,2
11004,42,69,1995,2800,1086,1714
11005,42,156,1995,161,36,125
11006,42,56,1995,357,55,302
11007,42,84,1995,0,0,0
11008,42,98,1995,21,5,16
11009,42,157,1995,7,1,6
11010,42,158,1995,2,0,2
11011,42,110,1995,8,4,4
11012,42,85,1995,1,0,1
11013,42,99,1995,10,7,3
11014,42,32,1995,644,288,356
11015,42,43,1995,90,40,50
11016,42,5,1995,768,265,503
11017,42,6,1995,1160,422,738
11018,42,16,1995,1453,597,856
11019,42,44,1995,128,34,94
11020,42,17,1995,371,114,257
11021,42,57,1995,655,154,501
11022,42,86,1995,25,8,17
11023,42,177,1995,455,207,248
11024,42,18,1995,88,14,74
11025,42,167,1995,22,12,10
11026,42,121,1995,139,61,78
11027,42,19,1995,39,13,26
11028,42,168,1995,1,1,0
11029,42,46,1995,117,66,51
11030,42,20,1995,196,53,143
11031,42,159,1995,19,3,16
11032,42,143,1995,45,11,34
11033,42,47,1995,68,41,27
11034,42,71,1995,23,10,13
11035,42,122,1995,2,1,1
11036,42,123,1995,2,0,2
11037,42,7,1995,1,0,1
11038,42,160,1995,3,0,3
11039,42,58,1995,13,3,10
11040,42,161,1995,0,0,0
11041,42,124,1995,18,10,8
11042,42,100,1995,98,44,54
11043,42,72,1995,2,0,2
11044,42,59,1995,0,0,0
11045,42,144,1995,642,82,560
11046,42,125,1995,12,8,4
11047,42,150,1995,38,20,18
11048,42,8,1995,49,20,29
11049,42,73,1995,515,127,388
11050,42,101,1995,23,14,9
11051,42,162,1995,170,25,145
11052,42,60,1995,0,0,0
11053,42,48,1995,853,431,422
11054,42,21,1995,2,1,1
11055,42,9,1995,237,63,174
11056,42,102,1995,11,3,8
11057,42,111,1995,7,3,4
11058,42,112,1995,125,70,55
11059,42,33,1995,1007,530,477
11060,42,61,1995,106,36,70
11061,42,22,1995,4,2,2
11062,42,35,1995,375,147,228
11063,42,36,1995,2115,1274,841
11064,42,126,1995,13,7,6
11065,42,90,1995,1,0,1
11066,42,91,1995,1,0,1
11067,42,92,1995,2,0,2
11068,42,62,1995,0,0,0
11069,42,23,1995,93,42,51
11070,42,164,1995,25,3,22
11071,42,63,1995,0,0,0
11072,42,127,1995,1,1,0
11073,42,165,1995,29,4,25
11074,42,37,1995,7,3,4
11075,42,64,1995,2,1,1
11076,42,128,1995,1772,763,1009
11077,42,115,1995,145,71,74
11078,42,129,1995,0,0,0
11079,42,65,1995,579,209,370
11080,42,10,1995,232,110,122
11081,42,145,1995,0,0,0
11082,42,113,1995,2,1,1
11083,42,49,1995,24814,12012,12802
11084,42,74,1995,476,201,275
11085,42,25,1995,105,35,70
11086,42,169,1995,2,1,1
11087,42,166,1995,8,1,7
11088,42,93,1995,10,6,4
11089,42,146,1995,208,23,185
11090,42,26,1995,1133,224,909
11091,42,170,1995,2,1,1
11092,42,94,1995,0,0,0
11093,42,130,1995,16,5,11
11094,42,38,1995,92,53,39
11095,42,27,1995,22,5,17
11096,42,50,1995,2018,635,1383
11097,42,131,1995,116,42,74
11098,42,114,1995,39,13,26
11099,42,171,1995,6,3,3
11100,42,1,1995,2035,987,1048
11101,42,28,1995,12,5,7
11102,42,132,1995,52,27,25
11103,42,133,1995,15,6,9
11104,68,2,1995,3455,1509,1946
11105,68,51,1995,3501,1611,1890
11106,68,141,1995,814417,359486,454931
11107,68,52,1995,1273,703,570
11108,68,134,1995,11871,5198,6673
11109,68,75,1995,9,3,6
11110,68,76,1995,20,15,5
11111,68,103,1995,10465,5821,4644
11112,68,11,1995,6759,3734,3025
11113,68,77,1995,10,6,4
11114,68,66,1995,12052,8057,3995
11115,68,12,1995,413,207,206
11116,68,78,1995,67,40,27
11117,68,13,1995,57,30,27
11118,68,3,1995,2269,804,1465
11119,68,79,1995,44,24,20
11120,68,29,1995,1163,708,455
11121,68,67,1995,132113,77298,54815
11122,68,95,1995,7,6,1
11123,68,151,1995,11847,5407,6440
11124,68,4,1995,248,94,154
11125,68,53,1995,8628,4362,4266
11126,68,147,1995,188,101,87
11127,68,105,1995,21096,12611,8485
11128,68,30,1995,9708,5460,4248
11129,68,152,1995,3955,1814,2141
11130,68,116,1995,1388,767,621
11131,68,153,1995,16887,9145,7742
11132,68,135,1995,38038,20464,17574
11133,68,136,1995,2637,1149,1488
11134,68,106,1995,13634,7039,6595
11135,68,172,1995,43028,23132,19896
11136,68,173,1995,2299,1260,1039
11137,68,174,1995,115,59,56
11138,68,107,1995,15537,8735,6802
11139,68,117,1995,19469,10091,9378
11140,68,137,1995,49960,23663,26297
11141,68,96,1995,435,241,194
11142,68,54,1995,10802,5106,5696
11143,68,81,1995,2097,1228,869
11144,68,14,1995,1108,572,536
11145,68,31,1995,11915,7307,4608
11146,68,176,1995,102,63,39
11147,68,137,1995,33563,16783,16780
11148,68,39,1995,6991,4411,2580
11149,68,118,1995,3149,1498,1651
11150,68,82,1995,768,504,264
11151,68,83,1995,469,308,161
11152,68,108,1995,1637,1036,601
11153,68,142,1995,23179,8260,14919
11154,68,97,1995,1032,608,424
11155,68,138,1995,149,84,65
11156,68,119,1995,166,105,61
11157,68,40,1995,855,531,324
11158,68,148,1995,9,6,3
11159,68,120,1995,3975,2452,1523
11160,68,41,1995,4,3,1
11161,68,42,1995,4555,3368,1187
11162,68,139,1995,8196,4306,3890
11163,68,155,1995,1372,660,712
11164,68,15,1995,1381,712,669
11165,68,69,1995,177141,109703,67438
11166,68,156,1995,5756,2746,3010
11167,68,55,1995,65,44,21
11168,68,56,1995,14368,7410,6958
11169,68,98,1995,1667,858,809
11170,68,157,1995,8069,3571,4498
11171,68,158,1995,8321,3434,4887
11172,68,110,1995,31,19,12
11173,68,85,1995,27102,15096,12006
11174,68,99,1995,498,292,206
11175,68,32,1995,13837,6540,7297
11176,68,43,1995,409,253,156
11177,68,5,1995,26652,13795,12857
11178,68,6,1995,24114,11044,13070
11179,68,16,1995,4763,2029,2734
11180,68,44,1995,6919,4367,2552
11181,68,45,1995,13,10,3
11182,68,17,1995,6056,3047,3009
11183,68,57,1995,538661,275945,262716
11184,68,86,1995,478,292,186
11185,68,177,1995,18648,11918,6730
11186,68,18,1995,971,316,655
11187,68,167,1995,450,258,192
11188,68,121,1995,978,663,315
11189,68,19,1995,702,279,423
11190,68,168,1995,106,72,34
11191,68,46,1995,1353,747,606
11192,68,20,1995,39847,16727,23120
11193,68,149,1995,10,4,6
11194,68,159,1995,829,326,503
11195,68,143,1995,1398,656,742
11196,68,70,1995,106,50,56
11197,68,47,1995,1597,924,673
11198,68,71,1995,8275,4811,3464
11199,68,122,1995,39993,23872,16121
11200,68,123,1995,80,40,40
11201,68,7,1995,4,1,3
11202,68,160,1995,50893,18237,32656
11203,68,58,1995,940,518,422
11204,68,161,1995,11652,3657,7995
11205,68,124,1995,39333,23314,16019
11206,68,100,1995,6509,4058,2451
11207,68,72,1995,3388,1685,1703
11208,68,59,1995,980,470,510
11209,68,87,1995,6,6,0
11210,68,144,1995,737068,337390,399678
11211,68,125,1995,1082,593,489
11212,68,150,1995,108,57,51
11213,68,8,1995,730,390,340
11214,68,73,1995,35533,19532,16001
11215,68,101,1995,505,326,179
11216,68,162,1995,2798,1260,1538
11217,68,60,1995,76894,38180,38714
11218,68,48,1995,3363,2180,1183
11219,68,21,1995,22,9,13
11220,68,9,1995,16083,6036,10047
11221,68,102,1995,370,215,155
11222,68,111,1995,780,429,351
11223,68,112,1995,8162,4783,3379
11224,68,33,1995,139427,91383,48044
11225,68,61,1995,806641,394670,411971
11226,68,88,1995,300,148,152
11227,68,22,1995,156,84,72
11228,68,35,1995,32961,17207,15754
11229,68,36,1995,22069,14756,7313
11230,68,126,1995,3252,1753,1499
11231,68,90,1995,6,4,2
11232,68,91,1995,160,108,52
11233,68,92,1995,96,69,27
11234,68,62,1995,256,124,132
11235,68,140,1995,132,77,55
11236,68,23,1995,1286,581,705
11237,68,164,1995,76187,32069,44118
11238,68,63,1995,1960,941,1019
11239,68,127,1995,443,312,131
11240,68,165,1995,736,381,355
11241,68,37,1995,2861,1668,1193
11242,68,64,1995,3463,1904,1559
11243,68,128,1995,1533,780,753
11244,68,115,1995,2475,1450,1025
11245,68,65,1995,447770,246540,201230
11246,68,10,1995,34109,15711,18398
11247,68,145,1995,1169,441,728
11248,68,113,1995,276,158,118
11249,68,49,1995,10949,7463,3486
11250,68,74,1995,62850,36029,26821
11251,68,25,1995,14085,5760,8325
11252,68,169,1995,31,17,14
11253,68,166,1995,14992,6931,8061
11254,68,93,1995,278,195,83
11255,68,146,1995,285233,121610,163623
11256,68,26,1995,248944,117535,131409
11257,68,170,1995,224,124,100
11258,68,94,1995,7,4,3
11259,68,130,1995,435,252,183
11260,68,38,1995,8124,5370,2754
11261,68,27,1995,275,119,156
11262,68,50,1995,105643,56089,49554
11263,68,131,1995,650,369,281
11264,68,114,1995,2132,1143,989
11265,68,171,1995,313,177,136
11266,68,1,1995,102298,54130,48168
11267,68,28,1995,941,505,436
11268,68,132,1995,284,154,130
11269,68,133,1995,399,221,178
11270,109,141,1995,94,46,48
11271,109,67,1995,110,55,55
11272,109,105,1995,7022,3429,3593
11273,109,172,1995,1201,587,614
11274,109,82,1995,493,338,155
11275,109,68,1995,18094,7902,10192
11276,109,110,1995,2469,1204,1265
11277,109,85,1995,11381,5566,5815
11278,109,57,1995,120,59,61
11279,109,112,1995,344,168,176
11280,109,91,1995,1565,757,808
11281,109,113,1995,15381,7476,7905
11282,139,141,1995,45,19,26
11283,139,134,1995,457,188,269
11284,139,67,1995,206,94,112
11285,139,116,1995,69,29,40
11286,139,135,1995,20944,10568,10376
11287,139,136,1995,1870,746,1124
11288,139,172,1995,143,41,102
11289,139,137,1995,6747,3622,3125
11290,139,137,1995,3683,1700,1983
11291,139,151,1995,21584,10705,10879
11292,139,138,1995,35966,18288,17678
11293,139,68,1995,6645,2896,3749
11294,139,69,1995,36,16,20
11295,139,156,1995,2631,389,2242
11296,139,157,1995,2058,540,1518
11297,139,17,1995,6,2,4
11298,139,177,1995,13,6,7
11299,139,176,1995,67,26,41
11300,139,20,1995,1034,317,717
11301,139,160,1995,22807,8212,14595
11302,139,144,1995,295,150,145
11303,139,162,1995,9887,2723,7164
11304,139,126,1995,87,42,45
11305,139,140,1995,2690,1435,1255
11306,139,164,1995,12612,2576,10036
11307,139,115,1995,5,0,5
11308,139,25,1995,12,5,7
11309,139,166,1995,9517,4805,4712
11310,139,146,1995,93,41,52
11311,139,152,1995,2891,1153,1738
11312,155,157,1995,30668,12477,18191
11313,155,159,1995,286,130,156
11314,155,160,1995,7028,2494,4534
11315,155,161,1995,2474,354,2120
11316,155,158,1995,9365,4669,4696
11317,155,164,1995,89990,43965,46025
11318,155,165,1995,6835,3118,3717
11319,15,2,1995,0,0,0
11320,15,51,1995,0,0,0
11321,15,141,1995,0,0,0
11322,15,12,1995,6433,3302,3131
11323,15,103,1995,0,0,0
11324,15,66,1995,0,0,0
11325,15,11,1995,3297,1701,1596
11326,15,67,1995,0,0,0
11327,15,30,1995,0,0,0
11328,15,29,1995,2118,1714,404
11329,15,172,1995,337,178,159
11330,15,81,1995,0,0,0
11331,15,31,1995,0,0,0
11332,15,40,1995,720,402,318
11333,15,42,1995,0,0,0
11334,15,68,1995,0,0,0
11335,15,69,1995,1214,668,546
11336,15,56,1995,0,0,0
11337,15,32,1995,0,0,0
11338,15,5,1995,0,0,0
11339,15,6,1995,0,0,0
11340,15,17,1995,0,0,0
11341,15,57,1995,0,0,0
11342,15,167,1995,3302,1436,1866
11343,15,168,1995,484,326,158
11344,15,20,1995,0,0,0
11345,15,46,1995,398,260,138
11346,15,47,1995,410,314,96
11347,15,8,1995,0,0,0
11348,15,73,1995,0,0,0
11349,15,9,1995,0,0,0
11350,15,112,1995,0,0,0
11351,15,33,1995,350,252,98
11352,15,35,1995,396,211,185
11353,15,36,1995,89180,51100,38080
11354,15,65,1995,0,0,0
11355,15,74,1995,0,0,0
11356,15,169,1995,2690,1436,1254
11357,15,26,1995,513,268,245
11358,15,170,1995,1335,736,599
11359,15,38,1995,23412,13348,10064
11360,15,50,1995,0,0,0
11361,15,171,1995,9342,5089,4253
11362,69,2,1995,51537,22250,29287
11363,69,51,1995,8303,2933,5370
11364,69,141,1995,12366,2707,9659
11365,69,134,1995,0,0,0
11366,69,103,1995,4616,2581,2035
11367,69,11,1995,7892,3722,4170
11368,69,66,1995,185418,83520,101898
11369,69,12,1995,6621,3254,3367
11370,69,3,1995,5304,797,4507
11371,69,29,1995,10522,6739,3783
11372,69,67,1995,22307,11354,10953
11373,69,151,1995,859,193,666
11374,69,53,1995,129718,62862,66856
11375,69,105,1995,17392,12351,5041
11376,69,30,1995,30146,13749,16397
11377,69,152,1995,1296,142,1154
11378,69,116,1995,331,111,220
11379,69,135,1995,5590,1772,3818
11380,69,136,1995,281,35,246
11381,69,106,1995,6584,3470,3114
11382,69,172,1995,34512,13772,20740
11383,69,107,1995,6401,4199,2202
11384,69,137,1995,844,299,545
11385,69,96,1995,639,398,241
11386,69,54,1995,179958,89291,90667
11387,69,81,1995,4993,2405,2588
11388,69,14,1995,631,261,370
11389,69,31,1995,351459,181909,169550
11390,69,176,1995,1453,698,755
11391,69,137,1995,9428,3733,5695
11392,69,39,1995,18466,10935,7531
11393,69,83,1995,2828,2177,651
11394,69,108,1995,2397,1442,955
11395,69,142,1995,12245,3107,9138
11396,69,97,1995,504,277,227
11397,69,119,1995,3979,1791,2188
11398,69,40,1995,5310,3555,1755
11399,69,120,1995,17204,7155,10049
11400,69,42,1995,13312,9732,3580
11401,69,68,1995,97944,52736,45208
11402,69,139,1995,182,49,133
11403,69,155,1995,2261,233,2028
11404,69,15,1995,5946,3425,2521
11405,69,156,1995,21454,8120,13334
11406,69,56,1995,345405,157731,187674
11407,69,98,1995,618,354,264
11408,69,157,1995,1345,259,1086
11409,69,85,1995,350,180,170
11410,69,99,1995,498,330,168
11411,69,32,1995,69867,27560,42307
11412,69,43,1995,1370,694,676
11413,69,5,1995,32944,9479,23465
11414,69,6,1995,100027,38539,61488
11415,69,16,1995,32864,11113,21751
11416,69,44,1995,13677,6538,7139
11417,69,17,1995,9305,3812,5493
11418,69,57,1995,492300,189789,302511
11419,69,86,1995,985,579,406
11420,69,177,1995,27918,14645,13273
11421,69,18,1995,11543,3325,8218
11422,69,167,1995,248645,142797,105848
11423,69,121,1995,2966,1908,1058
11424,69,168,1995,16588,9579,7009
11425,69,46,1995,8067,4913,3154
11426,69,20,1995,47656,18911,28745
11427,69,159,1995,2891,642,2249
11428,69,143,1995,2068,601,1467
11429,69,70,1995,99,62,37
11430,69,47,1995,9451,6590,2861
11431,69,71,1995,5626,2536,3090
11432,69,122,1995,538,289,249
11433,69,160,1995,722,138,584
11434,69,58,1995,295,171,124
11435,69,100,1995,4652,3138,1514
11436,69,59,1995,37033,17210,19823
11437,69,144,1995,75112,29937,45175
11438,69,8,1995,1386,400,986
11439,69,73,1995,111594,52113,59481
11440,69,101,1995,634,331,303
11441,69,162,1995,14054,3292,10762
11442,69,60,1995,44914,21586,23328
11443,69,48,1995,6815,3821,2994
11444,69,9,1995,31202,8651,22551
11445,69,102,1995,237,122,115
11446,69,111,1995,731,447,284
11447,69,112,1995,6123,3809,2314
11448,69,33,1995,459633,247743,211890
11449,69,61,1995,111027,50314,60713
11450,69,35,1995,249921,118211,131710
11451,69,36,1995,490548,291139,199409
11452,69,126,1995,599,229,370
11453,69,23,1995,875,298,577
11454,69,164,1995,2171,269,1902
11455,69,63,1995,512812,234607,278205
11456,69,165,1995,3113,560,2553
11457,69,37,1995,20363,8917,11446
11458,69,64,1995,19580,9401,10179
11459,69,128,1995,6853,2281,4572
11460,69,115,1995,4560,2687,1873
11461,69,65,1995,133808,61302,72506
11462,69,10,1995,43756,15736,28020
11463,69,145,1995,0,0,0
11464,69,49,1995,15721,9136,6585
11465,69,74,1995,34981,19773,15208
11466,69,25,1995,20223,7743,12480
11467,69,169,1995,4140,2252,1888
11468,69,166,1995,6485,1928,4557
11469,69,93,1995,404,244,160
11470,69,146,1995,25283,9110,16173
11471,69,26,1995,1617880,751291,866589
11472,69,170,1995,1774,1015,759
11473,69,130,1995,1151,482,669
11474,69,38,1995,85683,50701,34982
11475,69,50,1995,107736,45319,62417
11476,69,131,1995,907,363,544
11477,69,114,1995,782,415,367
11478,69,171,1995,9029,5031,3998
11479,69,1,1995,75465,33962,41503
11480,69,28,1995,1342,362,980
11481,69,132,1995,342,126,216
11482,156,141,1995,7,2,5
11483,156,105,1995,7,3,4
11484,156,135,1995,61,21,40
11485,156,10,1995,15,6,9
11486,156,136,1995,8,2,6
11487,156,172,1995,121,20,101
11488,156,137,1995,16,8,8
11489,156,151,1995,8928,4033,4895
11490,156,120,1995,16,8,8
11491,156,68,1995,116,50,66
11492,156,155,1995,19,6,13
11493,156,157,1995,74,27,47
11494,156,5,1995,452,177,275
11495,156,17,1995,24,11,13
11496,156,57,1995,123,48,75
11497,156,177,1995,30,11,19
11498,156,121,1995,8,2,6
11499,156,20,1995,523,205,318
11500,156,159,1995,14538,6700,7838
11501,156,160,1995,3580,960,2620
11502,156,161,1995,9,3,6
11503,156,73,1995,131,52,79
11504,156,162,1995,14826,6311,8515
11505,156,9,1995,47,20,27
11506,156,33,1995,34,16,18
11507,156,36,1995,47,24,23
11508,156,126,1995,267,157,110
11509,156,164,1995,53,18,35
11510,156,165,1995,1180,514,666
11511,156,145,1995,18,3,15
11512,156,74,1995,104,42,62
11513,156,25,1995,37,15,22
11514,156,166,1995,144121,79378,64743
11515,156,142,1995,21,9,12
11516,156,50,1995,969,453,516
11517,156,131,1995,6,3,3
11518,156,152,1995,41526,17063,24463
11519,55,144,1995,1564,429,1135
11520,55,65,1995,2235,1594,641
11521,55,50,1995,3316,1583,1733
11522,56,2,1995,472,84,388
11523,56,51,1995,230218,91476,138742
11524,56,141,1995,258,82,176
11525,56,52,1995,5,1,4
11526,56,134,1995,19,10,9
11527,56,75,1995,11,5,6
11528,56,76,1995,13,5,8
11529,56,103,1995,628,356,272
11530,56,11,1995,10438,4943,5495
11531,56,77,1995,66,29,37
11532,56,66,1995,2854,1804,1050
11533,56,12,1995,277,153,124
11534,56,78,1995,21,11,10
11535,56,13,1995,15,7,8
11536,56,3,1995,6129,1755,4374
11537,56,79,1995,7,3,4
11538,56,29,1995,573,329,244
11539,56,67,1995,4916,2804,2112
11540,56,95,1995,3,1,2
11541,56,151,1995,7,2,5
11542,56,4,1995,4,1,3
11543,56,53,1995,422,217,205
11544,56,147,1995,3,2,1
11545,56,105,1995,1763,1055,708
11546,56,30,1995,22834,12499,10335
11547,56,152,1995,6,2,4
11548,56,116,1995,90,47,43
11549,56,153,1995,33,15,18
11550,56,135,1995,308,146,162
11551,56,80,1995,12,7,5
11552,56,136,1995,21,8,13
11553,56,106,1995,582,279,303
11554,56,172,1995,441,165,276
11555,56,173,1995,40,19,21
11556,56,107,1995,410,355,55
11557,56,117,1995,0,0,0
11558,56,137,1995,435,224,211
11559,56,96,1995,26,14,12
11560,56,54,1995,407,218,189
11561,56,81,1995,199,118,81
11562,56,14,1995,33684,16922,16762
11563,56,31,1995,2970,1705,1265
11564,56,176,1995,274,3,271
11565,56,137,1995,928,457,471
11566,56,39,1995,1314,949,365
11567,56,118,1995,13,8,5
11568,56,82,1995,401,266,135
11569,56,83,1995,192,120,72
11570,56,108,1995,48,31,17
11571,56,142,1995,22258,9341,12917
11572,56,97,1995,26,16,10
11573,56,138,1995,1,0,1
11574,56,119,1995,117,58,59
11575,56,40,1995,102,52,50
11576,56,148,1995,9,6,3
11577,56,120,1995,2929,1523,1406
11578,56,41,1995,2,2,0
11579,56,42,1995,1175,837,338
11580,56,68,1995,8518,5136,3382
11581,56,109,1995,3,1,2
11582,56,139,1995,31,14,17
11583,56,155,1995,51,25,26
11584,56,15,1995,53103,26703,26400
11585,56,69,1995,63007,33877,29130
11586,56,156,1995,514,198,316
11587,56,55,1995,12,7,5
11588,56,84,1995,4,2,2
11589,56,98,1995,37,22,15
11590,56,157,1995,17,6,11
11591,56,158,1995,5,4,1
11592,56,110,1995,13,6,7
11593,56,85,1995,87,40,47
11594,56,99,1995,47,25,22
11595,56,32,1995,1228,827,401
11596,56,43,1995,35,20,15
11597,56,5,1995,6117,868,5249
11598,56,6,1995,1946,724,1222
11599,56,16,1995,6698,2153,4545
11600,56,44,1995,762,507,255
11601,56,45,1995,15,7,8
11602,56,17,1995,1032,451,581
11603,56,57,1995,9328,5017,4311
11604,56,86,1995,68,31,37
11605,56,177,1995,863,514,349
11606,56,18,1995,1630,254,1376
11607,56,167,1995,13744,7064,6680
11608,56,121,1995,419,158,261
11609,56,19,1995,87,35,52
11610,56,168,1995,141,76,65
11611,56,46,1995,65,38,27
11612,56,20,1995,3958,1517,2441
11613,56,149,1995,2,2,0
11614,56,159,1995,28,12,16
11615,56,143,1995,848,268,580
11616,56,70,1995,9,4,5
11617,56,47,1995,228,129,99
11618,56,71,1995,121,73,48
11619,56,122,1995,101,53,48
11620,56,7,1995,6,2,4
11621,56,160,1995,16,6,10
11622,56,58,1995,162,82,80
11623,56,161,1995,4,2,2
11624,56,124,1995,48,29,19
11625,56,100,1995,366,258,108
11626,56,72,1995,16,9,7
11627,56,87,1995,2,0,2
11628,56,144,1995,772,359,413
11629,56,125,1995,52,29,23
11630,56,150,1995,7,2,5
11631,56,8,1995,21,8,13
11632,56,73,1995,4247,2712,1535
11633,56,101,1995,35,18,17
11634,56,162,1995,1705,431,1274
11635,56,60,1995,2519,1115,1404
11636,56,48,1995,701,389,312
11637,56,21,1995,3,1,2
11638,56,9,1995,8295,833,7462
11639,56,102,1995,210,104,106
11640,56,111,1995,63,40,23
11641,56,112,1995,187,109,78
11642,56,33,1995,22454,13054,9400
11643,56,61,1995,506,293,213
11644,56,88,1995,19,9,10
11645,56,22,1995,9,2,7
11646,56,35,1995,16015,7681,8334
11647,56,36,1995,49780,26741,23039
11648,56,126,1995,148,54,94
11649,56,90,1995,6,3,3
11650,56,92,1995,102,29,73
11651,56,62,1995,9,5,4
11652,56,140,1995,3,2,1
11653,56,23,1995,490,212,278
11654,56,164,1995,63,27,36
11655,56,63,1995,2508,1413,1095
11656,56,127,1995,37,21,16
11657,56,165,1995,344,141,203
11658,56,37,1995,548,296,252
11659,56,64,1995,105,61,44
11660,56,128,1995,55,24,31
11661,56,115,1995,3596,1947,1649
11662,56,65,1995,1760,1065,695
11663,56,10,1995,1069,558,511
11664,56,145,1995,1262,423,839
11665,56,113,1995,2,0,2
11666,56,49,1995,4336,2590,1746
11667,56,74,1995,3115,1654,1461
11668,56,25,1995,6220,1327,4893
11669,56,169,1995,40,25,15
11670,56,166,1995,12,7,5
11671,56,93,1995,9,6,3
11672,56,146,1995,407,170,237
11673,56,26,1995,54741,30376,24365
11674,56,170,1995,19982,8842,11140
11675,56,130,1995,99,52,47
11676,56,38,1995,8282,6120,2162
11677,56,27,1995,47,18,29
11678,56,50,1995,23503,14040,9463
11679,56,131,1995,330,147,183
11680,56,114,1995,87,53,34
11681,56,171,1995,3199,1658,1541
11682,56,1,1995,465,173,292
11683,56,28,1995,47,4,43
11684,56,132,1995,213,78,135
11685,56,133,1995,253,134,119
11686,84,76,1995,28,14,14
11687,84,78,1995,22,11,11
11688,84,79,1995,131,66,65
11689,84,82,1995,54,27,27
11690,84,110,1995,316,212,104
11691,84,86,1995,85,43,42
11692,84,87,1995,7,3,4
11693,84,90,1995,11,5,6
11694,84,91,1995,119,60,59
11695,84,92,1995,333,213,120
11696,84,93,1995,1813,1082,731
11697,98,103,1995,318,159,159
11698,98,105,1995,114,72,42
11699,98,95,1995,561,338,223
11700,98,106,1995,231,136,95
11701,98,172,1995,361,188,173
11702,98,107,1995,610,365,245
11703,98,96,1995,746,485,261
11704,98,81,1995,347,187,160
11705,98,83,1995,64,41,23
11706,98,108,1995,113,63,50
11707,98,97,1995,124346,70239,54107
11708,98,68,1995,229,120,109
11709,98,109,1995,13,8,5
11710,98,69,1995,440,255,185
11711,98,85,1995,18,12,6
11712,98,99,1995,5032,3540,1492
11713,98,6,1995,12,6,6
11714,98,17,1995,71,30,41
11715,98,57,1995,279,116,163
11716,98,177,1995,89,45,44
11717,98,20,1995,21,9,12
11718,98,100,1995,8236,4770,3466
11719,98,73,1995,86,39,47
11720,98,101,1995,4565,2782,1783
11721,98,9,1995,17,11,6
11722,98,102,1995,216,141,75
11723,98,111,1995,55,28,27
11724,98,112,1995,249,138,111
11725,98,61,1995,16,5,11
11726,98,88,1995,67,38,29
11727,98,23,1995,24,13,11
11728,98,65,1995,889,451,438
11729,98,49,1995,29,16,13
11730,98,74,1995,124,62,62
11731,98,25,1995,51,21,30
11732,98,26,1995,16,12,4
11733,98,142,1995,21,18,3
11734,98,50,1995,134,71,63
11735,98,114,1995,92,43,49
11736,157,2,1995,0,0,0
11737,157,51,1995,0,0,0
11738,157,141,1995,0,0,0
11739,157,52,1995,0,0,0
11740,157,134,1995,0,0,0
11741,157,76,1995,0,0,0
11742,157,12,1995,0,0,0
11743,157,103,1995,0,0,0
11744,157,66,1995,0,0,0
11745,157,78,1995,0,0,0
11746,157,13,1995,0,0,0
11747,157,3,1995,0,0,0
11748,157,11,1995,0,0,0
11749,157,79,1995,0,0,0
11750,157,67,1995,238,87,151
11751,157,4,1995,0,0,0
11752,157,53,1995,0,0,0
11753,157,147,1995,0,0,0
11754,157,105,1995,285,97,188
11755,157,95,1995,0,0,0
11756,157,30,1995,0,0,0
11757,157,116,1995,0,0,0
11758,157,135,1995,0,0,0
11759,157,153,1995,112,48,64
11760,157,10,1995,0,0,0
11761,157,136,1995,0,0,0
11762,157,106,1995,0,0,0
11763,157,172,1995,154,32,122
11764,157,107,1995,0,0,0
11765,157,117,1995,0,0,0
11766,157,137,1995,0,0,0
11767,157,137,1995,0,0,0
11768,157,96,1995,0,0,0
11769,157,54,1995,0,0,0
11770,157,81,1995,70,32,38
11771,157,151,1995,2710,1108,1602
11772,157,39,1995,0,0,0
11773,157,82,1995,0,0,0
11774,157,83,1995,0,0,0
11775,157,108,1995,0,0,0
11776,157,97,1995,0,0,0
11777,157,138,1995,0,0,0
11778,157,120,1995,0,0,0
11779,157,119,1995,0,0,0
11780,157,42,1995,0,0,0
11781,157,68,1995,1893,701,1192
11782,157,118,1995,0,0,0
11783,157,139,1995,0,0,0
11784,157,155,1995,935,329,606
11785,157,69,1995,0,0,0
11786,157,156,1995,0,0,0
11787,157,85,1995,0,0,0
11788,157,99,1995,0,0,0
11789,157,5,1995,0,0,0
11790,157,17,1995,0,0,0
11791,157,57,1995,0,0,0
11792,157,177,1995,31,15,16
11793,157,18,1995,0,0,0
11794,157,121,1995,0,0,0
11795,157,176,1995,0,0,0
11796,157,20,1995,0,0,0
11797,157,149,1995,0,0,0
11798,157,46,1995,0,0,0
11799,157,159,1995,449575,229283,220292
11800,157,143,1995,0,0,0
11801,157,70,1995,0,0,0
11802,157,122,1995,0,0,0
11803,157,123,1995,0,0,0
11804,157,160,1995,17927,7398,10529
11805,157,161,1995,442,136,306
11806,157,124,1995,0,0,0
11807,157,144,1995,0,0,0
11808,157,125,1995,0,0,0
11809,157,150,1995,0,0,0
11810,157,8,1995,0,0,0
11811,157,73,1995,0,0,0
11812,157,101,1995,0,0,0
11813,157,162,1995,1049,246,803
11814,157,48,1995,0,0,0
11815,157,9,1995,0,0,0
11816,157,33,1995,0,0,0
11817,157,61,1995,273,124,149
11818,157,158,1995,3226,1351,1875
11819,157,35,1995,0,0,0
11820,157,36,1995,551,184,367
11821,157,126,1995,0,0,0
11822,157,92,1995,0,0,0
11823,157,140,1995,0,0,0
11824,157,23,1995,786,342,444
11825,157,164,1995,7805,2369,5436
11826,157,63,1995,0,0,0
11827,157,127,1995,0,0,0
11828,157,165,1995,273125,139293,133832
11829,157,1,1995,0,0,0
11830,157,64,1995,0,0,0
11831,157,128,1995,0,0,0
11832,157,115,1995,0,0,0
11833,157,133,1995,0,0,0
11834,157,65,1995,68,32,36
11835,157,129,1995,0,0,0
11836,157,145,1995,0,0,0
11837,157,148,1995,0,0,0
11838,157,49,1995,0,0,0
11839,157,74,1995,0,0,0
11840,157,25,1995,34,7,27
11841,157,169,1995,0,0,0
11842,157,166,1995,1692,528,1164
11843,157,146,1995,0,0,0
11844,157,26,1995,0,0,0
11845,157,130,1995,0,0,0
11846,157,38,1995,96,46,50
11847,157,142,1995,0,0,0
11848,157,50,1995,0,0,0
11849,157,131,1995,0,0,0
11850,157,152,1995,552,182,370
11851,157,114,1995,0,0,0
11852,157,171,1995,0,0,0
11853,158,153,1995,466,283,183
11854,158,68,1995,91,28,63
11855,158,155,1995,1247,628,619
11856,158,157,1995,4069,1831,2238
11857,158,159,1995,2407,938,1469
11858,158,161,1995,461,234,227
11859,158,61,1995,678,303,375
11860,158,164,1995,16635,8892,7743
11861,158,165,1995,524,259,265
11862,110,76,1995,8,5,3
11863,110,78,1995,6,3,3
11864,110,79,1995,186,90,96
11865,110,105,1995,780,309,471
11866,110,172,1995,422,173,249
11867,110,82,1995,19,8,11
11868,110,84,1995,81,38,43
11869,110,86,1995,124,58,66
11870,110,91,1995,275,116,159
11871,110,92,1995,154,71,83
11872,110,113,1995,1681,849,832
11873,110,93,1995,310,141,169
11874,110,50,1995,211,96,115
11875,85,103,1995,442,189,253
11876,85,66,1995,161,26,135
11877,85,106,1995,316,113,203
11878,85,172,1995,330,139,191
11879,85,107,1995,786,386,400
11880,85,96,1995,260,159,101
11881,85,81,1995,1142,503,639
11882,85,83,1995,2285,1007,1278
11883,85,68,1995,422,164,258
11884,85,69,1995,851,344,507
11885,85,57,1995,1165,342,823
11886,85,177,1995,209,96,113
11887,85,100,1995,290,166,124
11888,85,112,1995,333,135,198
11889,85,88,1995,1468,800,668
11890,85,65,1995,1232,449,783
11891,85,74,1995,358,130,228
11892,85,114,1995,271,165,106
11893,99,103,1995,144,63,81
11894,99,67,1995,19,6,13
11895,99,105,1995,178,105,73
11896,99,95,1995,242,115,127
11897,99,80,1995,68,33,35
11898,99,106,1995,252,124,128
11899,99,172,1995,419,153,266
11900,99,107,1995,527,231,296
11901,99,96,1995,617,286,331
11902,99,81,1995,460,145,315
11903,99,83,1995,102,38,64
11904,99,108,1995,345,112,233
11905,99,97,1995,60692,31519,29173
11906,99,68,1995,108,46,62
11907,99,69,1995,221,76,145
11908,99,98,1995,3336,1631,1705
11909,99,85,1995,34,5,29
11910,99,17,1995,68,24,44
11911,99,57,1995,196,49,147
11912,99,86,1995,20,4,16
11913,99,177,1995,105,47,58
11914,99,18,1995,31,15,16
11915,99,176,1995,48,15,33
11916,99,100,1995,980,494,486
11917,99,73,1995,69,21,48
11918,99,101,1995,74273,35454,38819
11919,99,102,1995,243,105,138
11920,99,111,1995,27,11,16
11921,99,112,1995,288,123,165
11922,99,88,1995,97,37,60
11923,99,36,1995,19,8,11
11924,99,65,1995,381,164,217
11925,99,49,1995,23,11,12
11926,99,74,1995,47,14,33
11927,99,50,1995,77,24,53
11928,99,114,1995,51,19,32
11929,173,3,1995,332,116,216
11930,173,172,1995,1772597,823343,949254
11931,173,174,1995,58769,28618,30151
11932,173,68,1995,1641,531,1110
11933,173,69,1995,1476,374,1102
11934,173,5,1995,13464,6492,6972
11935,173,44,1995,520,207,313
11936,173,57,1995,480,170,310
11937,173,177,1995,10608,4826,5782
11938,173,8,1995,6980,3347,3633
11939,173,73,1995,763,254,509
11940,173,9,1995,5650,2146,3504
11941,173,61,1995,82,43,39
11942,173,36,1995,66,52,14
11943,173,65,1995,300,141,159
11944,173,10,1995,585,355,230
11945,173,74,1995,544,154,390
11946,173,50,1995,13212,4696,8516
11947,173,1,1995,8174,4726,3448
11948,32,2,1995,403,179,224
11949,32,51,1995,113,64,49
11950,32,141,1995,365,64,301
11951,32,52,1995,0,0,0
11952,32,134,1995,43,12,31
11953,32,76,1995,0,0,0
11954,32,103,1995,123,59,64
11955,32,11,1995,165,90,75
11956,32,77,1995,0,0,0
11957,32,66,1995,5365,2740,2625
11958,32,12,1995,119,62,57
11959,32,78,1995,3,1,2
11960,32,13,1995,12,5,7
11961,32,3,1995,53,7,46
11962,32,79,1995,2,1,1
11963,32,29,1995,125,76,49
11964,32,67,1995,601,303,298
11965,32,95,1995,1,0,1
11966,32,151,1995,15,2,13
11967,32,4,1995,0,0,0
11968,32,53,1995,323,134,189
11969,32,147,1995,3,1,2
11970,32,105,1995,207,102,105
11971,32,30,1995,1696,939,757
11972,32,152,1995,0,0,0
11973,32,116,1995,0,0,0
11974,32,153,1995,0,0,0
11975,32,135,1995,71,19,52
11976,32,80,1995,0,0,0
11977,32,136,1995,2,1,1
11978,32,106,1995,110,47,63
11979,32,172,1995,4242,2048,2194
11980,32,107,1995,84,39,45
11981,32,117,1995,0,0,0
11982,32,137,1995,37,5,32
11983,32,96,1995,15,4,11
11984,32,54,1995,980,536,444
11985,32,81,1995,335,205,130
11986,32,14,1995,288,115,173
11987,32,31,1995,578,371,207
11988,32,176,1995,0,0,0
11989,32,137,1995,15,5,10
11990,32,39,1995,146,65,81
11991,32,118,1995,0,0,0
11992,32,82,1995,0,0,0
11993,32,83,1995,12,6,6
11994,32,108,1995,49,19,30
11995,32,142,1995,390,75,315
11996,32,97,1995,11,6,5
11997,32,138,1995,0,0,0
11998,32,119,1995,3,2,1
11999,32,40,1995,63,46,17
12000,32,148,1995,0,0,0
12001,32,120,1995,61,15,46
12002,32,41,1995,0,0,0
12003,32,42,1995,284,151,133
12004,32,68,1995,2203,1127,1076
12005,32,139,1995,2,1,1
12006,32,155,1995,4,2,2
12007,32,15,1995,165,76,89
12008,32,69,1995,19850,10696,9154
12009,32,156,1995,65,18,47
12010,32,56,1995,1252,679,573
12011,32,84,1995,3,1,2
12012,32,98,1995,9,6,3
12013,32,157,1995,22,3,19
12014,32,158,1995,6,0,6
12015,32,110,1995,4,1,3
12016,32,85,1995,0,0,0
12017,32,99,1995,5,2,3
12018,32,43,1995,48,28,20
12019,32,5,1995,867,304,563
12020,32,6,1995,1595,608,987
12021,32,16,1995,649,205,444
12022,32,44,1995,287,142,145
12023,32,17,1995,786,360,426
12024,32,57,1995,1499,603,896
12025,32,86,1995,12,4,8
12026,32,177,1995,595,307,288
12027,32,18,1995,310,78,232
12028,32,167,1995,416,217,199
12029,32,121,1995,39,18,21
12030,32,19,1995,137,46,91
12031,32,168,1995,103,81,22
12032,32,46,1995,59,46,13
12033,32,20,1995,270,62,208
12034,32,149,1995,2,1,1
12035,32,159,1995,12,4,8
12036,32,143,1995,275,131,144
12037,32,70,1995,3,2,1
12038,32,47,1995,71,39,32
12039,32,71,1995,49,23,26
12040,32,122,1995,15,7,8
12041,32,123,1995,0,0,0
12042,32,160,1995,12,2,10
12043,32,58,1995,13,7,6
12044,32,161,1995,6,3,3
12045,32,124,1995,28,14,14
12046,32,100,1995,154,75,79
12047,32,72,1995,2,1,1
12048,32,59,1995,14,5,9
12049,32,144,1995,83,21,62
12050,32,125,1995,14,4,10
12051,32,150,1995,3,1,2
12052,32,8,1995,19,7,12
12053,32,73,1995,1012,439,573
12054,32,101,1995,12,5,7
12055,32,162,1995,484,145,339
12056,32,60,1995,23063,12806,10257
12057,32,48,1995,456,279,177
12058,32,21,1995,13,9,4
12059,32,9,1995,182,60,122
12060,32,102,1995,13,4,9
12061,32,111,1995,10,5,5
12062,32,112,1995,111,49,62
12063,32,33,1995,3200,1935,1265
12064,32,61,1995,123,51,72
12065,32,22,1995,27,11,16
12066,32,35,1995,170168,93483,76685
12067,32,36,1995,20575,11575,9000
12068,32,126,1995,7,3,4
12069,32,90,1995,8,6,2
12070,32,91,1995,0,0,0
12071,32,92,1995,2,1,1
12072,32,62,1995,0,0,0
12073,32,23,1995,253,69,184
12074,32,164,1995,11,3,8
12075,32,63,1995,8421,4307,4114
12076,32,127,1995,0,0,0
12077,32,165,1995,13,1,12
12078,32,37,1995,7703,4971,2732
12079,32,64,1995,189,92,97
12080,32,128,1995,139,30,109
12081,32,115,1995,137,65,72
12082,32,65,1995,437,219,218
12083,32,10,1995,42,17,25
12084,32,145,1995,95,18,77
12085,32,113,1995,0,0,0
12086,32,49,1995,653,344,309
12087,32,74,1995,829,398,431
12088,32,25,1995,664,240,424
12089,32,169,1995,14,7,7
12090,32,166,1995,4,1,3
12091,32,93,1995,5,3,2
12092,32,146,1995,82,13,69
12093,32,26,1995,919,331,588
12094,32,170,1995,0,0,0
12095,32,130,1995,14,4,10
12096,32,38,1995,11454,6910,4544
12097,32,27,1995,62,28,34
12098,32,50,1995,2091,930,1161
12099,32,131,1995,34,8,26
12100,32,114,1995,53,30,23
12101,32,171,1995,91,52,39
12102,32,1,1995,1499,797,702
12103,32,28,1995,214,62,152
12104,32,132,1995,7,5,2
12105,32,133,1995,18,8,10
12106,43,2,1995,1,0,1
12107,43,51,1995,15,10,5
12108,43,141,1995,17,4,13
12109,43,52,1995,0,0,0
12110,43,134,1995,15,6,9
12111,43,76,1995,0,0,0
12112,43,103,1995,9,3,6
12113,43,11,1995,2,2,0
12114,43,77,1995,0,0,0
12115,43,66,1995,62,33,29
12116,43,12,1995,3,2,1
12117,43,78,1995,1,1,0
12118,43,13,1995,1,0,1
12119,43,3,1995,0,0,0
12120,43,79,1995,1,0,1
12121,43,29,1995,1,0,1
12122,43,67,1995,56,30,26
12123,43,95,1995,1,1,0
12124,43,151,1995,0,0,0
12125,43,53,1995,14,6,8
12126,43,105,1995,20,13,7
12127,43,30,1995,46,25,21
12128,43,152,1995,0,0,0
12129,43,153,1995,28,15,13
12130,43,135,1995,2,0,2
12131,43,136,1995,0,0,0
12132,43,106,1995,34,14,20
12133,43,172,1995,118,63,55
12134,43,107,1995,42,24,18
12135,43,137,1995,0,0,0
12136,43,96,1995,5,2,3
12137,43,54,1995,9,4,5
12138,43,81,1995,11,5,6
12139,43,14,1995,2,1,1
12140,43,31,1995,64,38,26
12141,43,176,1995,0,0,0
12142,43,137,1995,2,0,2
12143,43,39,1995,2175,1211,964
12144,43,118,1995,0,0,0
12145,43,82,1995,1,0,1
12146,43,83,1995,4,3,1
12147,43,108,1995,10,6,4
12148,43,142,1995,12,3,9
12149,43,97,1995,1,1,0
12150,43,138,1995,1,1,0
12151,43,119,1995,1,0,1
12152,43,40,1995,11,7,4
12153,43,120,1995,22,11,11
12154,43,41,1995,273,164,109
12155,43,42,1995,97,68,29
12156,43,68,1995,196,101,95
12157,43,139,1995,0,0,0
12158,43,155,1995,4,2,2
12159,43,15,1995,3,2,1
12160,43,69,1995,922,621,301
12161,43,156,1995,15,6,9
12162,43,55,1995,0,0,0
12163,43,56,1995,8,3,5
12164,43,98,1995,21,9,12
12165,43,157,1995,5,2,3
12166,43,158,1995,0,0,0
12167,43,110,1995,10,6,4
12168,43,85,1995,1,1,0
12169,43,99,1995,11,2,9
12170,43,32,1995,49,29,20
12171,43,5,1995,105,60,45
12172,43,6,1995,16,4,12
12173,43,16,1995,9,3,6
12174,43,44,1995,68,32,36
12175,43,17,1995,20,7,13
12176,43,57,1995,73,32,41
12177,43,86,1995,7,4,3
12178,43,177,1995,31,21,10
12179,43,18,1995,6,4,2
12180,43,167,1995,1,1,0
12181,43,121,1995,17,10,7
12182,43,19,1995,1,0,1
12183,43,168,1995,1,1,0
12184,43,46,1995,10,3,7
12185,43,20,1995,17,5,12
12186,43,159,1995,0,0,0
12187,43,143,1995,0,0,0
12188,43,70,1995,0,0,0
12189,43,47,1995,16,7,9
12190,43,71,1995,64,32,32
12191,43,122,1995,1,0,1
12192,43,123,1995,1,0,1
12193,43,160,1995,0,0,0
12194,43,58,1995,1,1,0
12195,43,161,1995,0,0,0
12196,43,124,1995,5,3,2
12197,43,100,1995,24,17,7
12198,43,72,1995,1,1,0
12199,43,59,1995,0,0,0
12200,43,144,1995,53,16,37
12201,43,125,1995,6,4,2
12202,43,150,1995,15,7,8
12203,43,8,1995,12,3,9
12204,43,73,1995,133,77,56
12205,43,101,1995,2,2,0
12206,43,162,1995,18,6,12
12207,43,60,1995,9,4,5
12208,43,48,1995,760,432,328
12209,43,21,1995,0,0,0
12210,43,9,1995,10,4,6
12211,43,102,1995,2,1,1
12212,43,111,1995,2,1,1
12213,43,112,1995,30,18,12
12214,43,33,1995,878,489,389
12215,43,61,1995,71,26,45
12216,43,88,1995,1,0,1
12217,43,22,1995,2,2,0
12218,43,35,1995,34,10,24
12219,43,36,1995,273,155,118
12220,43,126,1995,1,0,1
12221,43,92,1995,0,0,0
12222,43,62,1995,0,0,0
12223,43,23,1995,2,2,0
12224,43,164,1995,5,2,3
12225,43,63,1995,463,202,261
12226,43,165,1995,8,3,5
12227,43,37,1995,2,2,0
12228,43,64,1995,10,4,6
12229,43,128,1995,1,1,0
12230,43,115,1995,64,41,23
12231,43,65,1995,130,51,79
12232,43,10,1995,93,63,30
12233,43,145,1995,0,0,0
12234,43,49,1995,1280,680,600
12235,43,74,1995,63,30,33
12236,43,25,1995,11,3,8
12237,43,169,1995,50,35,15
12238,43,166,1995,1,0,1
12239,43,93,1995,2,2,0
12240,43,146,1995,9,2,7
12241,43,26,1995,27,10,17
12242,43,170,1995,0,0,0
12243,43,130,1995,5,5,0
12244,43,38,1995,17,12,5
12245,43,27,1995,1,0,1
12246,43,50,1995,684,303,381
12247,43,131,1995,10,6,4
12248,43,114,1995,5,2,3
12249,43,171,1995,2,1,1
12250,43,1,1995,148,81,67
12251,43,28,1995,0,0,0
12252,43,132,1995,3,3,0
12253,43,133,1995,6,6,0
12254,5,2,1995,19916,9598,10318
12255,5,3,1995,4127135,1946520,2180615
12256,5,4,1995,9610,4742,4868
12257,5,172,1995,98000,47232,50768
12258,5,68,1995,3628,1949,1679
12259,5,69,1995,4140,2330,1810
12260,5,6,1995,2569,1323,1246
12261,5,16,1995,900,492,408
12262,5,177,1995,890,509,381
12263,5,167,1995,2052,1964,88
12264,5,121,1995,5541,2916,2625
12265,5,19,1995,12149,6292,5857
12266,5,7,1995,1027,215,812
12267,5,124,1995,1455,736,719
12268,5,8,1995,591200,324968,266232
12269,5,162,1995,1038,468,570
12270,5,9,1995,1637255,773528,863727
12271,5,61,1995,323,187,136
12272,5,23,1995,5767,2817,2950
12273,5,10,1995,235785,116605,119180
12274,5,26,1995,236,124,112
12275,5,36,1995,2547,1303,1244
12276,5,130,1995,1465,785,680
12277,5,27,1995,12301,6154,6147
12278,5,50,1995,5508,2894,2614
12279,5,1,1995,1762,1229,533
12280,5,132,1995,920,502,418
12281,6,2,1995,2660518,1188750,1471768
12282,6,11,1995,575,317,258
12283,6,12,1995,903,462,441
12284,6,16,1995,257645,127283,130362
12285,6,9,1995,8297,4090,4207
12286,6,26,1995,590,306,284
12287,6,170,1995,238,129,109
12288,16,2,1995,284,170,114
12289,16,119,1995,732,303,429
12290,16,5,1995,211,106,105
12291,16,6,1995,44953,19330,25623
12292,16,18,1995,9397,3610,5787
12293,16,19,1995,364,152,212
12294,16,20,1995,1383,744,639
12295,16,161,1995,182,60,122
12296,16,144,1995,532,259,273
12297,16,9,1995,619,212,407
12298,16,36,1995,248,100,148
12299,16,23,1995,612,225,387
12300,16,128,1995,377,136,241
12301,16,129,1995,268,46,222
12302,16,145,1995,3447,591,2856
12303,16,25,1995,5633,2692,2941
12304,16,27,1995,262,79,183
12305,16,146,1995,284,53,231
12306,16,26,1995,17439,7139,10300
12307,16,142,1995,13058,3210,9848
12308,16,28,1995,1819,485,1334
12309,44,2,1995,79,15,64
12310,44,51,1995,158,67,91
12311,44,141,1995,313,92,221
12312,44,52,1995,1,1,0
12313,44,134,1995,255,130,125
12314,44,75,1995,1,0,1
12315,44,76,1995,2,0,2
12316,44,103,1995,175,94,81
12317,44,11,1995,28,14,14
12318,44,77,1995,4,2,2
12319,44,66,1995,175,92,83
12320,44,12,1995,27,13,14
12321,44,78,1995,14,7,7
12322,44,13,1995,44,23,21
12323,44,3,1995,557,292,265
12324,44,79,1995,11,6,5
12325,44,29,1995,325,187,138
12326,44,67,1995,507,268,239
12327,44,95,1995,2,1,1
12328,44,151,1995,18,11,7
12329,44,4,1995,4,1,3
12330,44,53,1995,342,183,159
12331,44,147,1995,42,20,22
12332,44,105,1995,1341,703,638
12333,44,30,1995,494,270,224
12334,44,152,1995,5,2,3
12335,44,116,1995,25,13,12
12336,44,153,1995,2,0,2
12337,44,135,1995,185,109,76
12338,44,80,1995,13,8,5
12339,44,136,1995,5,2,3
12340,44,106,1995,75,45,30
12341,44,172,1995,3056,1600,1456
12342,44,173,1995,468,247,221
12343,44,137,1995,578,304,274
12344,44,96,1995,5,3,2
12345,44,54,1995,269,133,136
12346,44,81,1995,44,24,20
12347,44,14,1995,70,36,34
12348,44,31,1995,1437,754,683
12349,44,176,1995,70,43,27
12350,44,137,1995,27,15,12
12351,44,39,1995,359,167,192
12352,44,118,1995,1,0,1
12353,44,82,1995,1,0,1
12354,44,83,1995,5,2,3
12355,44,108,1995,21,15,6
12356,44,142,1995,284,92,192
12357,44,97,1995,14,9,5
12358,44,119,1995,20,8,12
12359,44,40,1995,674,355,319
12360,44,148,1995,11,7,4
12361,44,120,1995,82,46,36
12362,44,41,1995,2,1,1
12363,44,42,1995,266,139,127
12364,44,68,1995,3104,1951,1153
12365,44,139,1995,3,1,2
12366,44,155,1995,30,15,15
12367,44,15,1995,136,63,73
12368,44,69,1995,4291,2234,2057
12369,44,156,1995,268,151,117
12370,44,55,1995,20,11,9
12371,44,56,1995,160,65,95
12372,44,84,1995,8,3,5
12373,44,98,1995,66,36,30
12374,44,157,1995,27,12,15
12375,44,158,1995,1,0,1
12376,44,110,1995,16,10,6
12377,44,85,1995,3,2,1
12378,44,99,1995,6,4,2
12379,44,32,1995,906,475,431
12380,44,43,1995,20,11,9
12381,44,5,1995,2655,1390,1265
12382,44,6,1995,237,83,154
12383,44,16,1995,241,95,146
12384,44,17,1995,116,55,61
12385,44,57,1995,1977,822,1155
12386,44,86,1995,64,44,20
12387,44,177,1995,282,192,90
12388,44,18,1995,60,27,33
12389,44,167,1995,138,77,61
12390,44,121,1995,257,152,105
12391,44,19,1995,107,44,63
12392,44,168,1995,17,10,7
12393,44,46,1995,3814,1996,1818
12394,44,20,1995,71,31,40
12395,44,149,1995,20,12,8
12396,44,159,1995,57,26,31
12397,44,143,1995,233,102,131
12398,44,70,1995,1,0,1
12399,44,47,1995,6758,3538,3220
12400,44,71,1995,36,21,15
12401,44,122,1995,6,4,2
12402,44,123,1995,40,20,20
12403,44,7,1995,2,1,1
12404,44,160,1995,16,9,7
12405,44,58,1995,81,44,37
12406,44,161,1995,4,2,2
12407,44,124,1995,206,91,115
12408,44,100,1995,162,115,47
12409,44,72,1995,4,1,3
12410,44,87,1995,1,0,1
12411,44,144,1995,145,46,99
12412,44,125,1995,21,11,10
12413,44,150,1995,20,13,7
12414,44,8,1995,73,24,49
12415,44,73,1995,1728,860,868
12416,44,101,1995,9,5,4
12417,44,162,1995,4542,2382,2160
12418,44,60,1995,349,152,197
12419,44,48,1995,162,88,74
12420,44,21,1995,26,13,13
12421,44,9,1995,1594,834,760
12422,44,102,1995,9,6,3
12423,44,111,1995,14,10,4
12424,44,112,1995,67,46,21
12425,44,33,1995,17186,9003,8183
12426,44,61,1995,432,226,206
12427,44,22,1995,18,9,9
12428,44,35,1995,2334,1226,1108
12429,44,36,1995,1244,654,590
12430,44,126,1995,42,26,16
12431,44,90,1995,1,0,1
12432,44,91,1995,4,1,3
12433,44,92,1995,2,0,2
12434,44,23,1995,229,115,114
12435,44,164,1995,12,6,6
12436,44,127,1995,5,3,2
12437,44,165,1995,105,44,61
12438,44,37,1995,2234,1169,1065
12439,44,64,1995,38,21,17
12440,44,128,1995,282,136,146
12441,44,115,1995,2196,1149,1047
12442,44,65,1995,1765,923,842
12443,44,10,1995,127,54,73
12444,44,145,1995,314,116,198
12445,44,113,1995,6,4,2
12446,44,49,1995,515,270,245
12447,44,74,1995,294,182,112
12448,44,25,1995,61,20,41
12449,44,169,1995,11,7,4
12450,44,166,1995,61,26,35
12451,44,93,1995,60,38,22
12452,44,146,1995,53,11,42
12453,44,26,1995,260,64,196
12454,44,170,1995,3,2,1
12455,44,94,1995,1,0,1
12456,44,130,1995,80,45,35
12457,44,38,1995,925,487,438
12458,44,27,1995,107,54,53
12459,44,50,1995,124169,65037,59132
12460,44,131,1995,67,38,29
12461,44,114,1995,30,17,13
12462,44,171,1995,49,29,20
12463,44,1,1995,338,217,121
12464,44,28,1995,16,7,9
12465,44,132,1995,181,98,83
12466,44,133,1995,653,342,311
12467,45,44,1995,1700,983,717
12468,45,115,1995,345,181,164
12469,45,50,1995,32475,16929,15546
12470,17,2,1995,2836,1514,1322
12471,17,141,1995,25514,13717,11797
12472,17,12,1995,15271,8091,7180
12473,17,103,1995,29503,15500,14003
12474,17,66,1995,6471,3459,3012
12475,17,67,1995,4294,2392,1902
12476,17,105,1995,6759,3844,2915
12477,17,30,1995,19887,10936,8951
12478,17,29,1995,32968,17781,15187
12479,17,106,1995,2900,1558,1342
12480,17,172,1995,1002,553,449
12481,17,107,1995,1520,892,628
12482,17,39,1995,1261,795,466
12483,17,120,1995,50287,25197,25090
12484,17,42,1995,516,376,140
12485,17,68,1995,23373,12723,10650
12486,17,15,1995,24200,12533,11667
12487,17,69,1995,27508,15512,11996
12488,17,56,1995,1723,939,784
12489,17,32,1995,15907,8582,7325
12490,17,5,1995,18225,9513,8712
12491,17,6,1995,51220,26257,24963
12492,17,16,1995,77265,39505,37760
12493,17,57,1995,4981,2687,2294
12494,17,167,1995,8001,4394,3607
12495,17,168,1995,1407,785,622
12496,17,20,1995,4570,2750,1820
12497,17,46,1995,8948,4916,4032
12498,17,143,1995,19857,10451,9406
12499,17,47,1995,12500,6864,5636
12500,17,100,1995,1721,920,801
12501,17,144,1995,166657,86854,79803
12502,17,73,1995,4717,2710,2007
12503,17,112,1995,1021,587,434
12504,17,33,1995,93907,51471,42436
12505,17,35,1995,131109,72420,58689
12506,17,36,1995,173915,96053,77862
12507,17,115,1995,9581,5080,4501
12508,17,65,1995,3065,1745,1320
12509,17,49,1995,1149,683,466
12510,17,74,1995,3030,1762,1268
12511,17,25,1995,11277,6020,5257
12512,17,169,1995,4238,2149,2089
12513,17,146,1995,39320,20798,18522
12514,17,26,1995,32492,16874,15618
12515,17,170,1995,871,467,404
12516,17,38,1995,170963,93711,77252
12517,17,142,1995,22829,12018,10811
12518,17,50,1995,17066,9129,7937
12519,17,114,1995,4936,2634,2302
12520,17,171,1995,31147,16248,14899
12521,17,28,1995,37172,19873,17299
12522,57,2,1995,236,49,187
12523,57,51,1995,159672,70753,88919
12524,57,141,1995,10991,3490,7501
12525,57,52,1995,11,7,4
12526,57,134,1995,1024,543,481
12527,57,76,1995,6,5,1
12528,57,103,1995,25795,16699,9096
12529,57,11,1995,152,96,56
12530,57,66,1995,13068,10400,2668
12531,57,12,1995,52,32,20
12532,57,78,1995,17,12,5
12533,57,13,1995,2,2,0
12534,57,3,1995,14361,4189,10172
12535,57,79,1995,13,6,7
12536,57,29,1995,884,778,106
12537,57,67,1995,11695,8243,3452
12538,57,95,1995,10,5,5
12539,57,151,1995,656,304,352
12540,57,4,1995,24,10,14
12541,57,53,1995,15437,7930,7507
12542,57,147,1995,6,3,3
12543,57,105,1995,27162,22285,4877
12544,57,30,1995,5423,3466,1957
12545,57,152,1995,2624,1108,1516
12546,57,116,1995,327,217,110
12547,57,153,1995,5918,5179,739
12548,57,135,1995,1861,940,921
12549,57,136,1995,71,40,31
12550,57,106,1995,6919,4544,2375
12551,57,172,1995,53519,28109,25410
12552,57,107,1995,12313,9861,2452
12553,57,117,1995,7,5,2
12554,57,137,1995,1898,994,904
12555,57,96,1995,301,230,71
12556,57,54,1995,17882,10486,7396
12557,57,81,1995,6552,5642,910
12558,57,14,1995,119,69,50
12559,57,31,1995,3306,2927,379
12560,57,176,1995,21,15,6
12561,57,137,1995,1118,612,506
12562,57,39,1995,3670,2743,927
12563,57,118,1995,12,7,5
12564,57,82,1995,22,15,7
12565,57,83,1995,13427,10136,3291
12566,57,108,1995,11373,7673,3700
12567,57,142,1995,41691,14584,27107
12568,57,97,1995,3013,2153,860
12569,57,138,1995,33,13,20
12570,57,119,1995,4098,3034,1064
12571,57,40,1995,212,192,20
12572,57,148,1995,5,4,1
12573,57,120,1995,11136,8490,2646
12574,57,42,1995,1336,1135,201
12575,57,68,1995,56690,41999,14691
12576,57,139,1995,75,38,37
12577,57,155,1995,363,129,234
12578,57,15,1995,164,110,54
12579,57,69,1995,75903,53892,22011
12580,57,156,1995,29731,12914,16817
12581,57,56,1995,14957,6742,8215
12582,57,84,1995,5,3,2
12583,57,98,1995,353,274,79
12584,57,157,1995,690,269,421
12585,57,158,1995,152,68,84
12586,57,110,1995,21,19,2
12587,57,85,1995,133,99,34
12588,57,99,1995,319,252,67
12589,57,32,1995,2875,2464,411
12590,57,43,1995,141,101,40
12591,57,5,1995,23261,10952,12309
12592,57,6,1995,14034,6065,7969
12593,57,16,1995,837,293,544
12594,57,44,1995,3211,2287,924
12595,57,17,1995,4920,2094,2826
12596,57,86,1995,106,73,33
12597,57,177,1995,10155,6735,3420
12598,57,18,1995,3989,907,3082
12599,57,167,1995,296,266,30
12600,57,121,1995,592,396,196
12601,57,19,1995,78,36,42
12602,57,168,1995,41,35,6
12603,57,46,1995,337,316,21
12604,57,20,1995,6639,2380,4259
12605,57,149,1995,3,1,2
12606,57,159,1995,108,55,53
12607,57,143,1995,4411,2310,2101
12608,57,70,1995,21,13,8
12609,57,47,1995,298,272,26
12610,57,71,1995,779,520,259
12611,57,122,1995,645,520,125
12612,57,123,1995,29,19,10
12613,57,7,1995,6,2,4
12614,57,160,1995,272,133,139
12615,57,58,1995,697,566,131
12616,57,161,1995,216,77,139
12617,57,124,1995,10066,5909,4157
12618,57,100,1995,4177,3475,702
12619,57,72,1995,179,119,60
12620,57,59,1995,3757,1931,1826
12621,57,144,1995,227427,79705,147722
12622,57,125,1995,186,136,50
12623,57,150,1995,24,19,5
12624,57,8,1995,103,49,54
12625,57,73,1995,13450,9333,4117
12626,57,101,1995,257,179,78
12627,57,162,1995,19320,11194,8126
12628,57,60,1995,58600,29306,29294
12629,57,48,1995,567,421,146
12630,57,21,1995,39,25,14
12631,57,9,1995,15787,4429,11358
12632,57,102,1995,362,285,77
12633,57,111,1995,315,258,57
12634,57,112,1995,29771,20423,9348
12635,57,33,1995,33838,25831,8007
12636,57,61,1995,6018,4575,1443
12637,57,22,1995,1,0,1
12638,57,35,1995,79401,48157,31244
12639,57,36,1995,11088,9807,1281
12640,57,126,1995,379,220,159
12641,57,90,1995,6,5,1
12642,57,91,1995,6,5,1
12643,57,92,1995,3,2,1
12644,57,62,1995,2080,1153,927
12645,57,140,1995,26,20,6
12646,57,23,1995,55,29,26
12647,57,164,1995,47201,5383,41818
12648,57,63,1995,48026,25380,22646
12649,57,127,1995,520,413,107
12650,57,165,1995,455,245,210
12651,57,37,1995,1748,1436,312
12652,57,64,1995,3048,2007,1041
12653,57,128,1995,9103,6146,2957
12654,57,115,1995,824,551,273
12655,57,129,1995,0,0,0
12656,57,65,1995,23051,19602,3449
12657,57,10,1995,30976,14319,16657
12658,57,145,1995,430,149,281
12659,57,113,1995,17,12,5
12660,57,49,1995,5003,3885,1118
12661,57,74,1995,32837,22267,10570
12662,57,25,1995,1963,864,1099
12663,57,169,1995,19,11,8
12664,57,166,1995,741,367,374
12665,57,93,1995,52,40,12
12666,57,146,1995,73188,23363,49825
12667,57,26,1995,8597,3988,4609
12668,57,170,1995,26,23,3
12669,57,130,1995,208,130,78
12670,57,38,1995,6959,5835,1124
12671,57,27,1995,11,7,4
12672,57,50,1995,45568,31017,14551
12673,57,131,1995,461,293,168
12674,57,114,1995,1637,1064,573
12675,57,171,1995,676,605,71
12676,57,1,1995,1327,809,518
12677,57,28,1995,134,73,61
12678,57,132,1995,90,52,38
12679,57,133,1995,91,64,27
12680,86,76,1995,143,73,70
12681,86,78,1995,616,314,302
12682,86,79,1995,497,254,243
12683,86,95,1995,7,4,3
12684,86,96,1995,101,59,42
12685,86,81,1995,1837,946,891
12686,86,82,1995,128,65,63
12687,86,97,1995,137,79,58
12688,86,84,1995,192,98,94
12689,86,98,1995,311,179,132
12690,86,99,1995,165,95,70
12691,86,5,1995,962,386,576
12692,86,101,1995,128,73,55
12693,86,102,1995,77,44,33
12694,86,90,1995,89,46,43
12695,86,91,1995,305,155,150
12696,86,92,1995,209,107,102
12697,86,93,1995,2126,1091,1035
12698,86,50,1995,5286,2747,2539
12699,177,103,1995,2950,1534,1416
12700,177,66,1995,390,203,187
12701,177,3,1995,5003,2601,2402
12702,177,67,1995,433,225,208
12703,177,105,1995,178865,93012,85853
12704,177,172,1995,222311,112261,110050
12705,177,39,1995,577,300,277
12706,177,142,1995,645,336,309
12707,177,42,1995,442,230,212
12708,177,68,1995,3824,1989,1835
12709,177,69,1995,4017,2089,1928
12710,177,156,1995,1187,617,570
12711,177,5,1995,5584,2904,2680
12712,177,6,1995,8764,4558,4206
12713,177,44,1995,869,452,417
12714,177,57,1995,1279,665,614
12715,177,100,1995,1255,653,602
12716,177,73,1995,834,433,401
12717,177,162,1995,1269,661,608
12718,177,48,1995,379,197,182
12719,177,9,1995,4818,2505,2313
12720,177,112,1995,36768,19120,17648
12721,177,33,1995,585,304,281
12722,177,61,1995,345,179,166
12723,177,36,1995,2199,1144,1055
12724,177,65,1995,1146,596,550
12725,177,10,1995,2832,1473,1359
12726,177,49,1995,860,447,413
12727,177,74,1995,955,497,458
12728,177,50,1995,12657,6582,6075
12729,177,1,1995,9224,4797,4427
12730,18,2,1995,75,31,44
12731,18,141,1995,320,204,116
12732,18,66,1995,110,53,57
12733,18,13,1995,330,144,186
12734,18,3,1995,4677,1348,3329
12735,18,11,1995,29,19,10
12736,18,67,1995,61,32,29
12737,18,53,1995,197,105,92
12738,18,105,1995,115,65,50
12739,18,30,1995,77,41,36
12740,18,10,1995,13104,12349,755
12741,18,136,1995,18,4,14
12742,18,172,1995,5718,5072,646
12743,18,107,1995,23,15,8
12744,18,54,1995,25,20,5
12745,18,14,1995,87,47,40
12746,18,31,1995,24,15,9
12747,18,39,1995,56,27,29
12748,18,120,1995,57,48,9
12749,18,119,1995,115,58,57
12750,18,68,1995,388,181,207
12751,18,69,1995,642,311,331
12752,18,156,1995,39,13,26
12753,18,56,1995,96,61,35
12754,18,173,1995,24,10,14
12755,18,32,1995,374,220,154
12756,18,5,1995,2572,409,2163
12757,18,6,1995,117,65,52
12758,18,16,1995,40831,16281,24550
12759,18,44,1995,70,48,22
12760,18,17,1995,956,322,634
12761,18,57,1995,447,242,205
12762,18,177,1995,135,50,85
12763,18,167,1995,14,10,4
12764,18,176,1995,71,23,48
12765,18,19,1995,573,202,371
12766,18,20,1995,2625,1527,1098
12767,18,143,1995,761,331,430
12768,18,161,1995,87,16,71
12769,18,144,1995,563,414,149
12770,18,21,1995,657,326,331
12771,18,8,1995,115,48,67
12772,18,73,1995,195,101,94
12773,18,162,1995,28,10,18
12774,18,48,1995,31,16,15
12775,18,9,1995,4558,2037,2521
12776,18,33,1995,93,58,35
12777,18,22,1995,187,55,132
12778,18,35,1995,320,276,44
12779,18,36,1995,653,492,161
12780,18,23,1995,4802,1838,2964
12781,18,63,1995,54,45,9
12782,18,37,1995,20,14,6
12783,18,128,1995,58,24,34
12784,18,115,1995,48,18,30
12785,18,65,1995,326,198,128
12786,18,129,1995,285,86,199
12787,18,145,1995,2309,697,1612
12788,18,49,1995,96,53,43
12789,18,74,1995,148,76,72
12790,18,25,1995,54585,24122,30463
12791,18,27,1995,205,100,105
12792,18,146,1995,269,136,133
12793,18,26,1995,1101,337,764
12794,18,38,1995,263,227,36
12795,18,60,1995,158,117,41
12796,18,142,1995,229396,66825,162571
12797,18,50,1995,724,320,404
12798,18,28,1995,2664,845,1819
12799,167,12,1995,35661,16515,19146
12800,167,11,1995,7156,3033,4123
12801,167,29,1995,61663,32508,29155
12802,167,172,1995,1142,531,611
12803,167,40,1995,588,332,256
12804,167,15,1995,3089,1201,1888
12805,167,176,1995,32525,16944,15581
12806,167,168,1995,5276,2756,2520
12807,167,46,1995,588,298,290
12808,167,47,1995,3785,1728,2057
12809,167,36,1995,2253497,1232743,1020754
12810,167,169,1995,8351,4046,4305
12811,167,26,1995,27068,13654,13414
12812,167,170,1995,555,232,323
12813,167,38,1995,302168,163171,138997
12814,167,171,1995,150058,75314,74744
12815,121,116,1995,147,68,79
12816,121,137,1995,391,180,211
12817,121,120,1995,29521,12696,16825
12818,121,119,1995,66,32,34
12819,121,125,1995,980,445,535
12820,121,150,1995,112,51,61
12821,121,126,1995,5861,2754,3107
12822,121,128,1995,172164,80916,91248
12823,121,115,1995,185,84,101
12824,121,129,1995,53996,25412,28584
12825,121,145,1995,41215,19370,21845
12826,121,130,1995,134005,71682,62323
12827,121,131,1995,73119,34282,38837
12828,19,2,1995,1068,387,681
12829,19,13,1995,231,183,48
12830,19,3,1995,110044,18355,91689
12831,19,10,1995,23883,18736,5147
12832,19,136,1995,697,252,445
12833,19,120,1995,1776,644,1132
12834,19,119,1995,2522,915,1607
12835,19,68,1995,505,269,236
12836,19,5,1995,332377,99990,232387
12837,19,18,1995,18028,8606,9422
12838,19,20,1995,3616,1312,2304
12839,19,144,1995,1277,463,814
12840,19,8,1995,1134,411,723
12841,19,73,1995,729,528,201
12842,19,162,1995,929,336,593
12843,19,9,1995,112925,33568,79357
12844,19,22,1995,60,50,10
12845,19,23,1995,466,207,259
12846,19,128,1995,1691,613,1078
12847,19,129,1995,0,0,0
12848,19,145,1995,24089,11098,12991
12849,19,25,1995,8831,3204,5627
12850,19,27,1995,5852,3928,1924
12851,19,146,1995,769,279,490
12852,19,26,1995,6416,2328,4088
12853,19,142,1995,107006,47959,59047
12854,19,50,1995,6908,3561,3347
12855,19,28,1995,29202,10597,18605
12856,168,12,1995,11702,6207,5495
12857,168,11,1995,5997,3199,2798
12858,168,29,1995,24823,14837,9986
12859,168,172,1995,612,334,278
12860,168,40,1995,1307,753,554
12861,168,42,1995,303,121,182
12862,168,15,1995,8367,4525,3842
12863,168,69,1995,10548,6054,4494
12864,168,167,1995,31791,18694,13097
12865,168,176,1995,1058,592,466
12866,168,46,1995,2122,1219,903
12867,168,47,1995,5736,3300,2436
12868,168,33,1995,6242,3898,2344
12869,168,35,1995,718,394,324
12870,168,36,1995,284678,166787,117891
12871,168,1,1995,278,140,138
12872,168,169,1995,13311,7345,5966
12873,168,26,1995,928,499,429
12874,168,170,1995,2427,1380,1047
12875,168,38,1995,69408,40777,28631
12876,168,171,1995,16955,9527,7428
12877,46,2,1995,22,7,15
12878,46,51,1995,6,3,3
12879,46,141,1995,9,1,8
12880,46,52,1995,0,0,0
12881,46,134,1995,1,1,0
12882,46,75,1995,6,2,4
12883,46,76,1995,0,0,0
12884,46,103,1995,14,9,5
12885,46,11,1995,1312,517,795
12886,46,77,1995,1,0,1
12887,46,66,1995,77,35,42
12888,46,12,1995,2254,819,1435
12889,46,13,1995,0,0,0
12890,46,3,1995,4,0,4
12891,46,79,1995,2,1,1
12892,46,29,1995,69060,41211,27849
12893,46,67,1995,21,8,13
12894,46,151,1995,0,0,0
12895,46,53,1995,2,0,2
12896,46,147,1995,0,0,0
12897,46,105,1995,12,6,6
12898,46,30,1995,220,111,109
12899,46,116,1995,1,0,1
12900,46,153,1995,1,0,1
12901,46,135,1995,1,0,1
12902,46,106,1995,1,0,1
12903,46,172,1995,175,82,93
12904,46,107,1995,3,3,0
12905,46,137,1995,1,0,1
12906,46,96,1995,0,0,0
12907,46,54,1995,6,1,5
12908,46,81,1995,45,18,27
12909,46,14,1995,2,1,1
12910,46,31,1995,112,71,41
12911,46,176,1995,109,59,50
12912,46,137,1995,0,0,0
12913,46,39,1995,93,26,67
12914,46,83,1995,0,0,0
12915,46,108,1995,0,0,0
12916,46,142,1995,8,1,7
12917,46,119,1995,0,0,0
12918,46,40,1995,2872,1573,1299
12919,46,41,1995,0,0,0
12920,46,42,1995,684,239,445
12921,46,68,1995,77,38,39
12922,46,139,1995,0,0,0
12923,46,155,1995,0,0,0
12924,46,15,1995,1368,578,790
12925,46,69,1995,3084,1229,1855
12926,46,156,1995,0,0,0
12927,46,56,1995,169,92,77
12928,46,98,1995,0,0,0
12929,46,32,1995,289,144,145
12930,46,43,1995,6,1,5
12931,46,5,1995,54,13,41
12932,46,6,1995,22,6,16
12933,46,16,1995,4,1,3
12934,46,44,1995,21,14,7
12935,46,17,1995,32,11,21
12936,46,57,1995,36,14,22
12937,46,86,1995,0,0,0
12938,46,177,1995,6,4,2
12939,46,18,1995,5,1,4
12940,46,167,1995,4627,2422,2205
12941,46,121,1995,0,0,0
12942,46,19,1995,1,1,0
12943,46,168,1995,913,503,410
12944,46,20,1995,42,14,28
12945,46,143,1995,2,1,1
12946,46,70,1995,0,0,0
12947,46,47,1995,22699,12845,9854
12948,46,71,1995,1,1,0
12949,46,122,1995,1,0,1
12950,46,123,1995,1,1,0
12951,46,160,1995,2,0,2
12952,46,58,1995,2,1,1
12953,46,161,1995,0,0,0
12954,46,124,1995,0,0,0
12955,46,100,1995,9,4,5
12956,46,72,1995,0,0,0
12957,46,59,1995,0,0,0
12958,46,144,1995,4,2,2
12959,46,125,1995,0,0,0
12960,46,150,1995,0,0,0
12961,46,8,1995,1,1,0
12962,46,73,1995,29,8,21
12963,46,101,1995,1,1,0
12964,46,162,1995,6,1,5
12965,46,60,1995,0,0,0
12966,46,48,1995,37,15,22
12967,46,9,1995,25,2,23
12968,46,111,1995,1,1,0
12969,46,112,1995,5,1,4
12970,46,33,1995,16038,9820,6218
12971,46,61,1995,1,0,1
12972,46,22,1995,0,0,0
12973,46,35,1995,1815,958,857
12974,46,36,1995,354000,202539,151461
12975,46,126,1995,1,0,1
12976,46,23,1995,0,0,0
12977,46,63,1995,8,4,4
12978,46,165,1995,2,0,2
12979,46,37,1995,19,11,8
12980,46,64,1995,3,2,1
12981,46,128,1995,0,0,0
12982,46,115,1995,2,1,1
12983,46,129,1995,1,1,0
12984,46,65,1995,17,8,9
12985,46,10,1995,21,9,12
12986,46,145,1995,1,0,1
12987,46,49,1995,167,54,113
12988,46,74,1995,17,6,11
12989,46,25,1995,7,1,6
12990,46,169,1995,434,220,214
12991,46,166,1995,1,0,1
12992,46,93,1995,0,0,0
12993,46,146,1995,0,0,0
12994,46,26,1995,18,4,14
12995,46,170,1995,475,246,229
12996,46,130,1995,1,1,0
12997,46,38,1995,49867,25060,24807
12998,46,27,1995,1,0,1
12999,46,50,1995,167,49,118
13000,46,131,1995,0,0,0
13001,46,114,1995,4,2,2
13002,46,171,1995,1614,894,720
13003,46,1,1995,5,1,4
13004,46,28,1995,1,0,1
13005,46,132,1995,0,0,0
13006,46,133,1995,1,0,1
13007,20,13,1995,150,70,80
13008,20,3,1995,2124,664,1460
13009,20,10,1995,5965,5920,45
13010,20,172,1995,2596,2519,77
13011,20,68,1995,177,88,89
13012,20,69,1995,292,151,141
13013,20,32,1995,170,109,61
13014,20,5,1995,1169,198,971
13015,20,16,1995,18572,7887,10685
13016,20,17,1995,434,160,274
13017,20,18,1995,1196,723,473
13018,20,19,1995,260,98,162
13019,20,143,1995,345,161,184
13020,20,144,1995,256,200,56
13021,20,21,1995,299,157,142
13022,20,9,1995,2077,963,1114
13023,20,36,1995,297,235,62
13024,20,23,1995,2185,880,1305
13025,20,129,1995,129,42,87
13026,20,145,1995,1051,338,713
13027,20,25,1995,24856,11534,13322
13028,20,26,1995,501,161,340
13029,20,38,1995,120,112,8
13030,20,142,1995,104377,32203,72174
13031,20,50,1995,329,155,174
13032,20,28,1995,1213,406,807
13033,149,147,1995,104,56,48
13034,149,172,1995,140,60,80
13035,149,156,1995,105,35,70
13036,149,5,1995,266,118,148
13037,149,123,1995,44,17,27
13038,149,125,1995,28,9,19
13039,149,150,1995,4,1,3
13040,149,9,1995,266,118,148
13041,149,115,1995,2528,1303,1225
13042,149,133,1995,72,35,37
13043,149,148,1995,44,23,21
13044,149,130,1995,160,72,88
13045,149,131,1995,100,51,49
13046,149,132,1995,72,35,37
13047,159,151,1995,61,25,36
13048,159,68,1995,289,139,150
13049,159,155,1995,650,272,378
13050,159,69,1995,906,449,457
13051,159,156,1995,9723,4504,5219
13052,159,157,1995,32238,13021,19217
13053,159,5,1995,756,280,476
13054,159,57,1995,246,100,146
13055,159,20,1995,4133,1679,2454
13056,159,160,1995,1924,653,1271
13057,159,73,1995,291,139,152
13058,159,162,1995,2337,909,1428
13059,159,158,1995,2211,1119,1092
13060,159,164,1995,237,81,156
13061,159,165,1995,124102,60159,63943
13062,159,65,1995,279,128,151
13063,159,49,1995,1094,531,563
13064,159,74,1995,144,65,79
13065,159,166,1995,244,103,141
13066,159,50,1995,1119,537,582
13067,159,152,1995,379,151,228
13068,143,2,1995,452,101,351
13069,143,51,1995,266,95,171
13070,143,141,1995,2079,1200,879
13071,143,66,1995,1288,707,581
13072,143,13,1995,894,429,465
13073,143,3,1995,613,59,554
13074,143,11,1995,346,206,140
13075,143,67,1995,1197,598,599
13076,143,53,1995,153,62,91
13077,143,105,1995,286,162,124
13078,143,29,1995,625,336,289
13079,143,10,1995,486,202,284
13080,143,136,1995,744,250,494
13081,143,172,1995,1800,507,1293
13082,143,117,1995,2178,335,1843
13083,143,137,1995,183,49,134
13084,143,137,1995,299,97,202
13085,143,39,1995,675,309,366
13086,143,97,1995,485,246,239
13087,143,120,1995,1470,781,689
13088,143,119,1995,1230,535,695
13089,143,42,1995,569,303,266
13090,143,68,1995,6208,2813,3395
13091,143,118,1995,863,301,562
13092,143,69,1995,16289,7540,8749
13093,143,156,1995,526,119,407
13094,143,56,1995,2804,1538,1266
13095,143,32,1995,297,164,133
13096,143,5,1995,2902,936,1966
13097,143,6,1995,340,133,207
13098,143,16,1995,26910,11052,15858
13099,143,57,1995,9034,4153,4881
13100,143,177,1995,2428,1164,1264
13101,143,167,1995,492,201,291
13102,143,18,1995,12240,4947,7293
13103,143,121,1995,307,92,215
13104,143,19,1995,6919,2296,4623
13105,143,20,1995,7318,3711,3607
13106,143,160,1995,464,100,364
13107,143,161,1995,345,87,258
13108,143,72,1995,187,86,101
13109,143,144,1995,2534,1648,886
13110,143,21,1995,1236,389,847
13111,143,73,1995,2158,1068,1090
13112,143,162,1995,1870,454,1416
13113,143,48,1995,271,113,158
13114,143,9,1995,1445,441,1004
13115,143,33,1995,824,403,421
13116,143,158,1995,213,4,209
13117,143,22,1995,921,323,598
13118,143,35,1995,537,290,247
13119,143,36,1995,15828,9861,5967
13120,143,23,1995,19379,6197,13182
13121,143,164,1995,952,172,780
13122,143,165,1995,144,72,72
13123,143,128,1995,40088,13935,26153
13124,143,115,1995,505,199,306
13125,143,65,1995,900,420,480
13126,143,129,1995,3005,1307,1698
13127,143,145,1995,24407,10616,13791
13128,143,49,1995,779,327,452
13129,143,74,1995,2854,1371,1483
13130,143,25,1995,17576,7080,10496
13131,143,169,1995,313,76,237
13132,143,27,1995,1669,606,1063
13133,143,146,1995,1826,881,945
13134,143,26,1995,2014,531,1483
13135,143,170,1995,115,26,89
13136,143,38,1995,413,230,183
13137,143,142,1995,11822,4614,7208
13138,143,50,1995,6959,3054,3905
13139,143,131,1995,317,68,249
13140,143,171,1995,257,47,210
13141,143,28,1995,13236,4803,8433
13142,70,2,1995,0,0,0
13143,70,51,1995,0,0,0
13144,70,141,1995,0,0,0
13145,70,52,1995,0,0,0
13146,70,134,1995,0,0,0
13147,70,103,1995,0,0,0
13148,70,11,1995,0,0,0
13149,70,66,1995,2334,1260,1074
13150,70,12,1995,0,0,0
13151,70,78,1995,0,0,0
13152,70,3,1995,0,0,0
13153,70,29,1995,0,0,0
13154,70,67,1995,11,4,7
13155,70,53,1995,361,192,169
13156,70,105,1995,50,35,15
13157,70,30,1995,21,0,21
13158,70,152,1995,0,0,0
13159,70,135,1995,0,0,0
13160,70,106,1995,0,0,0
13161,70,172,1995,40,19,21
13162,70,107,1995,0,0,0
13163,70,96,1995,0,0,0
13164,70,54,1995,135,73,62
13165,70,81,1995,0,0,0
13166,70,31,1995,11,0,11
13167,70,137,1995,0,0,0
13168,70,39,1995,19,4,15
13169,70,83,1995,1,0,1
13170,70,108,1995,0,0,0
13171,70,142,1995,0,0,0
13172,70,97,1995,0,0,0
13173,70,119,1995,0,0,0
13174,70,40,1995,15,0,15
13175,70,120,1995,0,0,0
13176,70,42,1995,1,0,1
13177,70,68,1995,70,34,36
13178,70,155,1995,0,0,0
13179,70,15,1995,0,0,0
13180,70,69,1995,1244,601,643
13181,70,56,1995,94,48,46
13182,70,98,1995,0,0,0
13183,70,157,1995,0,0,0
13184,70,85,1995,0,0,0
13185,70,99,1995,0,0,0
13186,70,32,1995,7,0,7
13187,70,43,1995,1,1,0
13188,70,5,1995,0,0,0
13189,70,6,1995,0,0,0
13190,70,16,1995,0,0,0
13191,70,44,1995,5,2,3
13192,70,17,1995,0,0,0
13193,70,57,1995,1148,454,694
13194,70,86,1995,0,0,0
13195,70,177,1995,0,0,0
13196,70,18,1995,0,0,0
13197,70,167,1995,0,0,0
13198,70,121,1995,0,0,0
13199,70,19,1995,0,0,0
13200,70,168,1995,0,0,0
13201,70,46,1995,0,0,0
13202,70,143,1995,0,0,0
13203,70,47,1995,0,0,0
13204,70,71,1995,7,2,5
13205,70,122,1995,0,0,0
13206,70,7,1995,0,0,0
13207,70,58,1995,0,0,0
13208,70,124,1995,0,0,0
13209,70,100,1995,0,0,0
13210,70,72,1995,0,0,0
13211,70,59,1995,94,0,94
13212,70,144,1995,0,0,0
13213,70,125,1995,0,0,0
13214,70,8,1995,0,0,0
13215,70,73,1995,51,25,26
13216,70,101,1995,0,0,0
13217,70,162,1995,0,0,0
13218,70,60,1995,529,238,291
13219,70,48,1995,9,5,4
13220,70,9,1995,0,0,0
13221,70,102,1995,0,0,0
13222,70,111,1995,0,0,0
13223,70,112,1995,0,0,0
13224,70,33,1995,13,0,13
13225,70,61,1995,390,194,196
13226,70,35,1995,5,4,1
13227,70,36,1995,13,10,3
13228,70,91,1995,0,0,0
13229,70,164,1995,0,0,0
13230,70,63,1995,461,0,461
13231,70,127,1995,0,0,0
13232,70,37,1995,21,13,8
13233,70,64,1995,63,41,22
13234,70,128,1995,0,0,0
13235,70,115,1995,0,0,0
13236,70,65,1995,391,186,205
13237,70,10,1995,0,0,0
13238,70,49,1995,23,12,11
13239,70,74,1995,4531,2225,2306
13240,70,25,1995,0,0,0
13241,70,93,1995,0,0,0
13242,70,146,1995,0,0,0
13243,70,26,1995,997,482,515
13244,70,130,1995,0,0,0
13245,70,38,1995,6,5,1
13246,70,27,1995,0,0,0
13247,70,50,1995,37,12,25
13248,70,131,1995,0,0,0
13249,70,114,1995,0,0,0
13250,70,171,1995,0,0,0
13251,70,1,1995,0,0,0
13252,70,132,1995,0,0,0
13253,70,133,1995,0,0,0
13254,47,2,1995,45,16,29
13255,47,51,1995,0,0,0
13256,47,141,1995,0,0,0
13257,47,134,1995,0,0,0
13258,47,103,1995,93,43,50
13259,47,11,1995,870,269,601
13260,47,77,1995,0,0,0
13261,47,66,1995,53,28,25
13262,47,12,1995,1711,533,1178
13263,47,78,1995,0,0,0
13264,47,13,1995,0,0,0
13265,47,3,1995,0,0,0
13266,47,29,1995,71602,40433,31169
13267,47,67,1995,34,10,24
13268,47,95,1995,0,0,0
13269,47,151,1995,0,0,0
13270,47,53,1995,0,0,0
13271,47,105,1995,84,45,39
13272,47,30,1995,37,6,31
13273,47,135,1995,0,0,0
13274,47,106,1995,0,0,0
13275,47,172,1995,175,72,103
13276,47,107,1995,0,0,0
13277,47,137,1995,0,0,0
13278,47,54,1995,0,0,0
13279,47,81,1995,0,0,0
13280,47,14,1995,4,4,0
13281,47,31,1995,74,37,37
13282,47,176,1995,0,0,0
13283,47,137,1995,0,0,0
13284,47,39,1995,112,31,81
13285,47,82,1995,0,0,0
13286,47,108,1995,0,0,0
13287,47,142,1995,4,1,3
13288,47,119,1995,0,0,0
13289,47,40,1995,1414,679,735
13290,47,120,1995,0,0,0
13291,47,42,1995,83,34,49
13292,47,68,1995,241,133,108
13293,47,155,1995,0,0,0
13294,47,15,1995,1144,461,683
13295,47,69,1995,2049,955,1094
13296,47,156,1995,0,0,0
13297,47,56,1995,12,5,7
13298,47,157,1995,0,0,0
13299,47,110,1995,0,0,0
13300,47,99,1995,0,0,0
13301,47,32,1995,147,71,76
13302,47,43,1995,8,5,3
13303,47,5,1995,0,0,0
13304,47,6,1995,27,6,21
13305,47,16,1995,0,0,0
13306,47,44,1995,21,11,10
13307,47,17,1995,34,12,22
13308,47,57,1995,45,19,26
13309,47,86,1995,0,0,0
13310,47,177,1995,15,8,7
13311,47,18,1995,0,0,0
13312,47,167,1995,8354,4149,4205
13313,47,121,1995,0,0,0
13314,47,19,1995,0,0,0
13315,47,168,1995,774,390,384
13316,47,46,1995,10638,5446,5192
13317,47,20,1995,133,12,121
13318,47,159,1995,0,0,0
13319,47,143,1995,0,0,0
13320,47,71,1995,0,0,0
13321,47,122,1995,0,0,0
13322,47,123,1995,0,0,0
13323,47,7,1995,0,0,0
13324,47,160,1995,0,0,0
13325,47,58,1995,0,0,0
13326,47,161,1995,0,0,0
13327,47,124,1995,0,0,0
13328,47,100,1995,0,0,0
13329,47,72,1995,0,0,0
13330,47,144,1995,0,0,0
13331,47,125,1995,0,0,0
13332,47,150,1995,0,0,0
13333,47,8,1995,0,0,0
13334,47,73,1995,37,14,23
13335,47,101,1995,0,0,0
13336,47,162,1995,5,0,5
13337,47,60,1995,0,0,0
13338,47,48,1995,49,14,35
13339,47,21,1995,0,0,0
13340,47,9,1995,40,6,34
13341,47,111,1995,0,0,0
13342,47,112,1995,0,0,0
13343,47,33,1995,4890,2804,2086
13344,47,61,1995,4,1,3
13345,47,22,1995,0,0,0
13346,47,35,1995,40,18,22
13347,47,36,1995,121622,65154,56468
13348,47,126,1995,0,0,0
13349,47,23,1995,0,0,0
13350,47,63,1995,0,0,0
13351,47,37,1995,18,8,10
13352,47,64,1995,0,0,0
13353,47,128,1995,0,0,0
13354,47,115,1995,0,0,0
13355,47,65,1995,935,397,538
13356,47,10,1995,0,0,0
13357,47,145,1995,0,0,0
13358,47,113,1995,0,0,0
13359,47,49,1995,308,106,202
13360,47,74,1995,26,11,15
13361,47,25,1995,0,0,0
13362,47,169,1995,659,292,367
13363,47,166,1995,0,0,0
13364,47,146,1995,0,0,0
13365,47,26,1995,45,11,34
13366,47,170,1995,479,262,217
13367,47,130,1995,0,0,0
13368,47,38,1995,25598,12066,13532
13369,47,27,1995,19,7,12
13370,47,50,1995,315,161,154
13371,47,131,1995,0,0,0
13372,47,114,1995,25,16,9
13373,47,171,1995,2077,1008,1069
13374,47,1,1995,74,21,53
13375,47,132,1995,0,0,0
13376,47,133,1995,0,0,0
13377,71,2,1995,0,0,0
13378,71,51,1995,275,132,143
13379,71,141,1995,92,43,49
13380,71,52,1995,0,0,0
13381,71,134,1995,0,0,0
13382,71,76,1995,0,0,0
13383,71,103,1995,36,17,19
13384,71,11,1995,0,0,0
13385,71,77,1995,0,0,0
13386,71,66,1995,487,289,198
13387,71,12,1995,0,0,0
13388,71,78,1995,0,0,0
13389,71,13,1995,0,0,0
13390,71,3,1995,27,11,16
13391,71,79,1995,0,0,0
13392,71,29,1995,39,36,3
13393,71,67,1995,11879,6061,5818
13394,71,151,1995,0,0,0
13395,71,4,1995,0,0,0
13396,71,53,1995,2220,1100,1120
13397,71,147,1995,0,0,0
13398,71,105,1995,273,185,88
13399,71,30,1995,68,44,24
13400,71,152,1995,0,0,0
13401,71,116,1995,0,0,0
13402,71,153,1995,1278,678,600
13403,71,135,1995,55,34,21
13404,71,136,1995,0,0,0
13405,71,106,1995,53,25,28
13406,71,172,1995,966,496,470
13407,71,107,1995,24,16,8
13408,71,117,1995,0,0,0
13409,71,137,1995,0,0,0
13410,71,96,1995,0,0,0
13411,71,54,1995,380,185,195
13412,71,81,1995,21,13,8
13413,71,14,1995,2,0,2
13414,71,31,1995,79,49,30
13415,71,176,1995,0,0,0
13416,71,137,1995,89,47,42
13417,71,39,1995,1438,755,683
13418,71,118,1995,0,0,0
13419,71,82,1995,105,77,28
13420,71,83,1995,32,21,11
13421,71,108,1995,0,0,0
13422,71,142,1995,23,9,14
13423,71,97,1995,0,0,0
13424,71,138,1995,0,0,0
13425,71,119,1995,0,0,0
13426,71,40,1995,16,13,3
13427,71,148,1995,0,0,0
13428,71,120,1995,0,0,0
13429,71,42,1995,445,262,183
13430,71,68,1995,15658,8486,7172
13431,71,139,1995,0,0,0
13432,71,155,1995,0,0,0
13433,71,15,1995,0,0,0
13434,71,69,1995,10558,6268,4290
13435,71,156,1995,0,0,0
13436,71,55,1995,0,0,0
13437,71,56,1995,805,406,399
13438,71,84,1995,0,0,0
13439,71,98,1995,0,0,0
13440,71,157,1995,0,0,0
13441,71,158,1995,0,0,0
13442,71,110,1995,0,0,0
13443,71,85,1995,0,0,0
13444,71,99,1995,0,0,0
13445,71,32,1995,89,55,34
13446,71,43,1995,273,150,123
13447,71,5,1995,177,92,85
13448,71,6,1995,212,104,108
13449,71,16,1995,0,0,0
13450,71,44,1995,585,315,270
13451,71,17,1995,38,16,22
13452,71,57,1995,14300,6673,7627
13453,71,86,1995,0,0,0
13454,71,177,1995,290,158,132
13455,71,18,1995,0,0,0
13456,71,167,1995,0,0,0
13457,71,121,1995,0,0,0
13458,71,19,1995,0,0,0
13459,71,168,1995,0,0,0
13460,71,46,1995,7,6,1
13461,71,20,1995,31,19,12
13462,71,159,1995,0,0,0
13463,71,143,1995,0,0,0
13464,71,70,1995,0,0,0
13465,71,47,1995,12,8,4
13466,71,122,1995,0,0,0
13467,71,123,1995,0,0,0
13468,71,160,1995,0,0,0
13469,71,58,1995,12,5,7
13470,71,161,1995,0,0,0
13471,71,124,1995,48,33,15
13472,71,100,1995,25,18,7
13473,71,72,1995,0,0,0
13474,71,59,1995,4925,2337,2588
13475,71,144,1995,169,87,82
13476,71,125,1995,0,0,0
13477,71,150,1995,0,0,0
13478,71,8,1995,28,8,20
13479,71,73,1995,3111,1569,1542
13480,71,101,1995,0,0,0
13481,71,162,1995,0,0,0
13482,71,60,1995,1124,487,637
13483,71,48,1995,161,79,82
13484,71,21,1995,0,0,0
13485,71,9,1995,0,0,0
13486,71,102,1995,0,0,0
13487,71,111,1995,0,0,0
13488,71,112,1995,91,57,34
13489,71,33,1995,642,381,261
13490,71,61,1995,40221,19186,21035
13491,71,22,1995,0,0,0
13492,71,35,1995,203,130,73
13493,71,36,1995,358,267,91
13494,71,126,1995,22,13,9
13495,71,92,1995,0,0,0
13496,71,62,1995,0,0,0
13497,71,140,1995,0,0,0
13498,71,23,1995,0,0,0
13499,71,164,1995,27,12,15
13500,71,63,1995,2288,1051,1237
13501,71,127,1995,0,0,0
13502,71,165,1995,0,0,0
13503,71,37,1995,65,36,29
13504,71,64,1995,51,24,27
13505,71,128,1995,0,0,0
13506,71,115,1995,42,21,21
13507,71,65,1995,2142,1081,1061
13508,71,10,1995,0,0,0
13509,71,145,1995,0,0,0
13510,71,113,1995,0,0,0
13511,71,49,1995,707,378,329
13512,71,74,1995,554,307,247
13513,71,25,1995,0,0,0
13514,71,169,1995,0,0,0
13515,71,166,1995,0,0,0
13516,71,93,1995,0,0,0
13517,71,146,1995,115,35,80
13518,71,26,1995,184,89,95
13519,71,170,1995,0,0,0
13520,71,130,1995,0,0,0
13521,71,38,1995,160,140,20
13522,71,27,1995,0,0,0
13523,71,50,1995,3041,1415,1626
13524,71,131,1995,0,0,0
13525,71,114,1995,0,0,0
13526,71,171,1995,0,0,0
13527,71,1,1995,66,45,21
13528,71,28,1995,0,0,0
13529,71,132,1995,0,0,0
13530,71,133,1995,0,0,0
13531,174,172,1995,189060,102731,86329
13532,174,173,1995,12873,6228,6645
13533,174,61,1995,3827,1832,1995
13534,122,172,1995,1312,574,738
13535,122,117,1995,7242,3172,4070
13536,122,68,1995,5908,2587,3321
13537,122,5,1995,1037,457,580
13538,123,116,1995,5896,2688,3208
13539,123,137,1995,1567,709,858
13540,123,137,1995,2481,1160,1321
13541,123,5,1995,2683,1228,1455
13542,123,125,1995,60845,28953,31892
13543,123,126,1995,5138,2413,2725
13544,123,128,1995,61,26,35
13545,123,115,1995,9179,5043,4136
13546,123,50,1995,1639,786,853
13547,123,131,1995,10676,5899,4777
13548,123,132,1995,47571,28002,19569
13549,123,133,1995,41271,23115,18156
13550,7,66,1995,36,18,18
13551,7,3,1995,3574,1786,1788
13552,7,10,1995,6212,3108,3104
13553,7,68,1995,70,35,35
13554,7,69,1995,213,107,106
13555,7,5,1995,6418,3216,3202
13556,7,57,1995,352,178,174
13557,7,177,1995,76,38,38
13558,7,20,1995,7,3,4
13559,7,9,1995,92,46,46
13560,7,49,1995,24,12,12
13561,7,74,1995,100,50,50
13562,7,142,1995,24,12,12
13563,7,50,1995,94,47,47
13564,160,2,1995,0,0,0
13565,160,51,1995,0,0,0
13566,160,141,1995,507,235,272
13567,160,52,1995,0,0,0
13568,160,134,1995,72,31,41
13569,160,135,1995,618,267,351
13570,160,136,1995,0,0,0
13571,160,106,1995,0,0,0
13572,160,172,1995,190,45,145
13573,160,137,1995,4208,2014,2194
13574,160,137,1995,0,0,0
13575,160,54,1995,0,0,0
13576,160,151,1995,566,236,330
13577,160,138,1995,0,0,0
13578,160,68,1995,2679,1270,1409
13579,160,139,1995,4670,2175,2495
13580,160,155,1995,621,284,337
13581,160,156,1995,2323,1107,1216
13582,160,84,1995,0,0,0
13583,160,157,1995,17896,9038,8858
13584,160,17,1995,0,0,0
13585,160,177,1995,0,0,0
13586,160,167,1995,0,0,0
13587,160,176,1995,0,0,0
13588,160,159,1995,612,303,309
13589,160,143,1995,0,0,0
13590,160,161,1995,20955,10447,10508
13591,160,144,1995,0,0,0
13592,160,162,1995,1663,760,903
13593,160,158,1995,0,0,0
13594,160,36,1995,240,126,114
13595,160,126,1995,0,0,0
13596,160,23,1995,0,0,0
13597,160,164,1995,12540,6174,6366
13598,160,165,1995,1283,625,658
13599,160,115,1995,0,0,0
13600,160,145,1995,0,0,0
13601,160,166,1995,934,383,551
13602,160,27,1995,0,0,0
13603,160,94,1995,0,0,0
13604,160,142,1995,0,0,0
13605,160,131,1995,0,0,0
13606,160,152,1995,20221,9989,10232
13607,160,114,1995,0,0,0
13608,160,132,1995,0,0,0
13609,58,51,1995,19,12,7
13610,58,141,1995,25,8,17
13611,58,103,1995,9,3,6
13612,58,11,1995,13,6,7
13613,58,66,1995,22,13,9
13614,58,3,1995,8,4,4
13615,58,29,1995,4,4,0
13616,58,67,1995,23,12,11
13617,58,53,1995,30,11,19
13618,58,105,1995,32,20,12
13619,58,30,1995,91,48,43
13620,58,172,1995,173,98,75
13621,58,54,1995,22,10,12
13622,58,14,1995,25,13,12
13623,58,31,1995,12,6,6
13624,58,39,1995,15,7,8
13625,58,142,1995,299,113,186
13626,58,119,1995,12,3,9
13627,58,120,1995,30,14,16
13628,58,42,1995,10,9,1
13629,58,68,1995,114,62,52
13630,58,15,1995,15,7,8
13631,58,69,1995,378,225,153
13632,58,156,1995,8,2,6
13633,58,56,1995,13,5,8
13634,58,32,1995,6,5,1
13635,58,5,1995,152,41,111
13636,58,6,1995,11,4,7
13637,58,16,1995,38,13,25
13638,58,44,1995,56,35,21
13639,58,17,1995,10,4,6
13640,58,57,1995,778,331,447
13641,58,177,1995,18,16,2
13642,58,18,1995,15,2,13
13643,58,121,1995,22,12,10
13644,58,19,1995,10,1,9
13645,58,46,1995,5,2,3
13646,58,20,1995,36,17,19
13647,58,143,1995,509,235,274
13648,58,47,1995,4,2,2
13649,58,144,1995,98,75,23
13650,58,73,1995,85,39,46
13651,58,162,1995,60,14,46
13652,58,60,1995,17,10,7
13653,58,48,1995,7,3,4
13654,58,9,1995,64,43,21
13655,58,112,1995,10,6,4
13656,58,33,1995,24,15,9
13657,58,61,1995,4,3,1
13658,58,35,1995,89,52,37
13659,58,36,1995,151,110,41
13660,58,23,1995,13,7,6
13661,58,63,1995,119,46,73
13662,58,37,1995,16,9,7
13663,58,64,1995,8,3,5
13664,58,128,1995,9,3,6
13665,58,115,1995,53,29,24
13666,58,65,1995,14,8,6
13667,58,10,1995,11,5,6
13668,58,145,1995,10,2,8
13669,58,49,1995,33,16,17
13670,58,74,1995,20,9,11
13671,58,25,1995,119,24,95
13672,58,93,1995,11,9,2
13673,58,146,1995,188,82,106
13674,58,26,1995,93,31,62
13675,58,38,1995,36,28,8
13676,58,27,1995,8,4,4
13677,58,50,1995,6258,3527,2731
13678,58,171,1995,9,6,3
13679,58,133,1995,18,8,10
13680,161,141,1995,1549,622,927
13681,161,103,1995,64,30,34
13682,161,67,1995,59,30,29
13683,161,105,1995,152,66,86
13684,161,135,1995,373,156,217
13685,161,136,1995,50,22,28
13686,161,172,1995,151,119,32
13687,161,137,1995,33,17,16
13688,161,151,1995,524,251,273
13689,161,139,1995,82,40,42
13690,161,156,1995,198,129,69
13691,161,157,1995,2936,1838,1098
13692,161,16,1995,82,42,40
13693,161,57,1995,53,27,26
13694,161,19,1995,30,19,11
13695,161,20,1995,113,62,51
13696,161,143,1995,132,66,66
13697,161,160,1995,41626,18426,23200
13698,161,144,1995,326,158,168
13699,161,158,1995,1140,742,398
13700,161,36,1995,59,16,43
13701,161,23,1995,291,135,156
13702,161,164,1995,36493,17994,18499
13703,161,65,1995,82,37,45
13704,161,25,1995,133,74,59
13705,161,166,1995,111,74,37
13706,161,27,1995,66,36,30
13707,161,146,1995,236,124,112
13708,161,142,1995,215,109,106
13709,124,3,1995,150,95,55
13710,124,67,1995,35,6,29
13711,124,10,1995,19,14,5
13712,124,172,1995,3273,2645,628
13713,124,68,1995,696,329,367
13714,124,69,1995,70,31,39
13715,124,173,1995,45,18,27
13716,124,5,1995,1483,312,1171
13717,124,44,1995,14,6,8
13718,124,57,1995,56,25,31
13719,124,177,1995,14,8,6
13720,124,122,1995,242,68,174
13721,124,9,1995,3,1,2
13722,124,36,1995,28,18,10
13723,124,127,1995,39,25,14
13724,124,115,1995,192,109,83
13725,124,65,1995,7,2,5
13726,124,74,1995,30,9,21
13727,124,50,1995,450,237,213
13728,100,141,1995,87,34,53
13729,100,134,1995,43,21,22
13730,100,103,1995,5366,2704,2662
13731,100,66,1995,569,285,284
13732,100,3,1995,24,8,16
13733,100,11,1995,66,31,35
13734,100,67,1995,887,448,439
13735,100,105,1995,2482,1402,1080
13736,100,95,1995,1474,916,558
13737,100,30,1995,191,97,94
13738,100,135,1995,5,2,3
13739,100,106,1995,4144,2235,1909
13740,100,172,1995,1911,862,1049
13741,100,107,1995,5530,2954,2576
13742,100,137,1995,13,1,12
13743,100,96,1995,2571,1571,1000
13744,100,54,1995,71,35,36
13745,100,81,1995,4858,2623,2235
13746,100,31,1995,331,156,175
13747,100,39,1995,298,131,167
13748,100,83,1995,842,429,413
13749,100,108,1995,1222,642,580
13750,100,97,1995,4931,2652,2279
13751,100,42,1995,78,49,29
13752,100,68,1995,4851,2406,2445
13753,100,69,1995,4988,2321,2667
13754,100,56,1995,270,94,176
13755,100,98,1995,49676,23340,26336
13756,100,85,1995,395,98,297
13757,100,99,1995,3031,1741,1290
13758,100,32,1995,313,178,135
13759,100,5,1995,347,145,202
13760,100,6,1995,150,35,115
13761,100,16,1995,40,21,19
13762,100,44,1995,211,94,117
13763,100,17,1995,1303,578,725
13764,100,57,1995,4434,1704,2730
13765,100,86,1995,115,79,36
13766,100,177,1995,3647,1789,1858
13767,100,18,1995,48,9,39
13768,100,121,1995,46,36,10
13769,100,176,1995,1219,605,614
13770,100,20,1995,1585,723,862
13771,100,46,1995,23,12,11
13772,100,47,1995,87,57,30
13773,100,144,1995,204,103,101
13774,100,73,1995,870,401,469
13775,100,101,1995,3324,1757,1567
13776,100,162,1995,55,11,44
13777,100,48,1995,124,54,70
13778,100,9,1995,53,14,39
13779,100,102,1995,13722,6843,6879
13780,100,111,1995,302,132,170
13781,100,112,1995,4140,2047,2093
13782,100,33,1995,1514,979,535
13783,100,61,1995,276,102,174
13784,100,88,1995,1888,1015,873
13785,100,35,1995,310,156,154
13786,100,36,1995,1503,901,602
13787,100,23,1995,175,77,98
13788,100,164,1995,21,3,18
13789,100,63,1995,13,8,5
13790,100,37,1995,50,29,21
13791,100,1,1995,64,21,43
13792,100,64,1995,43,18,25
13793,100,115,1995,96,52,44
13794,100,65,1995,22491,10313,12178
13795,100,49,1995,466,245,221
13796,100,74,1995,1657,724,933
13797,100,25,1995,480,180,300
13798,100,93,1995,35,13,22
13799,100,26,1995,317,175,142
13800,100,38,1995,279,156,123
13801,100,142,1995,174,79,95
13802,100,50,1995,3058,1530,1528
13803,100,114,1995,1506,738,768
13804,72,68,1995,7401,4332,3069
13805,72,57,1995,4180,1774,2406
13806,59,51,1995,0,0,0
13807,59,66,1995,0,0,0
13808,59,53,1995,0,0,0
13809,59,30,1995,0,0,0
13810,59,54,1995,0,0,0
13811,59,31,1995,0,0,0
13812,59,39,1995,0,0,0
13813,59,68,1995,0,0,0
13814,59,69,1995,0,0,0
13815,59,56,1995,0,0,0
13816,59,32,1995,0,0,0
13817,59,57,1995,0,0,0
13818,59,71,1995,0,0,0
13819,59,73,1995,0,0,0
13820,59,33,1995,0,0,0
13821,59,35,1995,0,0,0
13822,59,36,1995,0,0,0
13823,59,63,1995,0,0,0
13824,59,37,1995,0,0,0
13825,59,64,1995,0,0,0
13826,59,49,1995,0,0,0
13827,59,74,1995,0,0,0
13828,59,26,1995,0,0,0
13829,59,38,1995,0,0,0
13830,59,60,1995,0,0,0
13831,59,50,1995,0,0,0
13832,87,76,1995,138,72,66
13833,87,82,1995,331,177,154
13834,87,83,1995,29,9,20
13835,87,110,1995,288,120,168
13836,87,90,1995,141,81,60
13837,87,92,1995,35,11,24
13838,87,93,1995,52,21,31
13839,87,50,1995,129,64,65
13840,144,141,1995,8429,4033,4396
13841,144,67,1995,880,421,459
13842,144,137,1995,1180,564,616
13843,144,68,1995,13813,6609,7204
13844,144,69,1995,903,432,471
13845,144,157,1995,618,295,323
13846,144,16,1995,1075,514,561
13847,144,57,1995,1189,568,621
13848,144,20,1995,847,405,442
13849,144,143,1995,737,352,385
13850,144,161,1995,999,477,522
13851,144,164,1995,1132,541,591
13852,144,65,1995,2571,1230,1341
13853,144,25,1995,1284,614,670
13854,144,146,1995,1618,774,844
13855,144,142,1995,1166,557,609
13856,144,50,1995,760,363,397
13857,125,134,1995,19720,9032,10688
13858,125,116,1995,846,385,461
13859,125,153,1995,3439,1493,1946
13860,125,137,1995,3185,1453,1732
13861,125,5,1995,1238,417,821
13862,125,121,1995,12499,5828,6671
13863,125,149,1995,3955,1993,1962
13864,125,123,1995,31600,14173,17427
13865,125,162,1995,2702,1271,1431
13866,125,9,1995,711,240,471
13867,125,61,1995,2294,729,1565
13868,125,127,1995,8545,4165,4380
13869,125,115,1995,10175,4562,5613
13870,125,133,1995,49118,23024,26094
13871,125,131,1995,3744,1615,2129
13872,125,132,1995,2680,1252,1428
13873,150,2,1995,61,36,25
13874,150,141,1995,684,361,323
13875,150,134,1995,22978,8490,14488
13876,150,76,1995,662,397,265
13877,150,103,1995,70,44,26
13878,150,66,1995,861,397,464
13879,150,78,1995,70,52,18
13880,150,13,1995,68,49,19
13881,150,3,1995,45,17,28
13882,150,11,1995,89,0,89
13883,150,67,1995,260,129,131
13884,150,147,1995,932,478,454
13885,150,105,1995,755,440,315
13886,150,30,1995,43,33,10
13887,150,116,1995,549,215,334
13888,150,135,1995,167,29,138
13889,150,106,1995,45,13,32
13890,150,172,1995,4392,1241,3151
13891,150,137,1995,1579,662,917
13892,150,137,1995,4501,2330,2171
13893,150,81,1995,961,571,390
13894,150,31,1995,107,73,34
13895,150,151,1995,219,124,95
13896,150,39,1995,160,52,108
13897,150,120,1995,298,203,95
13898,150,42,1995,110,79,31
13899,150,68,1995,758,417,341
13900,150,155,1995,122,67,55
13901,150,69,1995,12815,7393,5422
13902,150,156,1995,202,83,119
13903,150,157,1995,75,29,46
13904,150,5,1995,953,330,623
13905,150,6,1995,43,17,26
13906,150,44,1995,85,44,41
13907,150,17,1995,153,67,86
13908,150,57,1995,1165,643,522
13909,150,177,1995,160,99,61
13910,150,121,1995,1569,778,791
13911,150,176,1995,142,0,142
13912,150,20,1995,65,25,40
13913,150,149,1995,177,92,85
13914,150,143,1995,49,25,24
13915,150,71,1995,61,33,28
13916,150,123,1995,521,243,278
13917,150,124,1995,151,89,62
13918,150,125,1995,194,83,111
13919,150,73,1995,729,373,356
13920,150,162,1995,1389,539,850
13921,150,48,1995,75,49,26
13922,150,9,1995,235,25,210
13923,150,33,1995,238,155,83
13924,150,61,1995,613,250,363
13925,150,35,1995,43,19,24
13926,150,36,1995,642,266,376
13927,150,126,1995,506,224,282
13928,150,164,1995,43,17,26
13929,150,127,1995,80,49,31
13930,150,165,1995,231,124,107
13931,150,128,1995,131,39,92
13932,150,115,1995,11988,6010,5978
13933,150,133,1995,20430,10084,10346
13934,150,65,1995,485,199,286
13935,150,145,1995,281,155,126
13936,150,148,1995,277,152,125
13937,150,49,1995,142,76,66
13938,150,74,1995,606,349,257
13939,150,26,1995,49,19,30
13940,150,130,1995,680,334,346
13941,150,38,1995,363,49,314
13942,150,142,1995,245,95,150
13943,150,50,1995,2429,1404,1025
13944,150,131,1995,1553,788,765
13945,150,152,1995,100,52,48
13946,150,132,1995,4277,1505,2772
13947,8,3,1995,577,468,109
13948,8,4,1995,107664,53134,54530
13949,8,10,1995,98,88,10
13950,8,172,1995,25260,12760,12500
13951,8,5,1995,515578,383358,132220
13952,8,9,1995,2734,1521,1213
13953,73,2,1995,14531,6143,8388
13954,73,51,1995,267,112,155
13955,73,141,1995,2694,796,1898
13956,73,52,1995,0,0,0
13957,73,134,1995,2543,917,1626
13958,73,75,1995,9,4,5
13959,73,76,1995,16,8,8
13960,73,103,1995,1785,970,815
13961,73,11,1995,62,30,32
13962,73,77,1995,630,294,336
13963,73,66,1995,6701,3885,2816
13964,73,12,1995,58,35,23
13965,73,78,1995,34,13,21
13966,73,13,1995,71,37,34
13967,73,3,1995,590,385,205
13968,73,79,1995,54,21,33
13969,73,29,1995,19,7,12
13970,73,67,1995,42604,23867,18737
13971,73,95,1995,0,0,0
13972,73,151,1995,77,27,50
13973,73,4,1995,13,1,12
13974,73,53,1995,288,138,150
13975,73,147,1995,130,64,66
13976,73,105,1995,5699,3360,2339
13977,73,30,1995,1217,748,469
13978,73,152,1995,133,47,86
13979,73,116,1995,326,151,175
13980,73,153,1995,9257,4603,4654
13981,73,135,1995,634,307,327
13982,73,80,1995,0,0,0
13983,73,136,1995,40,17,23
13984,73,106,1995,2673,1343,1330
13985,73,172,1995,26141,13346,12795
13986,73,107,1995,6784,3863,2921
13987,73,117,1995,0,0,0
13988,73,137,1995,433,183,250
13989,73,96,1995,304,161,143
13990,73,54,1995,81,39,42
13991,73,81,1995,460,269,191
13992,73,14,1995,182,71,111
13993,73,31,1995,3953,2689,1264
13994,73,176,1995,2,0,2
13995,73,137,1995,3316,1356,1960
13996,73,39,1995,2527,1552,975
13997,73,118,1995,70,33,37
13998,73,82,1995,48,26,22
13999,73,83,1995,3933,2803,1130
14000,73,108,1995,646,384,262
14001,73,142,1995,6789,1536,5253
14002,73,97,1995,197,110,87
14003,73,138,1995,13,5,8
14004,73,119,1995,228,96,132
14005,73,40,1995,121,87,34
14006,73,148,1995,52,26,26
14007,73,120,1995,5474,2346,3128
14008,73,41,1995,0,0,0
14009,73,42,1995,1655,1156,499
14010,73,68,1995,15164,8378,6786
14011,73,139,1995,51,26,25
14012,73,155,1995,164,37,127
14013,73,15,1995,46,21,25
14014,73,69,1995,123377,73078,50299
14015,73,156,1995,8266,3906,4360
14016,73,55,1995,16,1,15
14017,73,56,1995,6024,2062,3962
14018,73,84,1995,20,8,12
14019,73,98,1995,242,124,118
14020,73,157,1995,577,99,478
14021,73,158,1995,108,42,66
14022,73,110,1995,2020,1285,735
14023,73,85,1995,399,198,201
14024,73,99,1995,184,116,68
14025,73,32,1995,4859,2832,2027
14026,73,43,1995,277,152,125
14027,73,5,1995,8940,4159,4781
14028,73,6,1995,12357,5108,7249
14029,73,16,1995,15178,5555,9623
14030,73,44,1995,3923,2073,1850
14031,73,45,1995,0,0,0
14032,73,17,1995,3486,1457,2029
14033,73,57,1995,15067,4668,10399
14034,73,86,1995,577,360,217
14035,73,177,1995,4799,2474,2325
14036,73,18,1995,572,212,360
14037,73,167,1995,5,0,5
14038,73,121,1995,1355,719,636
14039,73,19,1995,952,385,567
14040,73,168,1995,0,0,0
14041,73,46,1995,188,127,61
14042,73,20,1995,2263,917,1346
14043,73,149,1995,60,28,32
14044,73,159,1995,1443,426,1017
14045,73,143,1995,293,105,188
14046,73,70,1995,0,0,0
14047,73,47,1995,253,198,55
14048,73,71,1995,587,318,269
14049,73,122,1995,100,57,43
14050,73,123,1995,161,78,83
14051,73,7,1995,0,0,0
14052,73,160,1995,70,30,40
14053,73,58,1995,155,92,63
14054,73,161,1995,240,6,234
14055,73,124,1995,213,128,85
14056,73,100,1995,968,558,410
14057,73,72,1995,33,18,15
14058,73,59,1995,0,0,0
14059,73,87,1995,0,0,0
14060,73,144,1995,130895,57527,73368
14061,73,125,1995,317,156,161
14062,73,150,1995,99,57,42
14063,73,8,1995,303,148,155
14064,73,101,1995,195,111,84
14065,73,162,1995,2580,924,1656
14066,73,60,1995,6,3,3
14067,73,48,1995,2008,1204,804
14068,73,21,1995,257,129,128
14069,73,9,1995,8428,3133,5295
14070,73,102,1995,148,67,81
14071,73,111,1995,114,68,46
14072,73,112,1995,1437,909,528
14073,73,33,1995,12398,8743,3655
14074,73,61,1995,8561,4159,4402
14075,73,22,1995,22,13,9
14076,73,35,1995,2804,1680,1124
14077,73,36,1995,8559,5378,3181
14078,73,126,1995,447,202,245
14079,73,90,1995,29,14,15
14080,73,91,1995,29,12,17
14081,73,92,1995,28,15,13
14082,73,62,1995,0,0,0
14083,73,140,1995,84,41,43
14084,73,23,1995,656,311,345
14085,73,164,1995,445,128,317
14086,73,63,1995,31358,15249,16109
14087,73,127,1995,57,34,23
14088,73,165,1995,933,194,739
14089,73,37,1995,19,8,11
14090,73,64,1995,15,6,9
14091,73,128,1995,11388,4987,6401
14092,73,115,1995,8417,4465,3952
14093,73,129,1995,0,0,0
14094,73,65,1995,17326,8303,9023
14095,73,10,1995,6813,3023,3790
14096,73,145,1995,2540,630,1910
14097,73,113,1995,167083,88054,79029
14098,73,49,1995,2770,1600,1170
14099,73,74,1995,4863,2804,2059
14100,73,25,1995,2996,1306,1690
14101,73,169,1995,89,77,12
14102,73,166,1995,449,116,333
14103,73,93,1995,331,199,132
14104,73,146,1995,3118,948,2170
14105,73,26,1995,155845,72882,82963
14106,73,170,1995,0,0,0
14107,73,94,1995,0,0,0
14108,73,130,1995,472,214,258
14109,73,38,1995,67,27,40
14110,73,27,1995,29,7,22
14111,73,50,1995,39070,17514,21556
14112,73,131,1995,804,401,403
14113,73,114,1995,417,194,223
14114,73,171,1995,7210,3417,3793
14115,73,1,1995,8861,4381,4480
14116,73,28,1995,97,27,70
14117,73,132,1995,605,298,307
14118,73,133,1995,1215,618,597
14119,101,2,1995,22,9,13
14120,101,141,1995,40,19,21
14121,101,76,1995,28,14,14
14122,101,103,1995,147,64,83
14123,101,66,1995,43,17,26
14124,101,78,1995,19,9,10
14125,101,67,1995,42,13,29
14126,101,105,1995,110,68,42
14127,101,95,1995,48,22,26
14128,101,30,1995,70,48,22
14129,101,106,1995,115,40,75
14130,101,172,1995,44,9,35
14131,101,107,1995,237,124,113
14132,101,137,1995,17,5,12
14133,101,96,1995,4727,2450,2277
14134,101,81,1995,711,290,421
14135,101,39,1995,44,16,28
14136,101,83,1995,52,27,25
14137,101,108,1995,78,35,43
14138,101,97,1995,2136,936,1200
14139,101,120,1995,29,10,19
14140,101,68,1995,111,48,63
14141,101,69,1995,297,132,165
14142,101,98,1995,900,441,459
14143,101,85,1995,20,5,15
14144,101,99,1995,9473,4866,4607
14145,101,5,1995,10,3,7
14146,101,44,1995,12,7,5
14147,101,57,1995,149,51,98
14148,101,86,1995,31,13,18
14149,101,177,1995,43,15,28
14150,101,18,1995,11,2,9
14151,101,100,1995,734,424,310
14152,101,73,1995,93,45,48
14153,101,162,1995,9,5,4
14154,101,102,1995,351,181,170
14155,101,112,1995,176,77,99
14156,101,88,1995,43,24,19
14157,101,36,1995,307,191,116
14158,101,164,1995,66,33,33
14159,101,128,1995,14,10,4
14160,101,65,1995,442,192,250
14161,101,49,1995,44,26,18
14162,101,74,1995,76,24,52
14163,101,38,1995,64,42,22
14164,101,50,1995,37,14,23
14165,101,114,1995,9,5,4
14166,101,28,1995,11,7,4
14167,162,135,1995,10384,4595,5789
14168,162,136,1995,11265,4985,6280
14169,162,151,1995,117556,52026,65530
14170,162,156,1995,81276,35970,45306
14171,162,159,1995,7931,3509,4422
14172,162,160,1995,39251,17371,21880
14173,162,165,1995,1574,696,878
14174,162,166,1995,52442,23209,29233
14175,176,3,1995,86,59,27
14176,176,105,1995,1140,581,559
14177,176,10,1995,126,98,28
14178,176,172,1995,19590,9068,10522
14179,176,173,1995,102,44,58
14180,176,5,1995,198,95,103
14181,176,177,1995,173,79,94
14182,176,9,1995,90,42,48
14183,176,112,1995,207,106,101
14184,176,36,1995,58,28,30
14185,176,1,1995,699,289,410
14186,176,50,1995,205,87,118
14187,60,51,1995,58009,33827,24182
14188,60,53,1995,5989,3492,2497
14189,60,30,1995,1006,587,419
14190,60,54,1995,1335,784,551
14191,60,31,1995,50,29,21
14192,60,69,1995,40,23,17
14193,60,56,1995,220,128,92
14194,60,32,1995,77,45,32
14195,60,57,1995,36,21,15
14196,60,59,1995,8606,5047,3559
14197,60,33,1995,94,55,39
14198,60,35,1995,22,13,9
14199,60,36,1995,203,119,84
14200,60,63,1995,16803,9799,7004
14201,60,37,1995,35,20,15
14202,60,64,1995,241,140,101
14203,60,26,1995,13247,7691,5556
14204,60,38,1995,61,35,26
14205,60,142,1995,1843,1074,769
14206,48,2,1995,351,145,206
14207,48,51,1995,81,39,42
14208,48,141,1995,558,130,428
14209,48,52,1995,0,0,0
14210,48,134,1995,41,21,20
14211,48,76,1995,0,0,0
14212,48,103,1995,491,266,225
14213,48,11,1995,15,7,8
14214,48,77,1995,0,0,0
14215,48,66,1995,936,462,474
14216,48,12,1995,3,3,0
14217,48,78,1995,8,4,4
14218,48,13,1995,12,6,6
14219,48,3,1995,492,247,245
14220,48,79,1995,14,5,9
14221,48,29,1995,36,17,19
14222,48,67,1995,818,437,381
14223,48,95,1995,0,0,0
14224,48,151,1995,3,0,3
14225,48,4,1995,8,0,8
14226,48,53,1995,9401,4750,4651
14227,48,147,1995,36,19,17
14228,48,105,1995,895,552,343
14229,48,30,1995,566,231,335
14230,48,152,1995,10,3,7
14231,48,116,1995,3,0,3
14232,48,153,1995,167,74,93
14233,48,135,1995,149,67,82
14234,48,80,1995,0,0,0
14235,48,136,1995,9,0,9
14236,48,106,1995,5249,2364,2885
14237,48,172,1995,2878,1467,1411
14238,48,173,1995,854,387,467
14239,48,174,1995,22,9,13
14240,48,107,1995,2584,1112,1472
14241,48,117,1995,0,0,0
14242,48,137,1995,172,86,86
14243,48,96,1995,157,78,79
14244,48,54,1995,102,50,52
14245,48,81,1995,49,24,25
14246,48,14,1995,91,22,69
14247,48,31,1995,185,89,96
14248,48,176,1995,23,13,10
14249,48,137,1995,27,8,19
14250,48,39,1995,21161,11292,9869
14251,48,118,1995,3,3,0
14252,48,82,1995,0,0,0
14253,48,83,1995,128,91,37
14254,48,108,1995,272,134,138
14255,48,142,1995,310,82,228
14256,48,97,1995,81,45,36
14257,48,138,1995,0,0,0
14258,48,119,1995,44,22,22
14259,48,40,1995,159,98,61
14260,48,148,1995,0,0,0
14261,48,120,1995,2227,871,1356
14262,48,41,1995,742,424,318
14263,48,42,1995,4533,2633,1900
14264,48,68,1995,2459,1200,1259
14265,48,139,1995,0,0,0
14266,48,155,1995,676,184,492
14267,48,15,1995,11,6,5
14268,48,69,1995,9318,5140,4178
14269,48,156,1995,1104,411,693
14270,48,55,1995,0,0,0
14271,48,56,1995,495,128,367
14272,48,84,1995,0,0,0
14273,48,98,1995,234,110,124
14274,48,157,1995,27,11,16
14275,48,158,1995,10,3,7
14276,48,110,1995,69,41,28
14277,48,85,1995,10,5,5
14278,48,99,1995,63,33,30
14279,48,32,1995,1328,525,803
14280,48,43,1995,2601,1360,1241
14281,48,5,1995,4621,2285,2336
14282,48,6,1995,7055,2592,4463
14283,48,16,1995,2376,825,1551
14284,48,44,1995,474,259,215
14285,48,45,1995,0,0,0
14286,48,17,1995,506,196,310
14287,48,57,1995,1157,403,754
14288,48,86,1995,54,30,24
14289,48,177,1995,867,546,321
14290,48,18,1995,74,27,47
14291,48,167,1995,6,3,3
14292,48,121,1995,618,310,308
14293,48,19,1995,94,35,59
14294,48,168,1995,0,0,0
14295,48,46,1995,130,85,45
14296,48,20,1995,997,373,624
14297,48,149,1995,0,0,0
14298,48,159,1995,71,34,37
14299,48,143,1995,54,8,46
14300,48,70,1995,6,3,3
14301,48,47,1995,75,55,20
14302,48,71,1995,67,26,41
14303,48,122,1995,365,181,184
14304,48,123,1995,3,3,0
14305,48,7,1995,0,0,0
14306,48,160,1995,14,5,9
14307,48,58,1995,35,18,17
14308,48,161,1995,7,0,7
14309,48,124,1995,148,73,75
14310,48,100,1995,262,158,104
14311,48,72,1995,0,0,0
14312,48,59,1995,0,0,0
14313,48,87,1995,0,0,0
14314,48,144,1995,3044,1009,2035
14315,48,125,1995,32,18,14
14316,48,150,1995,20,13,7
14317,48,8,1995,71,31,40
14318,48,73,1995,3552,1817,1735
14319,48,101,1995,57,28,29
14320,48,162,1995,370,113,257
14321,48,60,1995,26,12,14
14322,48,21,1995,13,6,7
14323,48,9,1995,11567,5196,6371
14324,48,102,1995,21,13,8
14325,48,111,1995,55,35,20
14326,48,112,1995,417,214,203
14327,48,33,1995,5157,3238,1919
14328,48,61,1995,630,266,364
14329,48,88,1995,0,0,0
14330,48,22,1995,0,0,0
14331,48,35,1995,577,337,240
14332,48,36,1995,820,531,289
14333,48,126,1995,33,17,16
14334,48,90,1995,0,0,0
14335,48,91,1995,0,0,0
14336,48,92,1995,0,0,0
14337,48,62,1995,0,0,0
14338,48,140,1995,0,0,0
14339,48,23,1995,69,29,40
14340,48,164,1995,44,15,29
14341,48,63,1995,0,0,0
14342,48,127,1995,0,0,0
14343,48,165,1995,153,46,107
14344,48,37,1995,18,12,6
14345,48,64,1995,10,5,5
14346,48,128,1995,3293,1289,2004
14347,48,115,1995,641,331,310
14348,48,129,1995,0,0,0
14349,48,65,1995,1403,577,826
14350,48,10,1995,6122,2349,3773
14351,48,145,1995,138,39,99
14352,48,113,1995,9,5,4
14353,48,49,1995,23219,12803,10416
14354,48,74,1995,1237,658,579
14355,48,25,1995,420,167,253
14356,48,169,1995,0,0,0
14357,48,166,1995,39,8,31
14358,48,93,1995,223,116,107
14359,48,146,1995,447,66,381
14360,48,26,1995,5974,2593,3381
14361,48,170,1995,0,0,0
14362,48,94,1995,0,0,0
14363,48,130,1995,325,137,188
14364,48,38,1995,77,46,31
14365,48,27,1995,34,18,16
14366,48,50,1995,13692,6300,7392
14367,48,131,1995,350,149,201
14368,48,114,1995,145,72,73
14369,48,171,1995,4,4,0
14370,48,1,1995,10594,4926,5668
14371,48,28,1995,22,12,10
14372,48,132,1995,140,59,81
14373,48,133,1995,90,42,48
14374,21,13,1995,294,155,139
14375,21,3,1995,82653,4536,78117
14376,21,10,1995,14591,9662,4929
14377,21,68,1995,663,226,437
14378,21,5,1995,282987,51350,231637
14379,21,16,1995,1361,608,753
14380,21,18,1995,8732,3323,5409
14381,21,19,1995,177,62,115
14382,21,73,1995,780,316,464
14383,21,9,1995,59439,8497,50942
14384,21,22,1995,77,44,33
14385,21,23,1995,595,167,428
14386,21,129,1995,0,0,0
14387,21,145,1995,8625,3501,5124
14388,21,27,1995,7470,3171,4299
14389,21,142,1995,27544,11502,16042
14390,21,50,1995,5188,1752,3436
14391,9,2,1995,1291867,631234,660633
14392,9,10,1995,413,194,219
14393,9,172,1995,410,173,237
14394,9,5,1995,2365884,1081631,1284253
14395,9,6,1995,3060,1375,1685
14396,9,16,1995,466,226,240
14397,102,103,1995,667,315,352
14398,102,66,1995,45,16,29
14399,102,3,1995,9,0,9
14400,102,79,1995,88,54,34
14401,102,67,1995,23,6,17
14402,102,105,1995,695,422,273
14403,102,95,1995,72,33,39
14404,102,30,1995,44,14,30
14405,102,106,1995,997,491,506
14406,102,172,1995,10439,4576,5863
14407,102,107,1995,17179,8687,8492
14408,102,96,1995,4155,2311,1844
14409,102,54,1995,39,3,36
14410,102,81,1995,2396,1072,1324
14411,102,31,1995,20,10,10
14412,102,39,1995,28,9,19
14413,102,82,1995,17,11,6
14414,102,83,1995,3554,2532,1022
14415,102,108,1995,1604,646,958
14416,102,97,1995,2146,1019,1127
14417,102,42,1995,8,3,5
14418,102,68,1995,282,125,157
14419,102,15,1995,0,0,0
14420,102,69,1995,344,131,213
14421,102,56,1995,224,65,159
14422,102,84,1995,11,8,3
14423,102,98,1995,473,231,242
14424,102,110,1995,38,10,28
14425,102,85,1995,204,103,101
14426,102,99,1995,715,384,331
14427,102,173,1995,270,124,146
14428,102,32,1995,47,28,19
14429,102,5,1995,1738,702,1036
14430,102,6,1995,45,9,36
14431,102,44,1995,15,5,10
14432,102,17,1995,472,164,308
14433,102,57,1995,500,186,314
14434,102,86,1995,724,419,305
14435,102,177,1995,244,92,152
14436,102,18,1995,61,18,43
14437,102,20,1995,303,114,189
14438,102,143,1995,15,6,9
14439,102,47,1995,20,5,15
14440,102,100,1995,1810,1015,795
14441,102,144,1995,33,12,21
14442,102,73,1995,90,33,57
14443,102,101,1995,4593,2532,2061
14444,102,162,1995,9,1,8
14445,102,48,1995,6,2,4
14446,102,9,1995,45,18,27
14447,102,111,1995,35,22,13
14448,102,112,1995,2170,904,1266
14449,102,33,1995,71,23,48
14450,102,61,1995,152,44,108
14451,102,88,1995,285,106,179
14452,102,35,1995,52,20,32
14453,102,36,1995,396,230,166
14454,102,23,1995,25,6,19
14455,102,63,1995,29,7,22
14456,102,37,1995,5,1,4
14457,102,1,1995,6,2,4
14458,102,115,1995,17,8,9
14459,102,65,1995,2432,907,1525
14460,102,49,1995,37,12,25
14461,102,74,1995,121,44,77
14462,102,25,1995,119,42,77
14463,102,93,1995,53,23,30
14464,102,26,1995,35,13,22
14465,102,38,1995,94,37,57
14466,102,142,1995,30,17,13
14467,102,50,1995,314,111,203
14468,102,114,1995,199,84,115
14469,111,103,1995,57525,28615,28910
14470,111,105,1995,97450,45708,51742
14471,111,106,1995,2425,1036,1389
14472,111,172,1995,1419,625,794
14473,111,68,1995,594,239,355
14474,111,69,1995,1994,842,1152
14475,111,57,1995,845,332,513
14476,111,177,1995,2448,1144,1304
14477,111,100,1995,2440,1221,1219
14478,111,33,1995,842,402,440
14479,111,65,1995,1057,446,611
14480,111,50,1995,169,78,91
14481,111,114,1995,3303,1434,1869
14482,112,141,1995,11,4,7
14483,112,134,1995,9,6,3
14484,112,103,1995,7087,3624,3463
14485,112,66,1995,123,56,67
14486,112,67,1995,383,184,199
14487,112,105,1995,3033,1707,1326
14488,112,30,1995,42,17,25
14489,112,106,1995,4483,2420,2063
14490,112,172,1995,2551,1158,1393
14491,112,107,1995,3706,1982,1724
14492,112,96,1995,210,110,100
14493,112,54,1995,57,12,45
14494,112,81,1995,564,231,333
14495,112,31,1995,56,25,31
14496,112,39,1995,151,68,83
14497,112,83,1995,112,58,54
14498,112,108,1995,2491,1441,1050
14499,112,97,1995,67,36,31
14500,112,40,1995,10,5,5
14501,112,42,1995,44,23,21
14502,112,68,1995,1441,671,770
14503,112,109,1995,21,12,9
14504,112,69,1995,1826,903,923
14505,112,56,1995,36,10,26
14506,112,98,1995,101,52,49
14507,112,85,1995,30,18,12
14508,112,99,1995,103,64,39
14509,112,32,1995,40,20,20
14510,112,43,1995,9,1,8
14511,112,5,1995,129,50,79
14512,112,6,1995,35,11,24
14513,112,16,1995,11,2,9
14514,112,44,1995,131,66,65
14515,112,17,1995,316,125,191
14516,112,57,1995,2088,943,1145
14517,112,177,1995,2093,1044,1049
14518,112,18,1995,24,6,18
14519,112,176,1995,54,24,30
14520,112,20,1995,43,18,25
14521,112,71,1995,9,4,5
14522,112,58,1995,13,0,13
14523,112,100,1995,931,497,434
14524,112,144,1995,24,8,16
14525,112,73,1995,423,193,230
14526,112,101,1995,100,61,39
14527,112,48,1995,65,30,35
14528,112,9,1995,45,10,35
14529,112,102,1995,215,110,105
14530,112,111,1995,340,188,152
14531,112,33,1995,124,61,63
14532,112,61,1995,80,29,51
14533,112,88,1995,85,46,39
14534,112,35,1995,114,62,52
14535,112,36,1995,392,251,141
14536,112,92,1995,14,10,4
14537,112,23,1995,20,9,11
14538,112,64,1995,17,8,9
14539,112,115,1995,72,27,45
14540,112,65,1995,3168,1502,1666
14541,112,49,1995,176,83,93
14542,112,74,1995,486,226,260
14543,112,26,1995,33,12,21
14544,112,38,1995,150,99,51
14545,112,142,1995,12,2,10
14546,112,50,1995,1034,497,537
14547,112,114,1995,382,166,216
14548,33,2,1995,187,21,166
14549,33,51,1995,70,27,43
14550,33,141,1995,549,137,412
14551,33,134,1995,32,0,32
14552,33,103,1995,214,99,115
14553,33,11,1995,1010,420,590
14554,33,66,1995,5234,2682,2552
14555,33,12,1995,304,166,138
14556,33,3,1995,51,2,49
14557,33,29,1995,126812,74389,52423
14558,33,67,1995,3395,1738,1657
14559,33,53,1995,3955,2200,1755
14560,33,105,1995,255,152,103
14561,33,30,1995,2064,856,1208
14562,33,135,1995,11,0,11
14563,33,106,1995,28,10,18
14564,33,172,1995,788,415,373
14565,33,107,1995,69,23,46
14566,33,137,1995,58,11,47
14567,33,96,1995,24,5,19
14568,33,54,1995,976,525,451
14569,33,81,1995,223,74,149
14570,33,14,1995,53,16,37
14571,33,31,1995,7526,4378,3148
14572,33,39,1995,853,493,360
14573,33,83,1995,3,0,3
14574,33,108,1995,36,8,28
14575,33,142,1995,246,67,179
14576,33,119,1995,2,0,2
14577,33,40,1995,343,210,133
14578,33,120,1995,58,15,43
14579,33,42,1995,232,126,106
14580,33,68,1995,42043,22917,19126
14581,33,15,1995,393,207,186
14582,33,69,1995,123377,69618,53759
14583,33,156,1995,55,16,39
14584,33,56,1995,3390,1402,1988
14585,33,157,1995,14,4,10
14586,33,110,1995,15,2,13
14587,33,32,1995,1631,932,699
14588,33,43,1995,49,16,33
14589,33,5,1995,372,113,259
14590,33,6,1995,168,45,123
14591,33,16,1995,480,66,414
14592,33,44,1995,86,23,63
14593,33,17,1995,463,140,323
14594,33,57,1995,5210,2487,2723
14595,33,177,1995,278,142,136
14596,33,18,1995,190,25,165
14597,33,167,1995,4087,2194,1893
14598,33,121,1995,64,28,36
14599,33,19,1995,165,63,102
14600,33,168,1995,90,51,39
14601,33,46,1995,2708,1622,1086
14602,33,20,1995,399,77,322
14603,33,143,1995,369,145,224
14604,33,47,1995,96834,57537,39297
14605,33,71,1995,151,84,67
14606,33,160,1995,30,0,30
14607,33,100,1995,140,68,72
14608,33,72,1995,2,0,2
14609,33,59,1995,235,94,141
14610,33,144,1995,189,50,139
14611,33,125,1995,15,0,15
14612,33,8,1995,10,0,10
14613,33,73,1995,1170,447,723
14614,33,162,1995,240,35,205
14615,33,60,1995,248,86,162
14616,33,48,1995,381,174,207
14617,33,9,1995,72,12,60
14618,33,102,1995,29,11,18
14619,33,112,1995,122,29,93
14620,33,61,1995,72,28,44
14621,33,22,1995,7,2,5
14622,33,35,1995,4061,2322,1739
14623,33,36,1995,65827,41554,24273
14624,33,23,1995,29,11,18
14625,33,164,1995,29,0,29
14626,33,63,1995,4056,2144,1912
14627,33,37,1995,1838,1064,774
14628,33,64,1995,156,91,65
14629,33,115,1995,321,155,166
14630,33,65,1995,1348,620,728
14631,33,10,1995,30,9,21
14632,33,145,1995,75,12,63
14633,33,49,1995,853,408,445
14634,33,74,1995,613,324,289
14635,33,25,1995,671,91,580
14636,33,169,1995,72,47,25
14637,33,146,1995,160,33,127
14638,33,26,1995,548,197,351
14639,33,170,1995,53,42,11
14640,33,130,1995,52,23,29
14641,33,38,1995,375267,223703,151564
14642,33,27,1995,100,49,51
14643,33,50,1995,3192,1383,1809
14644,33,131,1995,60,13,47
14645,33,114,1995,11,6,5
14646,33,171,1995,425,268,157
14647,33,1,1995,2003,753,1250
14648,33,28,1995,112,8,104
14649,33,132,1995,44,15,29
14650,33,133,1995,30,12,18
14651,61,51,1995,24,9,15
14652,61,141,1995,118,43,75
14653,61,52,1995,264,138,126
14654,61,134,1995,154254,81771,72483
14655,61,103,1995,654,354,300
14656,61,11,1995,34,15,19
14657,61,66,1995,245,130,115
14658,61,12,1995,5,2,3
14659,61,3,1995,165,10,155
14660,61,29,1995,82,31,51
14661,61,67,1995,2120,1136,984
14662,61,151,1995,15,2,13
14663,61,53,1995,27,14,13
14664,61,105,1995,35931,19013,16918
14665,61,30,1995,395,133,262
14666,61,153,1995,36695,17800,18895
14667,61,135,1995,35,15,20
14668,61,106,1995,119,61,58
14669,61,172,1995,1452,700,752
14670,61,173,1995,57,34,23
14671,61,174,1995,1816,1003,813
14672,61,107,1995,229,157,72
14673,61,137,1995,1148,607,541
14674,61,54,1995,58,21,37
14675,61,81,1995,250,141,109
14676,61,14,1995,11,5,6
14677,61,31,1995,81,48,33
14678,61,176,1995,2,1,1
14679,61,137,1995,1018,525,493
14680,61,39,1995,315,159,156
14681,61,83,1995,22,16,6
14682,61,108,1995,140,70,70
14683,61,142,1995,64,28,36
14684,61,97,1995,14,7,7
14685,61,138,1995,34,23,11
14686,61,40,1995,141,80,61
14687,61,148,1995,103,57,46
14688,61,120,1995,7,5,2
14689,61,42,1995,196,114,82
14690,61,68,1995,75053,39628,35425
14691,61,139,1995,45,24,21
14692,61,155,1995,15,0,15
14693,61,15,1995,88,9,79
14694,61,69,1995,19705,10083,9622
14695,61,156,1995,33,7,26
14696,61,56,1995,81,43,38
14697,61,98,1995,15,11,4
14698,61,157,1995,186,33,153
14699,61,158,1995,13671,5595,8076
14700,61,32,1995,136,89,47
14701,61,43,1995,20,10,10
14702,61,5,1995,4184,1941,2243
14703,61,6,1995,113,50,63
14704,61,16,1995,34,13,21
14705,61,44,1995,356,202,154
14706,61,17,1995,60,24,36
14707,61,57,1995,1436,620,816
14708,61,86,1995,16,8,8
14709,61,177,1995,175,94,81
14710,61,18,1995,6,0,6
14711,61,167,1995,58,19,39
14712,61,121,1995,94,54,40
14713,61,46,1995,44,14,30
14714,61,20,1995,36,16,20
14715,61,159,1995,18,2,16
14716,61,143,1995,5,0,5
14717,61,70,1995,2,0,2
14718,61,47,1995,82,18,64
14719,61,71,1995,2341,1180,1161
14720,61,122,1995,22,7,15
14721,61,123,1995,119,73,46
14722,61,160,1995,26,3,23
14723,61,58,1995,13,4,9
14724,61,161,1995,18,3,15
14725,61,100,1995,134,85,49
14726,61,59,1995,51,5,46
14727,61,144,1995,853,327,526
14728,61,125,1995,73598,38698,34900
14729,61,8,1995,20,3,17
14730,61,73,1995,2476,1259,1217
14731,61,162,1995,91,28,63
14732,61,60,1995,6,3,3
14733,61,48,1995,177,85,92
14734,61,9,1995,540,58,482
14735,61,102,1995,75,41,34
14736,61,111,1995,14,8,6
14737,61,112,1995,127,80,47
14738,61,33,1995,224,118,106
14739,61,35,1995,1766,477,1289
14740,61,36,1995,1468,596,872
14741,61,140,1995,8820,4736,4084
14742,61,164,1995,396,104,292
14743,61,63,1995,99,11,88
14744,61,165,1995,26,1,25
14745,61,37,1995,18,10,8
14746,61,64,1995,18,10,8
14747,61,115,1995,8622,4496,4126
14748,61,65,1995,12207,7373,4834
14749,61,10,1995,7,2,5
14750,61,49,1995,466,255,211
14751,61,74,1995,8128,4031,4097
14752,61,25,1995,21,9,12
14753,61,166,1995,18,3,15
14754,61,146,1995,32,11,21
14755,61,26,1995,66,20,46
14756,61,130,1995,36,22,14
14757,61,38,1995,6899,1302,5597
14758,61,50,1995,8269,4221,4048
14759,61,131,1995,104,66,38
14760,61,114,1995,84,41,43
14761,61,171,1995,11,0,11
14762,61,1,1995,12,6,6
14763,61,133,1995,852,472,380
14764,88,103,1995,1245,654,591
14765,88,105,1995,195,102,93
14766,88,106,1995,879,461,418
14767,88,172,1995,826,433,393
14768,88,107,1995,3601,1894,1707
14769,88,96,1995,531,279,252
14770,88,81,1995,19293,10027,9266
14771,88,82,1995,2575,1354,1221
14772,88,83,1995,49325,26576,22749
14773,88,108,1995,675,355,320
14774,88,142,1995,72,37,35
14775,88,97,1995,504,265,239
14776,88,68,1995,294,154,140
14777,88,69,1995,1662,873,789
14778,88,98,1995,515,271,244
14779,88,110,1995,104,54,50
14780,88,85,1995,310,163,147
14781,88,99,1995,446,234,212
14782,88,5,1995,101,53,48
14783,88,17,1995,91,48,43
14784,88,57,1995,448,235,213
14785,88,86,1995,88,46,42
14786,88,177,1995,172,90,82
14787,88,18,1995,185,97,88
14788,88,20,1995,36,18,18
14789,88,100,1995,2302,1210,1092
14790,88,73,1995,55,29,26
14791,88,101,1995,483,254,229
14792,88,102,1995,1661,873,788
14793,88,112,1995,916,481,435
14794,88,33,1995,37,19,18
14795,88,61,1995,71,37,34
14796,88,65,1995,4168,2192,1976
14797,88,93,1995,357,187,170
14798,88,26,1995,44,22,22
14799,88,50,1995,356,187,169
14800,88,1,1995,130,68,62
14801,22,2,1995,417,105,312
14802,22,13,1995,91,54,37
14803,22,3,1995,43199,5179,38020
14804,22,10,1995,1033,332,701
14805,22,136,1995,9228,5467,3761
14806,22,120,1995,986,250,736
14807,22,119,1995,694,176,518
14808,22,68,1995,202,75,127
14809,22,5,1995,2975,757,2218
14810,22,18,1995,13371,6514,6857
14811,22,19,1995,7067,2359,4708
14812,22,20,1995,3377,868,2509
14813,22,144,1995,1412,359,1053
14814,22,8,1995,498,126,372
14815,22,73,1995,442,112,330
14816,22,162,1995,282,140,142
14817,22,9,1995,363,92,271
14818,22,23,1995,17817,5757,12060
14819,22,128,1995,184,57,127
14820,22,129,1995,660,167,493
14821,22,145,1995,3452,879,2573
14822,22,25,1995,571,145,426
14823,22,27,1995,41796,13070,28726
14824,22,146,1995,300,75,225
14825,22,26,1995,2508,638,1870
14826,22,142,1995,271,68,203
14827,22,50,1995,2677,959,1718
14828,22,28,1995,11418,2906,8512
14829,35,2,1995,0,0,0
14830,35,51,1995,632,342,290
14831,35,141,1995,5,1,4
14832,35,52,1995,0,0,0
14833,35,134,1995,0,0,0
14834,35,75,1995,0,0,0
14835,35,76,1995,0,0,0
14836,35,103,1995,8,4,4
14837,35,11,1995,1,0,1
14838,35,66,1995,631,332,299
14839,35,12,1995,0,0,0
14840,35,78,1995,0,0,0
14841,35,13,1995,0,0,0
14842,35,3,1995,5,1,4
14843,35,79,1995,0,0,0
14844,35,29,1995,26,13,13
14845,35,67,1995,254,133,121
14846,35,95,1995,0,0,0
14847,35,151,1995,0,0,0
14848,35,4,1995,0,0,0
14849,35,53,1995,73,37,36
14850,35,147,1995,0,0,0
14851,35,105,1995,3,1,2
14852,35,30,1995,21944,12231,9713
14853,35,152,1995,0,0,0
14854,35,116,1995,0,0,0
14855,35,153,1995,0,0,0
14856,35,135,1995,0,0,0
14857,35,80,1995,0,0,0
14858,35,136,1995,0,0,0
14859,35,106,1995,0,0,0
14860,35,172,1995,1331,565,766
14861,35,107,1995,0,0,0
14862,35,117,1995,0,0,0
14863,35,137,1995,0,0,0
14864,35,96,1995,0,0,0
14865,35,54,1995,927,460,467
14866,35,81,1995,1,0,1
14867,35,14,1995,32,18,14
14868,35,31,1995,691,436,255
14869,35,176,1995,0,0,0
14870,35,137,1995,0,0,0
14871,35,39,1995,52,27,25
14872,35,118,1995,0,0,0
14873,35,82,1995,0,0,0
14874,35,83,1995,0,0,0
14875,35,108,1995,0,0,0
14876,35,142,1995,13,4,9
14877,35,97,1995,0,0,0
14878,35,138,1995,0,0,0
14879,35,119,1995,0,0,0
14880,35,40,1995,0,0,0
14881,35,148,1995,0,0,0
14882,35,120,1995,0,0,0
14883,35,41,1995,0,0,0
14884,35,42,1995,108,64,44
14885,35,68,1995,677,304,373
14886,35,139,1995,0,0,0
14887,35,155,1995,0,0,0
14888,35,15,1995,0,0,0
14889,35,69,1995,2033,1077,956
14890,35,156,1995,0,0,0
14891,35,55,1995,0,0,0
14892,35,56,1995,4350,2256,2094
14893,35,84,1995,0,0,0
14894,35,98,1995,0,0,0
14895,35,157,1995,1,0,1
14896,35,158,1995,0,0,0
14897,35,110,1995,0,0,0
14898,35,85,1995,0,0,0
14899,35,99,1995,0,0,0
14900,35,32,1995,7522,4814,2708
14901,35,43,1995,0,0,0
14902,35,5,1995,0,0,0
14903,35,6,1995,875,138,737
14904,35,16,1995,638,172,466
14905,35,44,1995,83,36,47
14906,35,45,1995,0,0,0
14907,35,17,1995,516,122,394
14908,35,57,1995,1436,400,1036
14909,35,86,1995,0,0,0
14910,35,177,1995,23,11,12
14911,35,18,1995,527,106,421
14912,35,167,1995,0,0,0
14913,35,121,1995,0,0,0
14914,35,19,1995,0,0,0
14915,35,168,1995,0,0,0
14916,35,46,1995,0,0,0
14917,35,20,1995,642,120,522
14918,35,159,1995,0,0,0
14919,35,143,1995,0,0,0
14920,35,70,1995,0,0,0
14921,35,47,1995,0,0,0
14922,35,71,1995,20,6,14
14923,35,122,1995,0,0,0
14924,35,123,1995,0,0,0
14925,35,7,1995,0,0,0
14926,35,160,1995,0,0,0
14927,35,58,1995,0,0,0
14928,35,161,1995,0,0,0
14929,35,124,1995,0,0,0
14930,35,100,1995,6,4,2
14931,35,72,1995,0,0,0
14932,35,59,1995,0,0,0
14933,35,144,1995,6,3,3
14934,35,125,1995,0,0,0
14935,35,150,1995,0,0,0
14936,35,8,1995,0,0,0
14937,35,73,1995,165,61,104
14938,35,101,1995,0,0,0
14939,35,162,1995,1,0,1
14940,35,60,1995,1849,1037,812
14941,35,48,1995,62,33,29
14942,35,21,1995,0,0,0
14943,35,9,1995,1,0,1
14944,35,102,1995,0,0,0
14945,35,111,1995,0,0,0
14946,35,112,1995,0,0,0
14947,35,33,1995,480,291,189
14948,35,61,1995,79,39,40
14949,35,22,1995,0,0,0
14950,35,36,1995,7431,4989,2442
14951,35,126,1995,0,0,0
14952,35,91,1995,0,0,0
14953,35,92,1995,0,0,0
14954,35,62,1995,0,0,0
14955,35,140,1995,0,0,0
14956,35,23,1995,6,0,6
14957,35,164,1995,0,0,0
14958,35,63,1995,1255,657,598
14959,35,165,1995,0,0,0
14960,35,37,1995,166,96,70
14961,35,64,1995,0,0,0
14962,35,128,1995,0,0,0
14963,35,115,1995,0,0,0
14964,35,65,1995,158,79,79
14965,35,10,1995,0,0,0
14966,35,145,1995,0,0,0
14967,35,113,1995,0,0,0
14968,35,49,1995,134,72,62
14969,35,74,1995,85,44,41
14970,35,25,1995,4579,1890,2689
14971,35,169,1995,0,0,0
14972,35,166,1995,0,0,0
14973,35,93,1995,0,0,0
14974,35,146,1995,3,1,2
14975,35,26,1995,1810,337,1473
14976,35,170,1995,0,0,0
14977,35,130,1995,0,0,0
14978,35,38,1995,14717,8673,6044
14979,35,27,1995,4,0,4
14980,35,50,1995,354,140,214
14981,35,131,1995,0,0,0
14982,35,114,1995,0,0,0
14983,35,171,1995,0,0,0
14984,35,1,1995,6,1,5
14985,35,28,1995,0,0,0
14986,35,132,1995,0,0,0
14987,35,133,1995,0,0,0
14988,36,2,1995,15576,5765,9811
14989,36,51,1995,988,461,527
14990,36,141,1995,1189,520,669
14991,36,134,1995,470,203,267
14992,36,12,1995,905728,423965,481763
14993,36,103,1995,572,273,299
14994,36,66,1995,3905,1962,1943
14995,36,3,1995,1035,377,658
14996,36,11,1995,516425,241177,275248
14997,36,67,1995,857,414,443
14998,36,53,1995,776,325,451
14999,36,147,1995,195,95,100
15000,36,105,1995,594,297,297
15001,36,30,1995,9934,4403,5531
15002,36,116,1995,164,76,88
15003,36,29,1995,886234,469619,416615
15004,36,135,1995,624,245,379
15005,36,153,1995,50,23,27
15006,36,10,1995,941,416,525
15007,36,136,1995,139,56,83
15008,36,106,1995,662,334,328
15009,36,172,1995,64969,30308,34661
15010,36,107,1995,297,124,173
15011,36,117,1995,15,6,9
15012,36,137,1995,424,171,253
15013,36,96,1995,34,16,18
15014,36,54,1995,313,125,188
15015,36,81,1995,2513,1130,1383
15016,36,14,1995,466,220,246
15017,36,31,1995,14104,7050,7054
15018,36,151,1995,324,160,164
15019,36,39,1995,2546,1289,1257
15020,36,108,1995,313,141,172
15021,36,138,1995,33,18,15
15022,36,120,1995,372,147,225
15023,36,40,1995,65943,33811,32132
15024,36,42,1995,1899,1005,894
15025,36,68,1995,1481,723,758
15026,36,15,1995,653159,315290,337869
15027,36,69,1995,149872,75322,74550
15028,36,156,1995,263,116,147
15029,36,56,1995,1975,947,1028
15030,36,157,1995,397,176,221
15031,36,173,1995,36,16,20
15032,36,32,1995,18740,9357,9383
15033,36,43,1995,56,28,28
15034,36,5,1995,8083,3048,5035
15035,36,6,1995,2829,1238,1591
15036,36,16,1995,1213,481,732
15037,36,44,1995,178,78,100
15038,36,17,1995,2641,1179,1462
15039,36,57,1995,974,449,525
15040,36,177,1995,679,342,337
15041,36,167,1995,2506132,1296891,1209241
15042,36,18,1995,1300,502,798
15043,36,121,1995,381,178,203
15044,36,176,1995,9245,4258,4987
15045,36,19,1995,212,85,127
15046,36,168,1995,455644,232512,223132
15047,36,20,1995,1710,614,1096
15048,36,46,1995,100686,51425,49261
15049,36,143,1995,362,170,192
15050,36,47,1995,85879,43231,42648
15051,36,71,1995,91,43,48
15052,36,122,1995,139,65,74
15053,36,123,1995,9,3,6
15054,36,7,1995,124,55,69
15055,36,160,1995,167,66,101
15056,36,58,1995,616,321,295
15057,36,124,1995,247,106,141
15058,36,100,1995,170,80,90
15059,36,72,1995,218,120,98
15060,36,59,1995,551,275,276
15061,36,144,1995,1514,613,901
15062,36,125,1995,105,48,57
15063,36,21,1995,51,19,32
15064,36,150,1995,95,41,54
15065,36,8,1995,492,198,294
15066,36,73,1995,376,185,191
15067,36,101,1995,66,30,36
15068,36,162,1995,1039,440,599
15069,36,48,1995,1193,609,584
15070,36,9,1995,1367,503,864
15071,36,102,1995,72,30,42
15072,36,111,1995,117,63,54
15073,36,112,1995,702,299,403
15074,36,33,1995,32973,16850,16123
15075,36,61,1995,125,59,66
15076,36,158,1995,308,132,176
15077,36,22,1995,107,48,59
15078,36,35,1995,4284,2257,2027
15079,36,126,1995,168,77,91
15080,36,75,1995,300,144,156
15081,36,62,1995,36,20,16
15082,36,23,1995,278,115,163
15083,36,164,1995,105,50,55
15084,36,37,1995,1046,522,524
15085,36,1,1995,28489,11915,16574
15086,36,64,1995,127,56,71
15087,36,128,1995,121,55,66
15088,36,115,1995,241,115,126
15089,36,133,1995,258,122,136
15090,36,65,1995,850,418,432
15091,36,145,1995,483,180,303
15092,36,49,1995,338,162,176
15093,36,74,1995,418,209,209
15094,36,25,1995,4479,1673,2806
15095,36,169,1995,410349,191940,218409
15096,36,27,1995,261,115,146
15097,36,146,1995,526,214,312
15098,36,26,1995,11200,4504,6696
15099,36,170,1995,173279,87903,85376
15100,36,130,1995,93,42,51
15101,36,38,1995,3485074,1790184,1694890
15102,36,60,1995,301,117,184
15103,36,142,1995,1488,717,771
15104,36,50,1995,865,402,463
15105,36,131,1995,244,105,139
15106,36,152,1995,568,298,270
15107,36,114,1995,498,252,246
15108,36,171,1995,918869,460514,458355
15109,36,28,1995,794,288,506
15110,36,132,1995,305,123,182
15111,126,116,1995,37445,16599,20846
15112,126,137,1995,89770,45732,44038
15113,126,121,1995,1455,610,845
15114,126,130,1995,48486,23541,24945
15115,126,131,1995,24121,12011,12110
15116,90,76,1995,231,122,109
15117,90,78,1995,8,4,4
15118,90,79,1995,56,32,24
15119,90,82,1995,115,54,61
15120,90,84,1995,34,15,19
15121,90,110,1995,443,213,230
15122,90,86,1995,82,43,39
15123,90,87,1995,246,126,120
15124,90,91,1995,60,21,39
15125,90,92,1995,97,49,48
15126,90,93,1995,152,64,88
15127,91,76,1995,65,32,33
15128,91,66,1995,8,4,4
15129,91,78,1995,7,2,5
15130,91,79,1995,437,214,223
15131,91,67,1995,5,2,3
15132,91,105,1995,6,2,4
15133,91,95,1995,0,0,0
15134,91,80,1995,2,0,2
15135,91,172,1995,27,14,13
15136,91,81,1995,13,7,6
15137,91,82,1995,129,62,67
15138,91,83,1995,26,16,10
15139,91,120,1995,2,2,0
15140,91,68,1995,41,13,28
15141,91,109,1995,171,108,63
15142,91,69,1995,41,25,16
15143,91,156,1995,13,5,8
15144,91,84,1995,90,36,54
15145,91,98,1995,2,0,2
15146,91,110,1995,1108,643,465
15147,91,85,1995,15,7,8
15148,91,5,1995,65,25,40
15149,91,44,1995,10,5,5
15150,91,57,1995,9,5,4
15151,91,86,1995,105,62,43
15152,91,177,1995,14,11,3
15153,91,20,1995,5,3,2
15154,91,100,1995,5,5,0
15155,91,87,1995,18,9,9
15156,91,73,1995,11,3,8
15157,91,77,1995,10,6,4
15158,91,162,1995,7,5,2
15159,91,9,1995,10,5,5
15160,91,102,1995,16,7,9
15161,91,88,1995,9,2,7
15162,91,90,1995,25,14,11
15163,91,75,1995,21,11,10
15164,91,92,1995,245,138,107
15165,91,115,1995,5,2,3
15166,91,133,1995,0,0,0
15167,91,113,1995,24,14,10
15168,91,74,1995,5,2,3
15169,91,25,1995,16,3,13
15170,91,93,1995,438,230,208
15171,91,50,1995,547,290,257
15172,92,76,1995,53,25,28
15173,92,79,1995,315,137,178
15174,92,82,1995,78,46,32
15175,92,84,1995,392,230,162
15176,92,110,1995,217,124,93
15177,92,86,1995,115,58,57
15178,92,90,1995,36,26,10
15179,92,91,1995,216,128,88
15180,92,93,1995,871,443,428
15181,92,50,1995,719,347,372
15182,62,57,1995,3273,1468,1805
15183,62,51,1995,28,23,5
15184,62,33,1995,19,17,2
15185,62,35,1995,71,55,16
15186,62,38,1995,25,23,2
15187,62,36,1995,16,13,3
15188,62,68,1995,28,16,12
15189,62,103,1995,74,34,40
15190,62,105,1995,20,19,1
15191,140,134,1995,556,271,285
15192,140,153,1995,3343,1693,1650
15193,140,138,1995,286,175,111
15194,140,139,1995,221,64,157
15195,140,125,1995,228,30,198
15196,140,61,1995,212,99,113
15197,23,2,1995,170388,56751,113637
15198,23,3,1995,491297,124746,366551
15199,23,10,1995,205566,68467,137099
15200,23,120,1995,62534,20828,41706
15201,23,5,1995,929709,302535,627174
15202,23,16,1995,33020,15515,17505
15203,23,18,1995,92523,30816,61707
15204,23,20,1995,58626,19526,39100
15205,23,8,1995,182078,42451,139627
15206,23,9,1995,570555,176732,393823
15207,23,145,1995,183214,61023,122191
15208,23,25,1995,313441,135717,177724
15209,23,142,1995,366429,122046,244383
15210,23,28,1995,293143,102518,190625
15211,164,141,1995,3622,2342,1280
15212,164,105,1995,560,292,268
15213,164,135,1995,875,547,328
15214,164,137,1995,29,16,13
15215,164,151,1995,3120,1541,1579
15216,164,68,1995,11977,6256,5721
15217,164,155,1995,4458,2530,1928
15218,164,69,1995,754,380,374
15219,164,156,1995,1543,349,1194
15220,164,157,1995,44519,16652,27867
15221,164,20,1995,952,340,612
15222,164,159,1995,220,123,97
15223,164,160,1995,29450,14382,15068
15224,164,161,1995,98848,47395,51453
15225,164,144,1995,3560,1861,1699
15226,164,162,1995,733,195,538
15227,164,158,1995,24916,14526,10390
15228,164,126,1995,300,168,132
15229,164,23,1995,1230,653,577
15230,164,165,1995,12876,6969,5907
15231,164,166,1995,1443,490,953
15232,164,26,1995,0,0,0
15233,63,51,1995,364,287,77
15234,63,141,1995,41,15,26
15235,63,103,1995,38,25,13
15236,63,66,1995,5461,2718,2743
15237,63,11,1995,122,94,28
15238,63,67,1995,108,45,63
15239,63,53,1995,266909,143969,122940
15240,63,105,1995,42,25,17
15241,63,30,1995,884,628,256
15242,63,29,1995,104,88,16
15243,63,172,1995,1375,608,767
15244,63,54,1995,255683,130895,124788
15245,63,81,1995,22,10,12
15246,63,14,1995,134,59,75
15247,63,31,1995,400,271,129
15248,63,39,1995,91,44,47
15249,63,42,1995,25,14,11
15250,63,68,1995,168,85,83
15251,63,15,1995,37,25,12
15252,63,69,1995,502,242,260
15253,63,156,1995,22,7,15
15254,63,56,1995,713,349,364
15255,63,32,1995,1404,914,490
15256,63,5,1995,229,128,101
15257,63,6,1995,50,5,45
15258,63,16,1995,137,46,91
15259,63,44,1995,40,18,22
15260,63,17,1995,84,40,44
15261,63,57,1995,540,329,211
15262,63,177,1995,29,16,13
15263,63,167,1995,75,59,16
15264,63,18,1995,77,16,61
15265,63,19,1995,51,20,31
15266,63,20,1995,35,15,20
15267,63,143,1995,291,119,172
15268,63,47,1995,21,15,6
15269,63,71,1995,70,26,44
15270,63,58,1995,41,19,22
15271,63,100,1995,19,11,8
15272,63,59,1995,60383,32968,27415
15273,63,144,1995,25,15,10
15274,63,73,1995,586,270,316
15275,63,48,1995,17,7,10
15276,63,112,1995,38,23,15
15277,63,33,1995,517,439,78
15278,63,61,1995,29,11,18
15279,63,35,1995,2815,2311,504
15280,63,36,1995,2297,1628,669
15281,63,37,1995,371,262,109
15282,63,64,1995,8530,4659,3871
15283,63,115,1995,39,28,11
15284,63,133,1995,21,12,9
15285,63,65,1995,122,53,69
15286,63,49,1995,929,448,481
15287,63,74,1995,2228,1046,1182
15288,63,25,1995,94,18,76
15289,63,27,1995,18,9,9
15290,63,146,1995,30,7,23
15291,63,26,1995,302,95,207
15292,63,170,1995,22,17,5
15293,63,38,1995,994,824,170
15294,63,60,1995,40287,23604,16683
15295,63,142,1995,59,19,40
15296,63,50,1995,504,230,274
15297,63,171,1995,61,55,6
15298,63,132,1995,44,23,21
15299,127,3,1995,14,6,8
15300,127,67,1995,26,10,16
15301,127,10,1995,391,145,246
15302,127,172,1995,80,14,66
15303,127,81,1995,26,12,14
15304,127,68,1995,167,87,80
15305,127,69,1995,48,25,23
15306,127,5,1995,1651,338,1313
15307,127,57,1995,29,11,18
15308,127,121,1995,178,123,55
15309,127,122,1995,279,257,22
15310,127,7,1995,1,1,0
15311,127,124,1995,383,158,225
15312,127,8,1995,33,22,11
15313,127,162,1995,32,13,19
15314,127,9,1995,17,10,7
15315,127,36,1995,45,26,19
15316,127,128,1995,13,3,10
15317,127,115,1995,224,59,165
15318,127,65,1995,10,5,5
15319,127,130,1995,5,2,3
15320,127,50,1995,223,108,115
15321,165,153,1995,4,2,2
15322,165,136,1995,3,1,2
15323,165,172,1995,273,7,266
15324,165,137,1995,0,0,0
15325,165,151,1995,257,160,97
15326,165,138,1995,0,0,0
15327,165,119,1995,0,0,0
15328,165,155,1995,5110,2392,2718
15329,165,69,1995,131,61,70
15330,165,156,1995,1274,427,847
15331,165,157,1995,72442,30449,41993
15332,165,5,1995,395,161,234
15333,165,16,1995,0,0,0
15334,165,177,1995,6,4,2
15335,165,121,1995,0,0,0
15336,165,176,1995,6,1,5
15337,165,20,1995,2066,1002,1064
15338,165,159,1995,8925,4643,4282
15339,165,160,1995,1904,874,1030
15340,165,161,1995,138,34,104
15341,165,162,1995,2063,761,1302
15342,165,9,1995,0,0,0
15343,165,158,1995,23,8,15
15344,165,36,1995,73,50,23
15345,165,126,1995,0,0,0
15346,165,164,1995,718,248,470
15347,165,1,1995,1,0,1
15348,165,115,1995,233,188,45
15349,165,145,1995,3,1,2
15350,165,166,1995,41,14,27
15351,165,50,1995,595,266,329
15352,165,152,1995,34,13,21
15353,165,132,1995,0,0,0
15354,37,2,1995,125,19,106
15355,37,51,1995,29,4,25
15356,37,141,1995,32,5,27
15357,37,52,1995,0,0,0
15358,37,134,1995,11,1,10
15359,37,103,1995,32,18,14
15360,37,11,1995,57,28,29
15361,37,77,1995,0,0,0
15362,37,66,1995,1033,483,550
15363,37,12,1995,11,7,4
15364,37,13,1995,0,0,0
15365,37,3,1995,0,0,0
15366,37,79,1995,0,0,0
15367,37,29,1995,87,65,22
15368,37,67,1995,259,109,150
15369,37,95,1995,0,0,0
15370,37,151,1995,0,0,0
15371,37,53,1995,133,42,91
15372,37,147,1995,0,0,0
15373,37,105,1995,30,19,11
15374,37,30,1995,790,301,489
15375,37,152,1995,0,0,0
15376,37,116,1995,0,0,0
15377,37,135,1995,0,0,0
15378,37,80,1995,0,0,0
15379,37,136,1995,43,26,17
15380,37,106,1995,8,3,5
15381,37,172,1995,320,166,154
15382,37,107,1995,16,4,12
15383,37,137,1995,6,2,4
15384,37,96,1995,0,0,0
15385,37,54,1995,273,102,171
15386,37,81,1995,49,13,36
15387,37,14,1995,32,14,18
15388,37,31,1995,37407,22127,15280
15389,37,176,1995,0,0,0
15390,37,137,1995,0,0,0
15391,37,39,1995,72,26,46
15392,37,82,1995,0,0,0
15393,37,83,1995,0,0,0
15394,37,108,1995,10,3,7
15395,37,142,1995,55,2,53
15396,37,97,1995,0,0,0
15397,37,40,1995,15,11,4
15398,37,148,1995,0,0,0
15399,37,120,1995,10,2,8
15400,37,41,1995,0,0,0
15401,37,42,1995,44,21,23
15402,37,68,1995,1071,575,496
15403,37,155,1995,0,0,0
15404,37,15,1995,27,11,16
15405,37,69,1995,1460,554,906
15406,37,156,1995,5,0,5
15407,37,56,1995,119,45,74
15408,37,84,1995,0,0,0
15409,37,98,1995,0,0,0
15410,37,157,1995,0,0,0
15411,37,158,1995,0,0,0
15412,37,85,1995,0,0,0
15413,37,99,1995,0,0,0
15414,37,32,1995,7707,4562,3145
15415,37,43,1995,13,7,6
15416,37,5,1995,45,14,31
15417,37,6,1995,198,28,170
15418,37,16,1995,25,3,22
15419,37,44,1995,233,117,116
15420,37,45,1995,0,0,0
15421,37,17,1995,58,19,39
15422,37,57,1995,793,222,571
15423,37,86,1995,0,0,0
15424,37,177,1995,41,25,16
15425,37,18,1995,19,3,16
15426,37,167,1995,78,46,32
15427,37,121,1995,7,3,4
15428,37,19,1995,25,7,18
15429,37,168,1995,7,4,3
15430,37,46,1995,40,26,14
15431,37,20,1995,36,5,31
15432,37,149,1995,0,0,0
15433,37,159,1995,0,0,0
15434,37,143,1995,18,3,15
15435,37,70,1995,0,0,0
15436,37,47,1995,42,28,14
15437,37,71,1995,20,10,10
15438,37,122,1995,0,0,0
15439,37,123,1995,0,0,0
15440,37,7,1995,0,0,0
15441,37,58,1995,6,2,4
15442,37,124,1995,0,0,0
15443,37,100,1995,24,8,16
15444,37,72,1995,0,0,0
15445,37,59,1995,14,6,8
15446,37,144,1995,15,2,13
15447,37,125,1995,0,0,0
15448,37,150,1995,0,0,0
15449,37,8,1995,0,0,0
15450,37,73,1995,163,52,111
15451,37,101,1995,0,0,0
15452,37,162,1995,30,1,29
15453,37,60,1995,231,78,153
15454,37,48,1995,197,118,79
15455,37,21,1995,0,0,0
15456,37,9,1995,25,0,25
15457,37,102,1995,0,0,0
15458,37,111,1995,0,0,0
15459,37,112,1995,17,6,11
15460,37,33,1995,2476,1556,920
15461,37,61,1995,46,15,31
15462,37,22,1995,0,0,0
15463,37,35,1995,2843,1273,1570
15464,37,36,1995,1073,765,308
15465,37,126,1995,0,0,0
15466,37,90,1995,0,0,0
15467,37,91,1995,0,0,0
15468,37,62,1995,0,0,0
15469,37,140,1995,0,0,0
15470,37,23,1995,10,0,10
15471,37,164,1995,0,0,0
15472,37,63,1995,709,289,420
15473,37,127,1995,0,0,0
15474,37,165,1995,0,0,0
15475,37,64,1995,95,32,63
15476,37,128,1995,0,0,0
15477,37,115,1995,33,10,23
15478,37,65,1995,240,118,122
15479,37,10,1995,0,0,0
15480,37,145,1995,0,0,0
15481,37,49,1995,76,35,41
15482,37,74,1995,186,85,101
15483,37,25,1995,81,14,67
15484,37,169,1995,0,0,0
15485,37,166,1995,0,0,0
15486,37,93,1995,0,0,0
15487,37,146,1995,43,3,40
15488,37,26,1995,92,16,76
15489,37,170,1995,0,0,0
15490,37,130,1995,0,0,0
15491,37,38,1995,4039,2689,1350
15492,37,27,1995,20,7,13
15493,37,50,1995,1426,682,744
15494,37,131,1995,0,0,0
15495,37,114,1995,0,0,0
15496,37,171,1995,16,10,6
15497,37,1,1995,713,298,415
15498,37,28,1995,12,1,11
15499,37,132,1995,0,0,0
15500,37,133,1995,0,0,0
15501,64,2,1995,2,0,2
15502,64,51,1995,51,17,34
15503,64,141,1995,8,3,5
15504,64,134,1995,0,0,0
15505,64,103,1995,129,63,66
15506,64,11,1995,0,0,0
15507,64,77,1995,0,0,0
15508,64,66,1995,3564,2066,1498
15509,64,12,1995,0,0,0
15510,64,78,1995,0,0,0
15511,64,3,1995,0,0,0
15512,64,79,1995,0,0,0
15513,64,29,1995,34,21,13
15514,64,67,1995,239,123,116
15515,64,95,1995,0,0,0
15516,64,151,1995,0,0,0
15517,64,53,1995,68327,31789,36538
15518,64,147,1995,0,0,0
15519,64,105,1995,14,10,4
15520,64,30,1995,75,36,39
15521,64,152,1995,0,0,0
15522,64,116,1995,0,0,0
15523,64,153,1995,0,0,0
15524,64,135,1995,0,0,0
15525,64,136,1995,0,0,0
15526,64,106,1995,14,7,7
15527,64,172,1995,132,56,76
15528,64,107,1995,4,1,3
15529,64,117,1995,0,0,0
15530,64,137,1995,0,0,0
15531,64,96,1995,0,0,0
15532,64,54,1995,47721,23904,23817
15533,64,81,1995,4,2,2
15534,64,14,1995,0,0,0
15535,64,31,1995,349,246,103
15536,64,176,1995,0,0,0
15537,64,137,1995,0,0,0
15538,64,39,1995,19,10,9
15539,64,82,1995,0,0,0
15540,64,83,1995,6,2,4
15541,64,108,1995,0,0,0
15542,64,142,1995,29,14,15
15543,64,97,1995,0,0,0
15544,64,119,1995,0,0,0
15545,64,40,1995,0,0,0
15546,64,120,1995,0,0,0
15547,64,42,1995,4,1,3
15548,64,68,1995,1262,687,575
15549,64,139,1995,0,0,0
15550,64,155,1995,0,0,0
15551,64,15,1995,0,0,0
15552,64,69,1995,6970,3618,3352
15553,64,156,1995,10,3,7
15554,64,56,1995,54,26,28
15555,64,98,1995,0,0,0
15556,64,157,1995,0,0,0
15557,64,158,1995,0,0,0
15558,64,110,1995,0,0,0
15559,64,85,1995,0,0,0
15560,64,99,1995,0,0,0
15561,64,32,1995,329,218,111
15562,64,43,1995,0,0,0
15563,64,5,1995,22,8,14
15564,64,6,1995,17,7,10
15565,64,16,1995,25,8,17
15566,64,44,1995,3,1,2
15567,64,17,1995,5,2,3
15568,64,57,1995,3670,2056,1614
15569,64,86,1995,0,0,0
15570,64,177,1995,16,9,7
15571,64,18,1995,16,3,13
15572,64,167,1995,7,4,3
15573,64,121,1995,10,5,5
15574,64,19,1995,0,0,0
15575,64,168,1995,0,0,0
15576,64,46,1995,6,4,2
15577,64,20,1995,8,4,4
15578,64,159,1995,0,0,0
15579,64,143,1995,16,7,9
15580,64,70,1995,0,0,0
15581,64,47,1995,3,1,2
15582,64,71,1995,25,14,11
15583,64,122,1995,0,0,0
15584,64,123,1995,0,0,0
15585,64,7,1995,0,0,0
15586,64,160,1995,0,0,0
15587,64,58,1995,0,0,0
15588,64,161,1995,0,0,0
15589,64,124,1995,0,0,0
15590,64,100,1995,10,4,6
15591,64,59,1995,2630,1205,1425
15592,64,87,1995,0,0,0
15593,64,144,1995,5,1,4
15594,64,125,1995,0,0,0
15595,64,150,1995,0,0,0
15596,64,8,1995,0,0,0
15597,64,73,1995,246,125,121
15598,64,101,1995,0,0,0
15599,64,162,1995,4,1,3
15600,64,60,1995,6599,2768,3831
15601,64,48,1995,0,0,0
15602,64,21,1995,0,0,0
15603,64,9,1995,5,2,3
15604,64,102,1995,0,0,0
15605,64,111,1995,0,0,0
15606,64,112,1995,7,3,4
15607,64,33,1995,133,96,37
15608,64,61,1995,6,2,4
15609,64,22,1995,0,0,0
15610,64,35,1995,93,63,30
15611,64,36,1995,372,253,119
15612,64,126,1995,0,0,0
15613,64,62,1995,0,0,0
15614,64,140,1995,0,0,0
15615,64,23,1995,0,0,0
15616,64,164,1995,0,0,0
15617,64,63,1995,24679,11313,13366
15618,64,165,1995,0,0,0
15619,64,37,1995,76,50,26
15620,64,128,1995,0,0,0
15621,64,115,1995,9,5,4
15622,64,65,1995,278,165,113
15623,64,10,1995,0,0,0
15624,64,145,1995,0,0,0
15625,64,113,1995,0,0,0
15626,64,49,1995,225,110,115
15627,64,74,1995,744,366,378
15628,64,25,1995,1,0,1
15629,64,169,1995,0,0,0
15630,64,166,1995,0,0,0
15631,64,93,1995,0,0,0
15632,64,146,1995,4,1,3
15633,64,26,1995,10,2,8
15634,64,170,1995,0,0,0
15635,64,130,1995,0,0,0
15636,64,38,1995,193,131,62
15637,64,27,1995,0,0,0
15638,64,50,1995,106,50,56
15639,64,131,1995,0,0,0
15640,64,114,1995,0,0,0
15641,64,171,1995,4,1,3
15642,64,1,1995,0,0,0
15643,64,28,1995,0,0,0
15644,64,132,1995,0,0,0
15645,64,133,1995,0,0,0
15646,128,120,1995,18044,8554,9490
15647,128,119,1995,0,0,0
15648,128,28,1995,0,0,0
15649,115,2,1995,36,12,24
15650,115,51,1995,63,35,28
15651,115,141,1995,233,75,158
15652,115,134,1995,11043,4272,6771
15653,115,103,1995,702,384,318
15654,115,66,1995,2520,1264,1256
15655,115,13,1995,100,56,44
15656,115,3,1995,1540,404,1136
15657,115,79,1995,18,6,12
15658,115,29,1995,93,46,47
15659,115,67,1995,4009,1989,2020
15660,115,151,1995,119,41,78
15661,115,53,1995,91,60,31
15662,115,147,1995,15678,4077,11601
15663,115,105,1995,960,573,387
15664,115,30,1995,2393,1293,1100
15665,115,116,1995,1305,419,886
15666,115,135,1995,1436,467,969
15667,115,106,1995,405,159,246
15668,115,172,1995,8051,3881,4170
15669,115,107,1995,159,85,74
15670,115,117,1995,120,20,100
15671,115,137,1995,3712,1357,2355
15672,115,54,1995,391,178,213
15673,115,81,1995,416,139,277
15674,115,14,1995,1304,663,641
15675,115,31,1995,779,346,433
15676,115,176,1995,85,76,9
15677,115,137,1995,7488,3494,3994
15678,115,39,1995,886,493,393
15679,115,142,1995,1204,537,667
15680,115,119,1995,325,151,174
15681,115,40,1995,56,10,46
15682,115,120,1995,1792,823,969
15683,115,42,1995,370,261,109
15684,115,68,1995,3828,2100,1728
15685,115,139,1995,190,92,98
15686,115,69,1995,25144,12978,12166
15687,115,156,1995,4046,1505,2541
15688,115,55,1995,21,4,17
15689,115,56,1995,3034,1448,1586
15690,115,98,1995,56,20,36
15691,115,157,1995,48,20,28
15692,115,158,1995,18,15,3
15693,115,110,1995,34,21,13
15694,115,173,1995,1075,540,535
15695,115,43,1995,13,3,10
15696,115,5,1995,10958,4943,6015
15697,115,6,1995,424,235,189
15698,115,16,1995,88,20,68
15699,115,44,1995,4728,2539,2189
15700,115,17,1995,1879,901,978
15701,115,57,1995,8891,4127,4764
15702,115,86,1995,119,80,39
15703,115,177,1995,786,374,412
15704,115,18,1995,34,17,17
15705,115,121,1995,3911,1889,2022
15706,115,19,1995,56,18,38
15707,115,168,1995,0,0,0
15708,115,46,1995,163,51,112
15709,115,20,1995,563,296,267
15710,115,149,1995,130897,39650,91247
15711,115,159,1995,192,122,70
15712,115,143,1995,98,21,77
15713,115,47,1995,157,86,71
15714,115,71,1995,11,6,5
15715,115,122,1995,263,171,92
15716,115,123,1995,17067,3397,13670
15717,115,7,1995,34,14,20
15718,115,160,1995,65,36,29
15719,115,58,1995,133,87,46
15720,115,124,1995,3604,1435,2169
15721,115,100,1995,86,39,47
15722,115,72,1995,9,3,6
15723,115,144,1995,660,267,393
15724,115,125,1995,320659,102126,218533
15725,115,150,1995,23874,11098,12776
15726,115,8,1995,77,34,43
15727,115,73,1995,11283,5962,5321
15728,115,101,1995,66,46,20
15729,115,162,1995,10027,2053,7974
15730,115,48,1995,435,250,185
15731,115,21,1995,20,10,10
15732,115,9,1995,2469,538,1931
15733,115,102,1995,36,20,16
15734,115,111,1995,72,41,31
15735,115,112,1995,124,63,61
15736,115,33,1995,2497,1196,1301
15737,115,61,1995,16592,8244,8348
15738,115,35,1995,631,320,311
15739,115,36,1995,1138,496,642
15740,115,126,1995,1512,833,679
15741,115,90,1995,16,7,9
15742,115,23,1995,377,196,181
15743,115,164,1995,1674,167,1507
15744,115,63,1995,1550,820,730
15745,115,127,1995,133,74,59
15746,115,165,1995,239,71,168
15747,115,37,1995,164,43,121
15748,115,128,1995,2874,1306,1568
15749,115,65,1995,478,238,240
15750,115,10,1995,600,323,277
15751,115,145,1995,1633,799,834
15752,115,148,1995,28635,9629,19006
15753,115,49,1995,95,40,55
15754,115,74,1995,2225,1195,1030
15755,115,25,1995,70,41,29
15756,115,60,1995,48,10,38
15757,115,93,1995,16,7,9
15758,115,146,1995,69,37,32
15759,115,26,1995,551,201,350
15760,115,130,1995,2882,1304,1578
15761,115,38,1995,1488,782,706
15762,115,27,1995,109,61,48
15763,115,50,1995,105771,56842,48929
15764,115,131,1995,1698,548,1150
15765,115,114,1995,69,21,48
15766,115,1,1995,97,65,32
15767,115,28,1995,51,37,14
15768,115,132,1995,12880,6317,6563
15769,115,133,1995,82744,34891,47853
15770,129,136,1995,0,0,0
15771,129,137,1995,0,0,0
15772,129,142,1995,0,0,0
15773,129,119,1995,0,0,0
15774,129,120,1995,0,0,0
15775,129,5,1995,0,0,0
15776,129,121,1995,0,0,0
15777,129,143,1995,0,0,0
15778,129,160,1995,0,0,0
15779,129,162,1995,0,0,0
15780,129,145,1995,0,0,0
15781,129,130,1995,0,0,0
15782,65,2,1995,37,11,26
15783,65,51,1995,359,169,190
15784,65,141,1995,12706,4811,7895
15785,65,52,1995,2355,1248,1107
15786,65,134,1995,1532,699,833
15787,65,103,1995,50810,26317,24493
15788,65,11,1995,657,306,351
15789,65,66,1995,3212,1735,1477
15790,65,12,1995,54,30,24
15791,65,78,1995,9,4,5
15792,65,13,1995,6,2,4
15793,65,3,1995,387,76,311
15794,65,79,1995,6,3,3
15795,65,29,1995,145,91,54
15796,65,67,1995,20333,10660,9673
15797,65,95,1995,5,2,3
15798,65,151,1995,49,17,32
15799,65,53,1995,867,432,435
15800,65,105,1995,17132,10385,6747
15801,65,30,1995,1959,930,1029
15802,65,152,1995,182,70,112
15803,65,116,1995,8,3,5
15804,65,153,1995,1528,914,614
15805,65,135,1995,685,298,387
15806,65,136,1995,11,3,8
15807,65,106,1995,14194,7745,6449
15808,65,172,1995,4349,2058,2291
15809,65,107,1995,21683,13932,7751
15810,65,137,1995,294,88,206
15811,65,96,1995,778,435,343
15812,65,54,1995,348,164,184
15813,65,81,1995,28314,16056,12258
15814,65,14,1995,165,79,86
15815,65,31,1995,958,587,371
15816,65,176,1995,27,13,14
15817,65,137,1995,950,377,573
15818,65,39,1995,4479,2410,2069
15819,65,118,1995,3,1,2
15820,65,82,1995,408,297,111
15821,65,83,1995,21654,15728,5926
15822,65,108,1995,11606,6508,5098
15823,65,142,1995,1267,409,858
15824,65,97,1995,1441,951,490
15825,65,138,1995,7506,4338,3168
15826,65,119,1995,10,4,6
15827,65,40,1995,58,36,22
15828,65,120,1995,174,74,100
15829,65,42,1995,3868,2229,1639
15830,65,68,1995,113860,60726,53134
15831,65,139,1995,34,18,16
15832,65,155,1995,3557,1004,2553
15833,65,15,1995,257,122,135
15834,65,69,1995,100172,51647,48525
15835,65,156,1995,736,194,542
15836,65,56,1995,806,324,482
15837,65,84,1995,90,46,44
15838,65,98,1995,1214,782,432
15839,65,157,1995,2825,1353,1472
15840,65,158,1995,869,142,727
15841,65,110,1995,13,8,5
15842,65,85,1995,58,28,30
15843,65,99,1995,1515,1043,472
15844,65,32,1995,770,450,320
15845,65,43,1995,227,126,101
15846,65,5,1995,5084,2399,2685
15847,65,6,1995,2159,835,1324
15848,65,16,1995,786,278,508
15849,65,44,1995,2622,1433,1189
15850,65,17,1995,796,270,526
15851,65,57,1995,16048,6124,9924
15852,65,86,1995,31,19,12
15853,65,177,1995,2027,1053,974
15854,65,18,1995,1069,228,841
15855,65,167,1995,20,13,7
15856,65,121,1995,303,169,134
15857,65,19,1995,63,25,38
15858,65,168,1995,26,17,9
15859,65,46,1995,98,53,45
15860,65,20,1995,1482,388,1094
15861,65,159,1995,870,196,674
15862,65,143,1995,118,43,75
15863,65,70,1995,78,47,31
15864,65,47,1995,104,55,49
15865,65,71,1995,783,413,370
15866,65,122,1995,60,42,18
15867,65,123,1995,6,3,3
15868,65,160,1995,709,82,627
15869,65,58,1995,119,67,52
15870,65,161,1995,1154,232,922
15871,65,124,1995,29,14,15
15872,65,100,1995,11659,6756,4903
15873,65,72,1995,124,57,67
15874,65,59,1995,0,0,0
15875,65,144,1995,165214,70492,94722
15876,65,125,1995,153,86,67
15877,65,150,1995,12,7,5
15878,65,8,1995,67,34,33
15879,65,73,1995,17094,9036,8058
15880,65,101,1995,1240,709,531
15881,65,162,1995,1884,466,1418
15882,65,60,1995,81,36,45
15883,65,48,1995,4036,2201,1835
15884,65,21,1995,3,1,2
15885,65,9,1995,3186,672,2514
15886,65,102,1995,1407,792,615
15887,65,111,1995,1090,654,436
15888,65,112,1995,25606,15146,10460
15889,65,33,1995,5725,2889,2836
15890,65,61,1995,42238,21728,20510
15891,65,22,1995,8,3,5
15892,65,35,1995,4375,2039,2336
15893,65,36,1995,4699,2709,1990
15894,65,126,1995,36,13,23
15895,65,91,1995,6,3,3
15896,65,62,1995,15,7,8
15897,65,140,1995,22,12,10
15898,65,23,1995,194,72,122
15899,65,164,1995,4574,869,3705
15900,65,63,1995,0,0,0
15901,65,127,1995,6,4,2
15902,65,165,1995,391,90,301
15903,65,37,1995,212,111,101
15904,65,64,1995,109,63,46
15905,65,128,1995,28,9,19
15906,65,115,1995,914,461,453
15907,65,10,1995,69,31,38
15908,65,145,1995,55,16,39
15909,65,113,1995,18,12,6
15910,65,49,1995,7207,4112,3095
15911,65,74,1995,38443,19241,19202
15912,65,25,1995,2245,557,1688
15913,65,169,1995,3,2,1
15914,65,166,1995,65,17,48
15915,65,93,1995,21,13,8
15916,65,146,1995,718,247,471
15917,65,26,1995,590,203,387
15918,65,170,1995,2,2,0
15919,65,130,1995,17,9,8
15920,65,38,1995,1038,582,456
15921,65,27,1995,22,11,11
15922,65,50,1995,74249,39309,34940
15923,65,131,1995,43,21,22
15924,65,114,1995,12691,6499,6192
15925,65,171,1995,41,25,16
15926,65,1,1995,423,225,198
15927,65,28,1995,4,1,3
15928,65,132,1995,21,11,10
15929,65,133,1995,35,18,17
15930,10,2,1995,15,2,13
15931,10,13,1995,50,10,40
15932,10,3,1995,85,10,75
15933,10,4,1995,28,5,23
15934,10,172,1995,312,27,285
15935,10,14,1995,31,6,25
15936,10,42,1995,6,1,5
15937,10,68,1995,78,26,52
15938,10,69,1995,83,19,64
15939,10,56,1995,11,2,9
15940,10,85,1995,3,0,3
15941,10,5,1995,35506,16645,18861
15942,10,6,1995,12,2,10
15943,10,16,1995,4,0,4
15944,10,17,1995,5,0,5
15945,10,57,1995,637,119,518
15946,10,177,1995,107,23,84
15947,10,18,1995,34,7,27
15948,10,19,1995,224,49,175
15949,10,20,1995,94,20,74
15950,10,143,1995,4,0,4
15951,10,7,1995,193,44,149
15952,10,21,1995,41,9,32
15953,10,8,1995,43,6,37
15954,10,48,1995,14,2,12
15955,10,9,1995,248,89,159
15956,10,61,1995,0,0,0
15957,10,22,1995,34,6,28
15958,10,36,1995,18,4,14
15959,10,23,1995,167,35,132
15960,10,127,1995,2,0,2
15961,10,115,1995,33,8,25
15962,10,65,1995,3,0,3
15963,10,49,1995,39,13,26
15964,10,74,1995,39,8,31
15965,10,25,1995,8,1,7
15966,10,27,1995,215,45,170
15967,10,26,1995,4,0,4
15968,10,142,1995,15,2,13
15969,10,50,1995,182,46,136
15970,145,136,1995,85807,43069,42738
15971,145,172,1995,1711,829,882
15972,145,137,1995,13976,6823,7153
15973,145,120,1995,496740,258412,238328
15974,145,119,1995,287519,136703,150816
15975,145,5,1995,2304,1116,1188
15976,145,121,1995,6241,3026,3215
15977,145,143,1995,2439,1184,1255
15978,145,160,1995,1079,523,556
15979,145,162,1995,23677,11478,12199
15980,145,128,1995,122,61,61
15981,145,129,1995,0,0,0
15982,145,130,1995,57771,28589,29182
15983,145,142,1995,21886,10611,11275
15984,113,105,1995,2594,1190,1404
15985,113,172,1995,2538,1164,1374
15986,113,110,1995,6317,2897,3420
15987,113,73,1995,1621,743,878
15988,49,2,1995,3997,1768,2229
15989,49,51,1995,348,159,189
15990,49,141,1995,1567,529,1038
15991,49,52,1995,0,0,0
15992,49,134,1995,403,221,182
15993,49,76,1995,7,1,6
15994,49,103,1995,2270,1137,1133
15995,49,11,1995,317,166,151
15996,49,66,1995,5614,2463,3151
15997,49,12,1995,176,125,51
15998,49,78,1995,14,2,12
15999,49,13,1995,50,19,31
16000,49,3,1995,2738,1259,1479
16001,49,79,1995,94,26,68
16002,49,29,1995,418,276,142
16003,49,67,1995,1119,545,574
16004,49,95,1995,5,0,5
16005,49,151,1995,20,8,12
16006,49,4,1995,9,1,8
16007,49,53,1995,48046,24037,24009
16008,49,147,1995,45,29,16
16009,49,105,1995,3259,2019,1240
16010,49,30,1995,3271,1699,1572
16011,49,152,1995,31,11,20
16012,49,116,1995,77,36,41
16013,49,153,1995,274,149,125
16014,49,135,1995,100,33,67
16015,49,136,1995,26,5,21
16016,49,106,1995,25029,12437,12592
16017,49,172,1995,8212,4863,3349
16018,49,173,1995,523,300,223
16019,49,107,1995,6822,3173,3649
16020,49,117,1995,9,4,5
16021,49,137,1995,149,69,80
16022,49,96,1995,193,101,92
16023,49,54,1995,4875,2356,2519
16024,49,81,1995,1388,570,818
16025,49,14,1995,422,155,267
16026,49,31,1995,299,195,104
16027,49,176,1995,52,15,37
16028,49,137,1995,931,410,521
16029,49,39,1995,35611,17053,18558
16030,49,118,1995,53,31,22
16031,49,82,1995,42,20,22
16032,49,83,1995,228,113,115
16033,49,108,1995,885,429,456
16034,49,142,1995,1944,695,1249
16035,49,97,1995,2174,1034,1140
16036,49,138,1995,10,7,3
16037,49,119,1995,2847,1346,1501
16038,49,40,1995,9560,5406,4154
16039,49,148,1995,14,9,5
16040,49,120,1995,11103,5144,5959
16041,49,42,1995,182250,105579,76671
16042,49,68,1995,5223,2161,3062
16043,49,139,1995,3,0,3
16044,49,155,1995,2332,944,1388
16045,49,15,1995,123,72,51
16046,49,69,1995,35578,19631,15947
16047,49,156,1995,914,377,537
16048,49,55,1995,0,0,0
16049,49,56,1995,10118,4042,6076
16050,49,84,1995,37,5,32
16051,49,98,1995,613,288,325
16052,49,157,1995,104,40,64
16053,49,158,1995,72,27,45
16054,49,110,1995,98,61,37
16055,49,85,1995,99,43,56
16056,49,99,1995,195,98,97
16057,49,32,1995,13173,6424,6749
16058,49,43,1995,3291,1614,1677
16059,49,5,1995,10359,6183,4176
16060,49,6,1995,47650,21679,25971
16061,49,16,1995,46038,19961,26077
16062,49,44,1995,1033,401,632
16063,49,17,1995,1414,548,866
16064,49,57,1995,5909,1903,4006
16065,49,86,1995,181,75,106
16066,49,177,1995,2128,1248,880
16067,49,18,1995,995,431,564
16068,49,167,1995,161,110,51
16069,49,121,1995,1181,657,524
16070,49,19,1995,754,352,402
16071,49,168,1995,42,33,9
16072,49,46,1995,2149,1273,876
16073,49,20,1995,18685,8330,10355
16074,49,149,1995,19,13,6
16075,49,159,1995,520,270,250
16076,49,143,1995,348,125,223
16077,49,70,1995,0,0,0
16078,49,47,1995,731,431,300
16079,49,71,1995,111,59,52
16080,49,122,1995,68,46,22
16081,49,123,1995,37,17,20
16082,49,7,1995,6,3,3
16083,49,160,1995,47,9,38
16084,49,58,1995,81,37,44
16085,49,161,1995,18,1,17
16086,49,124,1995,124,80,44
16087,49,100,1995,1006,541,465
16088,49,72,1995,13,2,11
16089,49,59,1995,0,0,0
16090,49,144,1995,4188,1692,2496
16091,49,125,1995,182,115,67
16092,49,150,1995,44,20,24
16093,49,8,1995,143,66,77
16094,49,73,1995,4226,1776,2450
16095,49,101,1995,376,220,156
16096,49,162,1995,653,185,468
16097,49,60,1995,2202,1046,1156
16098,49,48,1995,39596,23195,16401
16099,49,21,1995,6,4,2
16100,49,9,1995,2890,1270,1620
16101,49,102,1995,187,91,96
16102,49,111,1995,121,63,58
16103,49,112,1995,4225,2201,2024
16104,49,33,1995,37413,24373,13040
16105,49,61,1995,2344,1058,1286
16106,49,22,1995,21,12,9
16107,49,35,1995,10980,5945,5035
16108,49,36,1995,6082,4012,2070
16109,49,126,1995,105,50,55
16110,49,90,1995,0,0,0
16111,49,91,1995,27,8,19
16112,49,92,1995,12,2,10
16113,49,62,1995,6,2,4
16114,49,140,1995,7,2,5
16115,49,23,1995,779,377,402
16116,49,164,1995,214,87,127
16117,49,63,1995,0,0,0
16118,49,127,1995,43,31,12
16119,49,165,1995,202,90,112
16120,49,37,1995,226,147,79
16121,49,64,1995,636,291,345
16122,49,128,1995,12198,5747,6451
16123,49,115,1995,947,412,535
16124,49,129,1995,0,0,0
16125,49,65,1995,4736,1934,2802
16126,49,10,1995,5458,3060,2398
16127,49,145,1995,662,290,372
16128,49,113,1995,19,10,9
16129,49,74,1995,2227,1020,1207
16130,49,25,1995,13205,6643,6562
16131,49,169,1995,60,38,22
16132,49,166,1995,216,84,132
16133,49,93,1995,218,123,95
16134,49,146,1995,2543,780,1763
16135,49,26,1995,29740,14078,15662
16136,49,170,1995,52,36,16
16137,49,130,1995,2231,1118,1113
16138,49,38,1995,1360,943,417
16139,49,27,1995,327,162,165
16140,49,50,1995,13616,4896,8720
16141,49,131,1995,788,403,385
16142,49,114,1995,2076,994,1082
16143,49,171,1995,144,92,52
16144,49,1,1995,10162,5315,4847
16145,49,28,1995,161,69,92
16146,49,132,1995,228,119,109
16147,49,133,1995,236,121,115
16148,74,2,1995,2243,832,1411
16149,74,51,1995,1316,593,723
16150,74,141,1995,5980,2250,3730
16151,74,52,1995,25,9,16
16152,74,134,1995,4232,1913,2319
16153,74,76,1995,49,18,31
16154,74,103,1995,5249,2567,2682
16155,74,11,1995,415,209,206
16156,74,66,1995,46395,27770,18625
16157,74,12,1995,225,115,110
16158,74,78,1995,79,36,43
16159,74,13,1995,150,67,83
16160,74,3,1995,1055,266,789
16161,74,79,1995,47,20,27
16162,74,29,1995,449,300,149
16163,74,67,1995,10118,5154,4964
16164,74,95,1995,28,12,16
16165,74,151,1995,276,98,178
16166,74,4,1995,56,24,32
16167,74,53,1995,39843,18991,20852
16168,74,147,1995,31,13,18
16169,74,105,1995,18838,12379,6459
16170,74,30,1995,3067,1906,1161
16171,74,152,1995,317,127,190
16172,74,116,1995,356,188,168
16173,74,153,1995,1287,609,678
16174,74,135,1995,3555,2090,1465
16175,74,136,1995,186,88,98
16176,74,106,1995,4967,2432,2535
16177,74,172,1995,9792,5467,4325
16178,74,107,1995,6475,3701,2774
16179,74,117,1995,17,7,10
16180,74,137,1995,2070,924,1146
16181,74,96,1995,505,283,222
16182,74,54,1995,18107,9244,8863
16183,74,81,1995,1585,870,715
16184,74,14,1995,234,88,146
16185,74,31,1995,9600,5210,4390
16186,74,176,1995,233,135,98
16187,74,137,1995,2594,1163,1431
16188,74,39,1995,3830,2174,1656
16189,74,118,1995,52,27,25
16190,74,82,1995,131,85,46
16191,74,83,1995,5976,4092,1884
16192,74,108,1995,2337,1333,1004
16193,74,142,1995,4155,1526,2629
16194,74,97,1995,428,235,193
16195,74,138,1995,23,10,13
16196,74,119,1995,2734,1021,1713
16197,74,40,1995,270,180,90
16198,74,148,1995,58,35,23
16199,74,120,1995,2441,1208,1233
16200,74,42,1995,3555,2469,1086
16201,74,68,1995,93526,48213,45313
16202,74,139,1995,157,91,66
16203,74,155,1995,314,32,282
16204,74,15,1995,369,184,185
16205,74,69,1995,201043,101102,99941
16206,74,156,1995,1683,801,882
16207,74,56,1995,5666,2465,3201
16208,74,84,1995,33,17,16
16209,74,98,1995,577,317,260
16210,74,157,1995,575,144,431
16211,74,158,1995,165,46,119
16212,74,110,1995,97,61,36
16213,74,85,1995,1120,704,416
16214,74,99,1995,315,195,120
16215,74,32,1995,11046,5433,5613
16216,74,43,1995,173,83,90
16217,74,5,1995,9984,4506,5478
16218,74,6,1995,5372,2267,3105
16219,74,16,1995,4104,1278,2826
16220,74,44,1995,1850,936,914
16221,74,17,1995,2141,894,1247
16222,74,57,1995,191945,81074,110871
16223,74,86,1995,491,261,230
16224,74,177,1995,4434,2809,1625
16225,74,18,1995,366,135,231
16226,74,167,1995,794,444,350
16227,74,121,1995,1939,1033,906
16228,74,19,1995,237,97,140
16229,74,168,1995,169,104,65
16230,74,46,1995,712,491,221
16231,74,20,1995,3861,1205,2656
16232,74,149,1995,66,34,32
16233,74,159,1995,286,114,172
16234,74,143,1995,683,260,423
16235,74,70,1995,2248,1310,938
16236,74,47,1995,548,360,188
16237,74,71,1995,1442,742,700
16238,74,122,1995,1034,592,442
16239,74,123,1995,59,26,33
16240,74,7,1995,38,9,29
16241,74,160,1995,227,79,148
16242,74,58,1995,164,82,82
16243,74,161,1995,78,23,55
16244,74,124,1995,1862,1293,569
16245,74,100,1995,3416,2012,1404
16246,74,72,1995,148,72,76
16247,74,59,1995,992,453,539
16248,74,144,1995,10113,5273,4840
16249,74,125,1995,809,417,392
16250,74,150,1995,157,76,81
16251,74,8,1995,502,204,298
16252,74,73,1995,15529,7986,7543
16253,74,101,1995,330,193,137
16254,74,162,1995,1817,520,1297
16255,74,60,1995,37897,16630,21267
16256,74,48,1995,1615,869,746
16257,74,21,1995,35,12,23
16258,74,9,1995,2427,748,1679
16259,74,102,1995,302,166,136
16260,74,111,1995,511,276,235
16261,74,112,1995,5665,3467,2198
16262,74,33,1995,12836,7267,5569
16263,74,61,1995,109787,47412,62375
16264,74,22,1995,29,10,19
16265,74,35,1995,7770,4550,3220
16266,74,36,1995,9048,5541,3507
16267,74,126,1995,673,340,333
16268,74,90,1995,0,0,0
16269,74,91,1995,47,17,30
16270,74,92,1995,0,0,0
16271,74,62,1995,0,0,0
16272,74,140,1995,38,20,18
16273,74,23,1995,513,224,289
16274,74,164,1995,1223,451,772
16275,74,63,1995,41386,18166,23220
16276,74,127,1995,168,114,54
16277,74,165,1995,322,85,237
16278,74,37,1995,4523,2695,1828
16279,74,64,1995,3005,1713,1292
16280,74,128,1995,2901,1245,1656
16281,74,115,1995,4606,2352,2254
16282,74,129,1995,0,0,0
16283,74,65,1995,47536,22213,25323
16284,74,10,1995,20205,8331,11874
16285,74,145,1995,554,209,345
16286,74,113,1995,71,44,27
16287,74,49,1995,6515,3479,3036
16288,74,25,1995,1718,648,1070
16289,74,169,1995,73,41,32
16290,74,166,1995,840,341,499
16291,74,93,1995,210,113,97
16292,74,146,1995,6249,1916,4333
16293,74,26,1995,54615,23604,31011
16294,74,170,1995,33,22,11
16295,74,130,1995,451,240,211
16296,74,38,1995,3109,2160,949
16297,74,27,1995,192,78,114
16298,74,50,1995,26763,12150,14613
16299,74,131,1995,570,285,285
16300,74,114,1995,1060,538,522
16301,74,171,1995,273,157,116
16302,74,1,1995,7764,3942,3822
16303,74,28,1995,229,94,135
16304,74,132,1995,216,105,111
16305,74,133,1995,598,313,285
16306,25,2,1995,92,45,47
16307,25,16,1995,3036,1508,1528
16308,25,128,1995,345,170,175
16309,25,145,1995,48,24,24
16310,169,2,1995,12248,6731,5517
16311,169,141,1995,160,89,71
16312,169,12,1995,209,128,81
16313,169,66,1995,79,44,35
16314,169,11,1995,221,134,87
16315,169,29,1995,771,454,317
16316,169,172,1995,60,25,35
16317,169,39,1995,161,69,92
16318,169,15,1995,753,368,385
16319,169,69,1995,166,77,89
16320,169,5,1995,760,311,449
16321,169,6,1995,1473,720,753
16322,169,16,1995,78,38,40
16323,169,167,1995,951,501,450
16324,169,176,1995,193,83,110
16325,169,168,1995,15292,7783,7509
16326,169,21,1995,46,25,21
16327,169,73,1995,63,40,23
16328,169,9,1995,144,74,70
16329,169,33,1995,47,25,22
16330,169,36,1995,294449,168141,126308
16331,169,74,1995,66,32,34
16332,169,26,1995,955,460,495
16333,169,170,1995,744,397,347
16334,169,38,1995,2520,1210,1310
16335,169,50,1995,387,141,246
16336,169,171,1995,12829,6912,5917
16337,169,132,1995,31,16,15
16338,131,134,1995,958,387,571
16339,131,147,1995,108,34,74
16340,131,116,1995,310644,155746,154898
16341,131,117,1995,458,182,276
16342,131,137,1995,22000,10851,11149
16343,131,137,1995,21834,11136,10698
16344,131,69,1995,769,327,442
16345,131,5,1995,6308,2717,3591
16346,131,57,1995,457,194,263
16347,131,121,1995,31740,18133,13607
16348,131,149,1995,106,34,72
16349,131,123,1995,7121,3260,3861
16350,131,124,1995,151,57,94
16351,131,125,1995,57995,28094,29901
16352,131,150,1995,494,195,299
16353,131,9,1995,517,215,302
16354,131,126,1995,600656,305662,294994
16355,131,127,1995,286,114,172
16356,131,128,1995,4247,2098,2149
16357,131,115,1995,547,215,332
16358,131,148,1995,69,22,47
16359,131,130,1995,15546,7430,8116
16360,131,50,1995,866,371,495
16361,131,132,1995,14501,7837,6664
16362,131,133,1995,652,262,390
16363,166,67,1995,28,9,19
16364,166,135,1995,376,143,233
16365,166,153,1995,21,9,12
16366,166,136,1995,385,131,254
16367,166,172,1995,278,54,224
16368,166,137,1995,138,56,82
16369,166,137,1995,312,166,146
16370,166,151,1995,26058,11673,14385
16371,166,138,1995,56,22,34
16372,166,68,1995,1523,717,806
16373,166,139,1995,484,226,258
16374,166,155,1995,574,263,311
16375,166,69,1995,87,50,37
16376,166,156,1995,19575,11765,7810
16377,166,157,1995,1749,832,917
16378,166,159,1995,91,47,44
16379,166,160,1995,2038,883,1155
16380,166,161,1995,76,45,31
16381,166,162,1995,11900,5240,6660
16382,166,158,1995,69,40,29
16383,166,126,1995,899,465,434
16384,166,140,1995,21,11,10
16385,166,164,1995,544,252,292
16386,166,165,1995,55,30,25
16387,166,152,1995,6908,3107,3801
16388,93,79,1995,2188,1053,1135
16389,93,172,1995,425,206,219
16390,93,81,1995,36,16,20
16391,93,69,1995,124,64,60
16392,93,84,1995,15066,8094,6972
16393,93,110,1995,4666,2756,1910
16394,93,5,1995,697,344,353
16395,93,86,1995,736,379,357
16396,93,162,1995,246,94,152
16397,93,91,1995,1185,575,610
16398,93,92,1995,10556,5805,4751
16399,93,50,1995,1958,982,976
16400,146,141,1995,13669,6796,6873
16401,146,135,1995,0,0,0
16402,146,68,1995,3841,1910,1931
16403,146,69,1995,896,446,450
16404,146,16,1995,0,0,0
16405,146,57,1995,1610,801,809
16406,146,143,1995,1215,604,611
16407,146,160,1995,198,98,100
16408,146,161,1995,374,185,189
16409,146,144,1995,7220,3590,3630
16410,146,162,1995,119,59,60
16411,146,164,1995,323,161,162
16412,146,25,1995,377,187,190
16413,146,142,1995,602,299,303
16414,26,2,1995,9633,4400,5233
16415,26,51,1995,1939,946,993
16416,26,141,1995,378,102,276
16417,26,12,1995,9832,4689,5143
16418,26,103,1995,82,40,42
16419,26,66,1995,10148,5108,5040
16420,26,3,1995,192,15,177
16421,26,11,1995,465,287,178
16422,26,67,1995,6415,3337,3078
16423,26,53,1995,7000,3184,3816
16424,26,105,1995,201,121,80
16425,26,30,1995,454518,235523,218995
16426,26,29,1995,175,132,43
16427,26,10,1995,21,3,18
16428,26,106,1995,25,16,9
16429,26,172,1995,1020,509,511
16430,26,107,1995,27,17,10
16431,26,137,1995,17,4,13
16432,26,96,1995,31,14,17
16433,26,54,1995,129,72,57
16434,26,81,1995,24,11,13
16435,26,14,1995,9419,4970,4449
16436,26,31,1995,663,326,337
16437,26,39,1995,1970,1006,964
16438,26,120,1995,34,20,14
16439,26,40,1995,65,40,25
16440,26,42,1995,978,519,459
16441,26,68,1995,12558,6294,6264
16442,26,15,1995,3813,2168,1645
16443,26,69,1995,215428,109128,106300
16444,26,156,1995,83,9,74
16445,26,56,1995,78316,41844,36472
16446,26,173,1995,33,17,16
16447,26,32,1995,304,175,129
16448,26,43,1995,24,12,12
16449,26,5,1995,304,112,192
16450,26,6,1995,13188,5084,8104
16451,26,16,1995,21033,9419,11614
16452,26,44,1995,314,157,157
16453,26,17,1995,1592,756,836
16454,26,57,1995,2298,1015,1283
16455,26,177,1995,1415,739,676
16456,26,167,1995,2926,1593,1333
16457,26,18,1995,525,186,339
16458,26,121,1995,101,35,66
16459,26,176,1995,17,7,10
16460,26,19,1995,167,57,110
16461,26,168,1995,1025,439,586
16462,26,20,1995,662,328,334
16463,26,46,1995,37,24,13
16464,26,143,1995,1798,763,1035
16465,26,47,1995,152,91,61
16466,26,71,1995,26,13,13
16467,26,58,1995,24,15,9
16468,26,100,1995,89,45,44
16469,26,144,1995,274,108,166
16470,26,21,1995,14,8,6
16471,26,73,1995,15095,7619,7476
16472,26,162,1995,170,22,148
16473,26,48,1995,2081,1047,1034
16474,26,9,1995,666,263,403
16475,26,112,1995,31,18,13
16476,26,33,1995,1999,1039,960
16477,26,61,1995,131,66,65
16478,26,22,1995,18,6,12
16479,26,35,1995,12145,7131,5014
16480,26,36,1995,14936,8138,6798
16481,26,23,1995,3712,1753,1959
16482,26,164,1995,39,14,25
16483,26,37,1995,184,96,88
16484,26,1,1995,17,10,7
16485,26,64,1995,85,44,41
16486,26,128,1995,14,0,14
16487,26,115,1995,172,81,91
16488,26,65,1995,707,366,341
16489,26,145,1995,132,32,100
16490,26,148,1995,44,28,16
16491,26,49,1995,3124,1648,1476
16492,26,74,1995,8867,4555,4312
16493,26,25,1995,5106,2549,2557
16494,26,169,1995,155,36,119
16495,26,27,1995,1689,796,893
16496,26,146,1995,297,114,183
16497,26,170,1995,1190,328,862
16498,26,38,1995,2447,1687,760
16499,26,60,1995,84307,43247,41060
16500,26,142,1995,1514,647,867
16501,26,50,1995,12029,6346,5683
16502,26,131,1995,129,13,116
16503,26,114,1995,25,11,14
16504,26,171,1995,4632,2366,2266
16505,26,28,1995,39,15,24
16506,170,2,1995,3210,1826,1384
16507,170,12,1995,9633,4839,4794
16508,170,11,1995,9193,4555,4638
16509,170,29,1995,2662,914,1748
16510,170,69,1995,1280,728,552
16511,170,6,1995,2204,1085,1119
16512,170,167,1995,25385,12689,12696
16513,170,36,1995,98709,52244,46465
16514,170,169,1995,21432,12195,9237
16515,170,38,1995,10354,4934,5420
16516,170,171,1995,87778,44797,42981
16517,94,78,1995,649,307,342
16518,94,83,1995,520,235,285
16519,94,85,1995,3567,1754,1813
16520,94,50,1995,316,149,167
16521,130,141,1995,33,7,26
16522,130,3,1995,46,38,8
16523,130,67,1995,41,18,23
16524,130,116,1995,46279,17781,28498
16525,130,172,1995,129,38,91
16526,130,137,1995,73273,38342,34931
16527,130,81,1995,136,28,108
16528,130,39,1995,161,75,86
16529,130,120,1995,175,87,88
16530,130,119,1995,0,0,0
16531,130,68,1995,228,81,147
16532,130,155,1995,27,0,27
16533,130,69,1995,214,96,118
16534,130,156,1995,27,18,9
16535,130,56,1995,37,18,19
16536,130,32,1995,9,8,1
16537,130,5,1995,1244,373,871
16538,130,57,1995,369,33,336
16539,130,177,1995,64,18,46
16540,130,121,1995,30640,17714,12926
16541,130,176,1995,48,8,40
16542,130,143,1995,46,28,18
16543,130,123,1995,174,85,89
16544,130,161,1995,36,8,28
16545,130,125,1995,214,117,97
16546,130,73,1995,197,94,103
16547,130,162,1995,108,64,44
16548,130,48,1995,8,0,8
16549,130,9,1995,204,38,166
16550,130,36,1995,279,150,129
16551,130,126,1995,131974,63523,68451
16552,130,164,1995,54,11,43
16553,130,128,1995,1007,436,571
16554,130,133,1995,79,37,42
16555,130,65,1995,55,35,20
16556,130,129,1995,0,0,0
16557,130,145,1995,268735,135573,133162
16558,130,49,1995,27,0,27
16559,130,166,1995,99,41,58
16560,130,142,1995,41,8,33
16561,130,50,1995,979,478,501
16562,130,131,1995,29873,13342,16531
16563,130,132,1995,183,103,80
16564,38,2,1995,2468,571,1897
16565,38,12,1995,87250,43917,43333
16566,38,11,1995,44340,21328,23012
16567,38,30,1995,2026,678,1348
16568,38,29,1995,339992,197047,142945
16569,38,172,1995,7666,2854,4812
16570,38,40,1995,11068,5914,5154
16571,38,15,1995,74660,38536,36124
16572,38,69,1995,1265,604,661
16573,38,5,1995,4459,903,3556
16574,38,6,1995,2496,479,2017
16575,38,17,1995,4384,2207,2177
16576,38,167,1995,290731,163623,127108
16577,38,18,1995,4340,101,4239
16578,38,168,1995,33724,18835,14889
16579,38,20,1995,2062,117,1945
16580,38,46,1995,21108,11278,9830
16581,38,47,1995,26437,14125,12312
16582,38,144,1995,2031,593,1438
16583,38,33,1995,3597,2012,1585
16584,38,36,1995,4355392,2525437,1829955
16585,38,1,1995,14476,6367,8109
16586,38,25,1995,4347,175,4172
16587,38,169,1995,34009,18331,15678
16588,38,26,1995,1583,232,1351
16589,38,170,1995,28347,15715,12632
16590,38,171,1995,190478,100537,89941
16591,27,2,1995,2088,592,1496
16592,27,13,1995,498,329,169
16593,27,3,1995,219911,31631,188280
16594,27,10,1995,43576,26887,16689
16595,27,136,1995,1361,386,975
16596,27,120,1995,3470,984,2486
16597,27,119,1995,4928,1398,3530
16598,27,68,1995,1118,475,643
16599,27,5,1995,667853,161793,506060
16600,27,18,1995,35757,13093,22664
16601,27,19,1995,16904,4843,12061
16602,27,20,1995,7065,2004,5061
16603,27,144,1995,2496,707,1789
16604,27,8,1995,2217,628,1589
16605,27,73,1995,1346,703,643
16606,27,162,1995,1815,515,1300
16607,27,9,1995,225750,53397,172353
16608,27,22,1995,131,96,35
16609,27,23,1995,1005,353,652
16610,27,128,1995,3304,937,2367
16611,27,129,1995,5187,1843,3344
16612,27,145,1995,42130,14975,27155
16613,27,25,1995,17252,4895,12357
16614,27,146,1995,1505,426,1079
16615,27,26,1995,12534,3556,8978
16616,27,142,1995,207924,70836,137088
16617,27,50,1995,12845,4970,7875
16618,27,28,1995,57044,16185,40859
16619,50,2,1995,8160,2723,5437
16620,50,51,1995,1181,433,748
16621,50,141,1995,6898,2121,4777
16622,50,52,1995,15,5,10
16623,50,134,1995,3243,1593,1650
16624,50,75,1995,377,193,184
16625,50,76,1995,2135,1135,1000
16626,50,103,1995,3722,2068,1654
16627,50,11,1995,323,168,155
16628,50,77,1995,437,243,194
16629,50,66,1995,19373,13796,5577
16630,50,12,1995,307,155,152
16631,50,78,1995,984,503,481
16632,50,13,1995,2295,1100,1195
16633,50,3,1995,124761,59936,64825
16634,50,79,1995,21135,10764,10371
16635,50,29,1995,703,360,343
16636,50,67,1995,18359,11323,7036
16637,50,95,1995,1182,790,392
16638,50,151,1995,127,59,68
16639,50,4,1995,48,15,33
16640,50,53,1995,4108,2034,2074
16641,50,147,1995,1948,905,1043
16642,50,105,1995,12033,7071,4962
16643,50,30,1995,3395,1791,1604
16644,50,152,1995,52,20,32
16645,50,116,1995,1107,582,525
16646,50,153,1995,180,95,85
16647,50,135,1995,1773,870,903
16648,50,80,1995,591,329,262
16649,50,136,1995,101,25,76
16650,50,106,1995,2817,1517,1300
16651,50,172,1995,83030,42842,40188
16652,50,173,1995,72931,35422,37509
16653,50,107,1995,8660,5262,3398
16654,50,117,1995,33,17,16
16655,50,137,1995,1793,900,893
16656,50,96,1995,200,110,90
16657,50,54,1995,4290,2229,2061
16658,50,81,1995,592,317,275
16659,50,14,1995,75065,36553,38512
16660,50,31,1995,10086,6331,3755
16661,50,176,1995,5,0,5
16662,50,137,1995,4698,2238,2460
16663,50,39,1995,15833,9917,5916
16664,50,118,1995,131,66,65
16665,50,82,1995,3697,1875,1822
16666,50,83,1995,285,143,142
16667,50,108,1995,1665,899,766
16668,50,142,1995,22933,10637,12296
16669,50,97,1995,322,191,131
16670,50,138,1995,29,15,14
16671,50,119,1995,3593,1842,1751
16672,50,40,1995,1233,590,643
16673,50,148,1995,469,236,233
16674,50,120,1995,4269,2151,2118
16675,50,41,1995,150,87,63
16676,50,42,1995,7993,6004,1989
16677,50,68,1995,71537,43545,27992
16678,50,139,1995,70,36,34
16679,50,155,1995,2553,1151,1402
16680,50,15,1995,303,152,151
16681,50,69,1995,233229,136729,96500
16682,50,156,1995,42703,22027,20676
16683,50,55,1995,9279,4798,4481
16684,50,56,1995,23935,11017,12918
16685,50,84,1995,5367,2782,2585
16686,50,98,1995,272,158,114
16687,50,157,1995,144,60,84
16688,50,158,1995,211,99,112
16689,50,110,1995,19912,11213,8699
16690,50,85,1995,86,54,32
16691,50,99,1995,233,137,96
16692,50,32,1995,12352,5691,6661
16693,50,43,1995,947,488,459
16694,50,5,1995,422284,217442,204842
16695,50,6,1995,36022,15179,20843
16696,50,16,1995,22970,8840,14130
16697,50,44,1995,559011,307191,251820
16698,50,45,1995,8238,4263,3975
16699,50,17,1995,11621,5592,6029
16700,50,57,1995,95453,47635,47818
16701,50,86,1995,139059,73411,65648
16702,50,177,1995,31661,18227,13434
16703,50,18,1995,2712,1014,1698
16704,50,167,1995,480,304,176
16705,50,121,1995,116551,57228,59323
16706,50,19,1995,3223,1440,1783
16707,50,168,1995,72,47,25
16708,50,46,1995,2623,1031,1592
16709,50,20,1995,9330,3925,5405
16710,50,149,1995,180,104,76
16711,50,159,1995,864,363,501
16712,50,143,1995,7588,3227,4361
16713,50,70,1995,16,11,5
16714,50,47,1995,2675,1235,1440
16715,50,71,1995,926,496,430
16716,50,122,1995,433,272,161
16717,50,123,1995,11110,5458,5652
16718,50,7,1995,107,53,54
16719,50,160,1995,65,27,38
16720,50,58,1995,29655,15458,14197
16721,50,161,1995,15,5,10
16722,50,124,1995,24326,11740,12586
16723,50,100,1995,2769,1491,1278
16724,50,72,1995,136,58,78
16725,50,59,1995,447,201,246
16726,50,87,1995,5069,2839,2230
16727,50,144,1995,10312,4541,5771
16728,50,125,1995,1840,941,899
16729,50,150,1995,677,333,344
16730,50,8,1995,3257,1023,2234
16731,50,73,1995,33722,19091,14631
16732,50,101,1995,124,79,45
16733,50,162,1995,65168,32680,32488
16734,50,60,1995,787,452,335
16735,50,48,1995,10835,6471,4364
16736,50,21,1995,1108,419,689
16737,50,9,1995,267177,130039,137138
16738,50,102,1995,269,154,115
16739,50,111,1995,275,144,131
16740,50,112,1995,2231,1359,872
16741,50,33,1995,64757,30502,34255
16742,50,61,1995,27105,14256,12849
16743,50,22,1995,582,262,320
16744,50,35,1995,5579,2860,2719
16745,50,36,1995,9605,5483,4122
16746,50,126,1995,1301,700,601
16747,50,90,1995,3575,1847,1728
16748,50,91,1995,4534,2434,2100
16749,50,92,1995,3889,1973,1916
16750,50,140,1995,48,34,14
16751,50,23,1995,6294,2914,3380
16752,50,164,1995,396,170,226
16753,50,63,1995,3588,1745,1843
16754,50,127,1995,2828,1664,1164
16755,50,165,1995,11228,6018,5210
16756,50,37,1995,3236,2410,826
16757,50,64,1995,756,433,323
16758,50,128,1995,23882,12552,11330
16759,50,115,1995,100971,53371,47600
16760,50,65,1995,44874,26036,18838
16761,50,10,1995,51624,22945,28679
16762,50,145,1995,5854,2531,3323
16763,50,113,1995,144,80,64
16764,50,49,1995,16159,10616,5543
16765,50,74,1995,13797,8753,5044
16766,50,25,1995,3366,1357,2009
16767,50,169,1995,54,27,27
16768,50,166,1995,300,114,186
16769,50,93,1995,18728,11318,7410
16770,50,146,1995,2644,980,1664
16771,50,26,1995,38795,17124,21671
16772,50,170,1995,51,32,19
16773,50,94,1995,70,36,34
16774,50,130,1995,51083,24745,26338
16775,50,38,1995,7311,2835,4476
16776,50,27,1995,2965,1244,1721
16777,50,131,1995,30079,14519,15560
16778,50,114,1995,530,284,246
16779,50,171,1995,287,154,133
16780,50,1,1995,20943,10808,10135
16781,50,28,1995,6857,2806,4051
16782,50,132,1995,18532,9602,8930
16783,50,133,1995,34085,18262,15823
16784,114,103,1995,17970,10678,7292
16785,114,105,1995,11084,4704,6380
16786,114,106,1995,1299,674,625
16787,114,68,1995,840,437,403
16788,114,69,1995,2205,1204,1001
16789,114,57,1995,14943,7873,7070
16790,114,100,1995,657,346,311
16791,114,111,1995,1199,406,793
16792,114,112,1995,240,95,145
16793,114,33,1995,2465,1373,1092
16794,114,61,1995,877,512,365
16795,114,35,1995,748,375,373
16796,114,65,1995,29447,15689,13758
16797,114,50,1995,523,283,240
16798,171,12,1995,22987,11565,11422
16799,171,11,1995,8402,4324,4078
16800,171,29,1995,33291,17822,15469
16801,171,69,1995,14711,8242,6469
16802,171,167,1995,25111,14432,10679
16803,171,168,1995,5238,2843,2395
16804,171,36,1995,1161963,663391,498572
16805,171,169,1995,8292,4173,4119
16806,171,170,1995,551,239,312
16807,171,38,1995,153360,86007,67353
16808,1,3,1995,523,168,355
16809,1,10,1995,114,52,62
16810,1,172,1995,1192,542,650
16811,1,68,1995,53,16,37
16812,1,5,1995,350,176,174
16813,1,177,1995,224,79,145
16814,1,176,1995,228,104,124
16815,1,8,1995,299,149,150
16816,1,9,1995,70,24,46
16817,1,50,1995,1230,589,641
16818,28,120,1995,687,288,399
16819,28,119,1995,2500,1048,1452
16820,28,6,1995,0,0,0
16821,28,16,1995,5140,2086,3054
16822,28,1,1995,0,0,0
16823,28,128,1995,61684,26036,35648
16824,28,129,1995,0,0,0
16825,28,145,1995,19777,8203,11574
16826,28,25,1995,2318,1031,1287
16827,28,142,1995,8886,3895,4991
16828,132,134,1995,141001,70443,70558
16829,132,147,1995,228,142,86
16830,132,116,1995,271,138,133
16831,132,135,1995,13,2,11
16832,132,172,1995,128,35,93
16833,132,137,1995,456,251,205
16834,132,137,1995,31525,15197,16328
16835,132,68,1995,59,21,38
16836,132,69,1995,220,97,123
16837,132,156,1995,283,84,199
16838,132,5,1995,3854,1915,1939
16839,132,177,1995,137,44,93
16840,132,121,1995,328,118,210
16841,132,123,1995,12382,4809,7573
16842,132,160,1995,206,50,156
16843,132,125,1995,3127,1610,1517
16844,132,150,1995,473,217,256
16845,132,162,1995,148,43,105
16846,132,126,1995,2285,1065,1220
16847,132,164,1995,138,19,119
16848,132,115,1995,2660,1292,1368
16849,132,133,1995,23707,12278,11429
16850,132,130,1995,359,138,221
16851,132,142,1995,139,59,80
16852,132,50,1995,1434,647,787
16853,132,131,1995,6172,2717,3455
16854,133,147,1995,2924,1256,1668
16855,133,123,1995,67945,29183,38762
16856,133,125,1995,266322,114387,151935
16857,133,115,1995,15313,6577,8736
16858,133,50,1995,18132,7788,10344
16859,133,132,1995,22815,9799,13016
16860,2,9,2000,26343,11475,14868
16861,2,169,2000,32929,14343,18586
16862,2,171,2000,1646,717,929
16863,51,56,2000,46575,26217,20358
16864,51,57,2000,13113,6564,6549
16865,51,26,2000,2892,983,1909
16866,51,60,2000,787,433,354
16867,141,68,2000,556,304,252
16868,141,69,2000,778,497,281
16869,141,16,2000,7579,3807,3772
16870,141,57,2000,740,438,302
16871,141,18,2000,2258,1025,1233
16872,141,19,2000,1196,397,799
16873,141,20,2000,1225,721,504
16874,141,143,2000,2325,1058,1267
16875,141,36,2000,802,451,351
16876,141,23,2000,3926,1454,2472
16877,141,128,2000,11570,5001,6569
16878,141,145,2000,1597,722,875
16879,141,25,2000,3073,1396,1677
16880,141,50,2000,800,447,353
16881,141,28,2000,2366,961,1405
16882,52,103,2000,151,71,80
16883,52,67,2000,241,114,127
16884,52,106,2000,58,28,30
16885,52,39,2000,138,66,72
16886,52,68,2000,4298,2045,2253
16887,52,69,2000,355,169,186
16888,52,57,2000,151,71,80
16889,52,144,2000,471,224,247
16890,52,73,2000,229,108,121
16891,52,61,2000,6771,3222,3549
16892,52,65,2000,26841,12775,14066
16893,52,49,2000,49,23,26
16894,52,74,2000,74,35,39
16895,52,50,2000,907,431,476
16896,52,114,2000,77,37,40
16897,134,153,2000,4724,2343,2381
16898,134,136,2000,16,9,7
16899,134,137,2000,543,313,230
16900,134,137,2000,17735,9016,8719
16901,134,157,2000,173,97,76
16902,134,125,2000,128,63,65
16903,134,150,2000,457,232,225
16904,134,61,2000,7014,2727,4287
16905,134,126,2000,183,102,81
16906,134,140,2000,4121,2136,1985
16907,134,115,2000,3226,1640,1586
16908,134,132,2000,158,98,60
16909,75,83,2000,486,175,311
16910,75,110,2000,285,119,166
16911,75,86,2000,346,150,196
16912,75,87,2000,213,64,149
16913,75,90,2000,672,237,435
16914,75,50,2000,311,207,104
16915,76,78,2000,2,1,1
16916,76,79,2000,248,102,146
16917,76,95,2000,11,5,6
16918,76,172,2000,110,57,53
16919,76,81,2000,17,9,8
16920,76,82,2000,3898,2176,1722
16921,76,83,2000,1466,912,554
16922,76,120,2000,74,40,34
16923,76,68,2000,34,18,16
16924,76,109,2000,4,2,2
16925,76,69,2000,68,35,33
16926,76,156,2000,25,13,12
16927,76,84,2000,158,70,88
16928,76,110,2000,5317,2934,2383
16929,76,85,2000,27,14,13
16930,76,99,2000,6,3,3
16931,76,5,2000,65,33,32
16932,76,57,2000,59,30,29
16933,76,86,2000,3278,2179,1099
16934,76,177,2000,17,9,8
16935,76,20,2000,45,23,22
16936,76,100,2000,4,2,2
16937,76,87,2000,935,464,471
16938,76,73,2000,13,7,6
16939,76,77,2000,4,2,2
16940,76,162,2000,33,18,15
16941,76,9,2000,0,0,0
16942,76,88,2000,44,22,22
16943,76,90,2000,391,208,183
16944,76,75,2000,32,17,15
16945,76,91,2000,556,315,241
16946,76,92,2000,754,303,451
16947,76,115,2000,37,20,17
16948,76,65,2000,10,5,5
16949,76,113,2000,37,20,17
16950,76,25,2000,200,103,97
16951,76,93,2000,591,305,286
16952,76,94,2000,5,3,2
16953,76,142,2000,8,4,4
16954,76,50,2000,817,415,402
16955,103,2,2000,20,17,3
16956,103,51,2000,140,57,83
16957,103,141,2000,219,86,133
16958,103,52,2000,1,0,1
16959,103,134,2000,20,12,8
16960,103,66,2000,2146,1214,932
16961,103,13,2000,26,9,17
16962,103,11,2000,1178,595,583
16963,103,79,2000,16,15,1
16964,103,67,2000,1125,594,531
16965,103,105,2000,32925,18940,13985
16966,103,95,2000,12,10,2
16967,103,30,2000,618,345,273
16968,103,29,2000,637,359,278
16969,103,153,2000,49,30,19
16970,103,10,2000,6,0,6
16971,103,106,2000,205945,105503,100442
16972,103,172,2000,7432,3366,4066
16973,103,107,2000,3622,1898,1724
16974,103,137,2000,88,41,47
16975,103,96,2000,257,121,136
16976,103,54,2000,2067,1068,999
16977,103,81,2000,2319,1127,1192
16978,103,14,2000,99,54,45
16979,103,31,2000,3758,2363,1395
16980,103,39,2000,514,274,240
16981,103,82,2000,9,9,0
16982,103,83,2000,1434,1099,335
16983,103,108,2000,2004,1050,954
16984,103,97,2000,156,79,77
16985,103,120,2000,67,38,29
16986,103,40,2000,103,66,37
16987,103,42,2000,148,104,44
16988,103,68,2000,5996,3056,2940
16989,103,69,2000,9671,5281,4390
16990,103,55,2000,30,19,11
16991,103,56,2000,2136,1124,1012
16992,103,84,2000,23,23,0
16993,103,98,2000,201,107,94
16994,103,157,2000,1,1,0
16995,103,85,2000,86,26,60
16996,103,99,2000,139,74,65
16997,103,173,2000,9,0,9
16998,103,32,2000,1710,967,743
16999,103,43,2000,18,17,1
17000,103,5,2000,205,113,92
17001,103,6,2000,288,141,147
17002,103,16,2000,77,46,31
17003,103,44,2000,137,64,73
17004,103,17,2000,1169,595,574
17005,103,57,2000,210762,111486,99276
17006,103,86,2000,25,0,25
17007,103,177,2000,4550,2295,2255
17008,103,18,2000,152,55,97
17009,103,121,2000,6,4,2
17010,103,176,2000,29,0,29
17011,103,20,2000,1570,774,796
17012,103,46,2000,258,168,90
17013,103,143,2000,107,42,65
17014,103,70,2000,162,57,105
17015,103,47,2000,821,521,300
17016,103,71,2000,203,148,55
17017,103,122,2000,14,13,1
17018,103,58,2000,4,3,1
17019,103,100,2000,3040,1535,1505
17020,103,72,2000,21,20,1
17021,103,144,2000,444,263,181
17022,103,125,2000,23,23,0
17023,103,150,2000,4,0,4
17024,103,73,2000,810,374,436
17025,103,77,2000,1,1,0
17026,103,101,2000,190,96,94
17027,103,162,2000,89,63,26
17028,103,48,2000,123,29,94
17029,103,9,2000,10,0,10
17030,103,102,2000,338,151,187
17031,103,111,2000,315086,178223,136863
17032,103,112,2000,85411,49727,35684
17033,103,33,2000,13338,7760,5578
17034,103,61,2000,9046,4586,4460
17035,103,88,2000,159,91,68
17036,103,35,2000,2257,1265,992
17037,103,36,2000,3951,2186,1765
17038,103,62,2000,35,5,30
17039,103,23,2000,167,63,104
17040,103,1,2000,11,4,7
17041,103,64,2000,1699,887,812
17042,103,128,2000,4,0,4
17043,103,115,2000,264,142,122
17044,103,133,2000,3,3,0
17045,103,65,2000,130356,72974,57382
17046,103,145,2000,18,0,18
17047,103,113,2000,11,10,1
17048,103,49,2000,428,217,211
17049,103,74,2000,1663,825,838
17050,103,25,2000,2284,1097,1187
17051,103,93,2000,71,25,46
17052,103,146,2000,95,32,63
17053,103,26,2000,1331,688,643
17054,103,130,2000,1,1,0
17055,103,38,2000,8036,4299,3737
17056,103,60,2000,3123,1762,1361
17057,103,142,2000,498,227,271
17058,103,50,2000,1978,1041,937
17059,103,131,2000,1,0,1
17060,103,152,2000,24,20,4
17061,103,114,2000,113827,58000,55827
17062,103,132,2000,1,0,1
17063,11,12,2000,525188,303593,221595
17064,11,29,2000,743,490,253
17065,11,15,2000,46779,30739,16040
17066,11,69,2000,766,413,353
17067,11,56,2000,2073,1232,841
17068,11,6,2000,11205,6158,5047
17069,11,16,2000,2,1,1
17070,11,167,2000,913,662,251
17071,11,20,2000,1310,751,559
17072,11,36,2000,20363,14747,5616
17073,11,25,2000,3743,2098,1645
17074,11,26,2000,2270,1581,689
17075,11,170,2000,953,636,317
17076,11,38,2000,3008,2386,622
17077,11,171,2000,1335,940,395
17078,77,172,2000,622,292,330
17079,77,107,2000,7043,4232,2811
17080,77,82,2000,125,83,42
17081,77,83,2000,3615,2521,1094
17082,77,84,2000,276,213,63
17083,77,110,2000,297,140,157
17084,77,85,2000,1000,681,319
17085,77,5,2000,157,54,103
17086,77,86,2000,715,489,226
17087,77,73,2000,3674,1784,1890
17088,77,101,2000,77,41,36
17089,77,112,2000,939,432,507
17090,77,61,2000,188,85,103
17091,77,92,2000,131,90,41
17092,77,113,2000,1273,655,618
17093,77,26,2000,11,3,8
17094,66,2,2000,5966,1896,4070
17095,66,51,2000,2177,1061,1116
17096,66,141,2000,893,207,686
17097,66,52,2000,2,0,2
17098,66,134,2000,236,104,132
17099,66,76,2000,5,5,0
17100,66,103,2000,1054,507,547
17101,66,11,2000,2111,1010,1101
17102,66,77,2000,0,0,0
17103,66,12,2000,744,348,396
17104,66,78,2000,16,7,9
17105,66,13,2000,14,7,7
17106,66,3,2000,1894,611,1283
17107,66,79,2000,14,7,7
17108,66,29,2000,1153,827,326
17109,66,67,2000,1782,901,881
17110,66,95,2000,28,14,14
17111,66,151,2000,55,17,38
17112,66,4,2000,18,7,11
17113,66,53,2000,116023,56345,59678
17114,66,147,2000,18,10,8
17115,66,105,2000,3589,2255,1334
17116,66,30,2000,10888,5949,4939
17117,66,152,2000,84,36,48
17118,66,116,2000,67,27,40
17119,66,153,2000,28,16,12
17120,66,135,2000,453,163,290
17121,66,80,2000,0,0,0
17122,66,136,2000,9,3,6
17123,66,106,2000,870,448,422
17124,66,172,2000,12165,6550,5615
17125,66,173,2000,194,96,98
17126,66,174,2000,11,7,4
17127,66,107,2000,1086,634,452
17128,66,117,2000,0,0,0
17129,66,137,2000,316,136,180
17130,66,96,2000,124,75,49
17131,66,54,2000,54995,28414,26581
17132,66,81,2000,609,411,198
17133,66,14,2000,224,102,122
17134,66,31,2000,38058,22728,15330
17135,66,176,2000,1947,1180,767
17136,66,137,2000,485,210,275
17137,66,39,2000,982,541,441
17138,66,118,2000,5,2,3
17139,66,82,2000,35,25,10
17140,66,83,2000,2163,1491,672
17141,66,108,2000,457,249,208
17142,66,142,2000,10304,3662,6642
17143,66,97,2000,47,27,20
17144,66,138,2000,7,3,4
17145,66,119,2000,72,39,33
17146,66,40,2000,258,185,73
17147,66,148,2000,17,10,7
17148,66,120,2000,883,502,381
17149,66,41,2000,0,0,0
17150,66,42,2000,1106,777,329
17151,66,68,2000,6205,3296,2909
17152,66,139,2000,18,6,12
17153,66,155,2000,435,44,391
17154,66,15,2000,2295,1070,1225
17155,66,69,2000,126680,73875,52805
17156,66,156,2000,1712,704,1008
17157,66,55,2000,0,0,0
17158,66,56,2000,2770,969,1801
17159,66,84,2000,10,6,4
17160,66,98,2000,258,123,135
17161,66,157,2000,209,43,166
17162,66,158,2000,47,5,42
17163,66,110,2000,13,10,3
17164,66,85,2000,43,24,19
17165,66,99,2000,68,39,29
17166,66,32,2000,18097,11751,6346
17167,66,43,2000,130,69,61
17168,66,5,2000,9394,3791,5603
17169,66,6,2000,10723,4522,6201
17170,66,16,2000,3823,1397,2426
17171,66,44,2000,683,294,389
17172,66,17,2000,1774,753,1021
17173,66,57,2000,23325,13099,10226
17174,66,86,2000,144,80,64
17175,66,177,2000,2055,1405,650
17176,66,18,2000,518,153,365
17177,66,167,2000,763,461,302
17178,66,121,2000,680,446,234
17179,66,19,2000,175,61,114
17180,66,168,2000,449,288,161
17181,66,46,2000,559,374,185
17182,66,20,2000,1275,495,780
17183,66,149,2000,3,3,0
17184,66,159,2000,189,30,159
17185,66,143,2000,319,126,193
17186,66,70,2000,261,155,106
17187,66,47,2000,629,405,224
17188,66,71,2000,528,239,289
17189,66,122,2000,52,37,15
17190,66,123,2000,27,12,15
17191,66,7,2000,6,2,4
17192,66,160,2000,68,18,50
17193,66,58,2000,76,42,34
17194,66,161,2000,23,2,21
17195,66,124,2000,80,41,39
17196,66,100,2000,1046,590,456
17197,66,72,2000,18,9,9
17198,66,59,2000,15115,7453,7662
17199,66,144,2000,1333,586,747
17200,66,125,2000,47,25,22
17201,66,150,2000,127,74,53
17202,66,8,2000,406,142,264
17203,66,73,2000,5865,2913,2952
17204,66,101,2000,144,84,60
17205,66,162,2000,5872,1749,4123
17206,66,60,2000,15170,6647,8523
17207,66,48,2000,669,397,272
17208,66,21,2000,22,10,12
17209,66,9,2000,3331,1119,2212
17210,66,102,2000,43,26,17
17211,66,111,2000,158,88,70
17212,66,112,2000,1168,757,411
17213,66,33,2000,42528,23887,18641
17214,66,61,2000,1192,479,713
17215,66,88,2000,4,2,2
17216,66,22,2000,18,7,11
17217,66,35,2000,31368,18974,12394
17218,66,36,2000,21433,11667,9766
17219,66,126,2000,146,64,82
17220,66,90,2000,2,2,0
17221,66,91,2000,10,3,7
17222,66,92,2000,7,3,4
17223,66,62,2000,1,1,0
17224,66,140,2000,2,1,1
17225,66,23,2000,331,133,198
17226,66,164,2000,232,73,159
17227,66,63,2000,135065,66828,68237
17228,66,127,2000,30,17,13
17229,66,165,2000,185,42,143
17230,66,37,2000,18802,11736,7066
17231,66,64,2000,15986,9535,6451
17232,66,128,2000,841,322,519
17233,66,115,2000,1933,1047,886
17234,66,65,2000,2853,1499,1354
17235,66,10,2000,679,300,379
17236,66,145,2000,440,112,328
17237,66,113,2000,14,6,8
17238,66,49,2000,2457,1392,1065
17239,66,74,2000,10935,5729,5206
17240,66,25,2000,2297,832,1465
17241,66,169,2000,197,107,90
17242,66,166,2000,151,55,96
17243,66,93,2000,48,29,19
17244,66,146,2000,2554,747,1807
17245,66,26,2000,110695,50566,60129
17246,66,170,2000,97,62,35
17247,66,130,2000,189,87,102
17248,66,38,2000,5696,3899,1797
17249,66,27,2000,121,62,59
17250,66,50,2000,7622,3439,4183
17251,66,131,2000,109,51,58
17252,66,114,2000,195,103,92
17253,66,171,2000,522,281,241
17254,66,1,2000,2314,1195,1119
17255,66,28,2000,65,26,39
17256,66,132,2000,79,45,34
17257,66,133,2000,207,102,105
17258,12,2,2000,224,67,157
17259,12,11,2000,188400,106540,81860
17260,12,29,2000,554,432,122
17261,12,40,2000,586,316,270
17262,12,15,2000,61708,32784,28924
17263,12,69,2000,344,197,147
17264,12,6,2000,1846,695,1151
17265,12,167,2000,4370,2616,1754
17266,12,168,2000,3084,1636,1448
17267,12,36,2000,34703,24037,10666
17268,12,169,2000,300,183,117
17269,12,26,2000,2560,674,1886
17270,12,170,2000,2081,1195,886
17271,12,38,2000,3399,2549,850
17272,12,171,2000,20549,10938,9611
17273,78,76,2000,8,5,3
17274,78,103,2000,9,6,3
17275,78,66,2000,22,10,12
17276,78,79,2000,108,42,66
17277,78,67,2000,20,7,13
17278,78,147,2000,0,0,0
17279,78,105,2000,47,26,21
17280,78,95,2000,13,9,4
17281,78,30,2000,0,0,0
17282,78,80,2000,9,3,6
17283,78,10,2000,9,4,5
17284,78,106,2000,8,3,5
17285,78,172,2000,93,34,59
17286,78,107,2000,33,14,19
17287,78,96,2000,66,39,27
17288,78,81,2000,110,64,46
17289,78,39,2000,37,16,21
17290,78,82,2000,47,17,30
17291,78,83,2000,84,39,45
17292,78,108,2000,15,10,5
17293,78,97,2000,4,4,0
17294,78,40,2000,0,0,0
17295,78,68,2000,141,61,80
17296,78,69,2000,220,98,122
17297,78,156,2000,65,29,36
17298,78,56,2000,55,19,36
17299,78,84,2000,26,12,14
17300,78,98,2000,9,6,3
17301,78,110,2000,682,360,322
17302,78,85,2000,20628,8698,11930
17303,78,99,2000,13,7,6
17304,78,173,2000,25,9,16
17305,78,5,2000,229,98,131
17306,78,44,2000,69,26,43
17307,78,57,2000,94,37,57
17308,78,86,2000,3773,2478,1295
17309,78,177,2000,39,29,10
17310,78,121,2000,5,2,3
17311,78,100,2000,82,28,54
17312,78,73,2000,30,15,15
17313,78,101,2000,7,3,4
17314,78,162,2000,93,27,66
17315,78,48,2000,10,3,7
17316,78,9,2000,11,5,6
17317,78,102,2000,14,7,7
17318,78,112,2000,39,21,18
17319,78,33,2000,9,7,2
17320,78,61,2000,9,5,4
17321,78,35,2000,25,0,25
17322,78,36,2000,25,12,13
17323,78,90,2000,12,6,6
17324,78,91,2000,57,30,27
17325,78,92,2000,22,9,13
17326,78,115,2000,88,30,58
17327,78,133,2000,0,0,0
17328,78,65,2000,49,13,36
17329,78,148,2000,0,0,0
17330,78,49,2000,32,18,14
17331,78,74,2000,156,68,88
17332,78,93,2000,321,165,156
17333,78,94,2000,488,264,224
17334,78,130,2000,0,0,0
17335,78,38,2000,0,0,0
17336,78,142,2000,7,4,3
17337,78,50,2000,1705,737,968
17338,78,114,2000,2,2,0
17339,13,2,2000,258,80,178
17340,13,3,2000,28889,5268,23621
17341,13,10,2000,4391,2389,2002
17342,13,136,2000,169,51,118
17343,13,120,2000,430,133,297
17344,13,119,2000,610,189,421
17345,13,68,2000,180,82,98
17346,13,5,2000,88904,24351,64553
17347,13,18,2000,4609,1756,2853
17348,13,19,2000,2105,658,1447
17349,13,20,2000,875,270,605
17350,13,144,2000,308,95,213
17351,13,8,2000,274,85,189
17352,13,73,2000,140,66,74
17353,13,162,2000,224,69,155
17354,13,9,2000,29683,7807,21876
17355,13,22,2000,19,15,4
17356,13,23,2000,156,57,99
17357,13,128,2000,410,126,284
17358,13,129,2000,652,245,407
17359,13,145,2000,5299,1991,3308
17360,13,25,2000,2139,661,1478
17361,13,27,2000,1952,1093,859
17362,13,146,2000,186,57,129
17363,13,26,2000,1553,480,1073
17364,13,142,2000,25417,8916,16501
17365,13,50,2000,1378,543,835
17366,13,28,2000,7072,2188,4884
17367,3,13,2000,20661,9504,11157
17368,3,105,2000,10221,4701,5520
17369,3,172,2000,122691,56437,66254
17370,3,5,2000,22811,10493,12318
17371,3,177,2000,9618,4424,5194
17372,3,8,2000,13051,6003,7048
17373,3,48,2000,9804,4509,5295
17374,3,1,2000,18280,8408,9872
17375,3,50,2000,23021,10589,12432
17376,79,76,2000,267,176,91
17377,79,78,2000,64,35,29
17378,79,95,2000,0,0,0
17379,79,172,2000,0,0,0
17380,79,81,2000,0,0,0
17381,79,82,2000,534,359,175
17382,79,84,2000,668,429,239
17383,79,110,2000,3026,1782,1244
17384,79,85,2000,0,0,0
17385,79,5,2000,522,251,271
17386,79,86,2000,736,488,248
17387,79,90,2000,0,0,0
17388,79,91,2000,3924,2404,1520
17389,79,92,2000,4350,2464,1886
17390,79,113,2000,0,0,0
17391,79,93,2000,2070,1236,834
17392,79,50,2000,3535,1883,1652
17393,29,2,2000,292,93,199
17394,29,141,2000,55,9,46
17395,29,12,2000,14000,5927,8073
17396,29,103,2000,107,69,38
17397,29,66,2000,61,43,18
17398,29,11,2000,5944,2380,3564
17399,29,67,2000,38,15,23
17400,29,105,2000,97,70,27
17401,29,30,2000,63,30,33
17402,29,81,2000,46,3,43
17403,29,31,2000,99,69,30
17404,29,39,2000,206,84,122
17405,29,120,2000,25,1,24
17406,29,40,2000,3365,2220,1145
17407,29,42,2000,2190,1174,1016
17408,29,15,2000,8827,3731,5096
17409,29,69,2000,68,31,37
17410,29,56,2000,113,76,37
17411,29,32,2000,354,221,133
17412,29,5,2000,50,9,41
17413,29,6,2000,51,10,41
17414,29,44,2000,24,16,8
17415,29,17,2000,402,215,187
17416,29,57,2000,24,3,21
17417,29,167,2000,72587,37579,35008
17418,29,18,2000,30,1,29
17419,29,176,2000,62,43,19
17420,29,168,2000,5430,2803,2627
17421,29,20,2000,67,0,67
17422,29,46,2000,10880,7677,3203
17423,29,47,2000,18039,13273,4766
17424,29,48,2000,63,27,36
17425,29,9,2000,49,0,49
17426,29,33,2000,495,267,228
17427,29,35,2000,23,13,10
17428,29,36,2000,708011,391378,316633
17429,29,63,2000,37,13,24
17430,29,37,2000,27,18,9
17431,29,1,2000,381,201,180
17432,29,65,2000,37,19,18
17433,29,49,2000,352,169,183
17434,29,74,2000,29,16,13
17435,29,25,2000,86,0,86
17436,29,169,2000,5892,2879,3013
17437,29,27,2000,23,12,11
17438,29,26,2000,25,1,24
17439,29,170,2000,5670,2902,2768
17440,29,38,2000,234219,120887,113332
17441,29,50,2000,478,300,178
17442,29,114,2000,28,24,4
17443,29,171,2000,15344,7924,7420
17444,29,28,2000,33,6,27
17445,67,2,2000,60,29,31
17446,67,51,2000,2067,1011,1056
17447,67,141,2000,21519,9644,11875
17448,67,52,2000,0,0,0
17449,67,134,2000,658,285,373
17450,67,76,2000,0,0,0
17451,67,103,2000,1114,599,515
17452,67,11,2000,4,2,2
17453,67,66,2000,2486,1263,1223
17454,67,12,2000,5,2,3
17455,67,78,2000,6,6,0
17456,67,13,2000,27,0,27
17457,67,3,2000,1064,355,709
17458,67,79,2000,20,16,4
17459,67,29,2000,144,93,51
17460,67,95,2000,0,0,0
17461,67,151,2000,972,450,522
17462,67,4,2000,153,56,97
17463,67,53,2000,295,146,149
17464,67,147,2000,21,12,9
17465,67,105,2000,2958,1966,992
17466,67,30,2000,1111,667,444
17467,67,152,2000,472,182,290
17468,67,116,2000,1719,838,881
17469,67,153,2000,445,287,158
17470,67,135,2000,2174,1016,1158
17471,67,80,2000,0,0,0
17472,67,136,2000,196,84,112
17473,67,106,2000,4912,2412,2500
17474,67,172,2000,6757,3636,3121
17475,67,107,2000,2671,1682,989
17476,67,117,2000,0,0,0
17477,67,137,2000,3445,1597,1848
17478,67,96,2000,131,68,63
17479,67,54,2000,93,48,45
17480,67,81,2000,642,423,219
17481,67,14,2000,74,44,30
17482,67,31,2000,71,42,29
17483,67,176,2000,1623,961,662
17484,67,137,2000,46718,22725,23993
17485,67,39,2000,2783,1463,1320
17486,67,118,2000,73,35,38
17487,67,82,2000,93,44,49
17488,67,83,2000,1728,1192,536
17489,67,108,2000,1547,947,600
17490,67,142,2000,1570,465,1105
17491,67,97,2000,264,154,110
17492,67,138,2000,1191,552,639
17493,67,119,2000,1,0,1
17494,67,40,2000,55,30,25
17495,67,148,2000,0,0,0
17496,67,120,2000,1909,885,1024
17497,67,42,2000,2565,1551,1014
17498,67,68,2000,133707,69862,63845
17499,67,139,2000,296,142,154
17500,67,155,2000,187,67,120
17501,67,15,2000,176,89,87
17502,67,69,2000,72016,35046,36970
17503,67,156,2000,2801,1343,1458
17504,67,55,2000,0,0,0
17505,67,56,2000,16857,7847,9010
17506,67,84,2000,0,0,0
17507,67,98,2000,5493,2246,3247
17508,67,157,2000,767,239,528
17509,67,158,2000,117,64,53
17510,67,110,2000,88,65,23
17511,67,85,2000,1725,825,900
17512,67,99,2000,93,61,32
17513,67,32,2000,1832,1059,773
17514,67,43,2000,112,61,51
17515,67,5,2000,7298,3039,4259
17516,67,6,2000,1731,881,850
17517,67,16,2000,45,21,24
17518,67,44,2000,2697,1476,1221
17519,67,17,2000,3827,1736,2091
17520,67,57,2000,146188,66525,79663
17521,67,86,2000,255,161,94
17522,67,177,2000,3878,1977,1901
17523,67,18,2000,66,32,34
17524,67,167,2000,10,5,5
17525,67,121,2000,518,303,215
17526,67,19,2000,136,58,78
17527,67,168,2000,5,2,3
17528,67,46,2000,72,46,26
17529,67,20,2000,2725,1063,1662
17530,67,149,2000,8,5,3
17531,67,159,2000,358,107,251
17532,67,143,2000,208,81,127
17533,67,70,2000,3,2,1
17534,67,47,2000,73,47,26
17535,67,71,2000,11679,4885,6794
17536,67,122,2000,1016,748,268
17537,67,123,2000,27,11,16
17538,67,7,2000,2,2,0
17539,67,160,2000,260,121,139
17540,67,58,2000,249,128,121
17541,67,161,2000,837,179,658
17542,67,124,2000,3755,2781,974
17543,67,100,2000,1579,986,593
17544,67,72,2000,77,31,46
17545,67,59,2000,9,4,5
17546,67,144,2000,232447,109867,122580
17547,67,125,2000,180,144,36
17548,67,150,2000,29,16,13
17549,67,8,2000,38,18,20
17550,67,73,2000,84345,38962,45383
17551,67,101,2000,130,95,35
17552,67,162,2000,1382,533,849
17553,67,60,2000,155,71,84
17554,67,48,2000,1165,552,613
17555,67,21,2000,2,2,0
17556,67,9,2000,4270,1589,2681
17557,67,102,2000,102,68,34
17558,67,111,2000,161,107,54
17559,67,112,2000,1798,1140,658
17560,67,33,2000,8125,5234,2891
17561,67,61,2000,20834,10242,10592
17562,67,22,2000,0,0,0
17563,67,35,2000,2712,1620,1092
17564,67,36,2000,886,537,349
17565,67,126,2000,2270,1157,1113
17566,67,90,2000,0,0,0
17567,67,91,2000,0,0,0
17568,67,92,2000,0,0,0
17569,67,62,2000,12,3,9
17570,67,140,2000,31,22,9
17571,67,23,2000,140,86,54
17572,67,164,2000,1576,640,936
17573,67,63,2000,346,167,179
17574,67,127,2000,51,35,16
17575,67,165,2000,1051,487,564
17576,67,37,2000,103,61,42
17577,67,64,2000,22,10,12
17578,67,128,2000,1169,542,627
17579,67,115,2000,2646,1486,1160
17580,67,65,2000,34629,17594,17035
17581,67,10,2000,230,124,106
17582,67,145,2000,168,73,95
17583,67,113,2000,265,184,81
17584,67,49,2000,3752,1955,1797
17585,67,74,2000,4649,2272,2377
17586,67,25,2000,1643,668,975
17587,67,169,2000,6,2,4
17588,67,166,2000,895,415,480
17589,67,93,2000,0,0,0
17590,67,146,2000,10205,3910,6295
17591,67,26,2000,132115,67245,64870
17592,67,170,2000,0,0,0
17593,67,130,2000,202,89,113
17594,67,38,2000,505,331,174
17595,67,27,2000,0,0,0
17596,67,50,2000,24643,11038,13605
17597,67,131,2000,219,109,110
17598,67,114,2000,326,149,177
17599,67,171,2000,6,3,3
17600,67,1,2000,4325,2765,1560
17601,67,28,2000,107,36,71
17602,67,132,2000,213,109,104
17603,67,133,2000,167,92,75
17604,95,172,2000,1094,489,605
17605,95,97,2000,6631,3197,3434
17606,95,69,2000,48,18,30
17607,95,98,2000,16058,8205,7853
17608,95,85,2000,38,18,20
17609,95,99,2000,5436,2676,2760
17610,95,173,2000,50,25,25
17611,95,5,2000,265,118,147
17612,95,86,2000,403,157,246
17613,95,20,2000,38,10,28
17614,95,100,2000,2539,1185,1354
17615,95,162,2000,32,6,26
17616,95,50,2000,288,111,177
17617,151,136,2000,253,116,137
17618,151,137,2000,691,318,373
17619,151,68,2000,650,310,340
17620,151,156,2000,3698,1738,1960
17621,151,160,2000,467,219,248
17622,151,162,2000,27595,10874,16721
17623,151,166,2000,29771,19220,10551
17624,151,152,2000,6154,2479,3675
17625,4,3,2000,33,10,23
17626,4,10,2000,21,9,12
17627,4,172,2000,570,266,304
17628,4,39,2000,24,8,16
17629,4,68,2000,19,9,10
17630,4,69,2000,17,7,10
17631,4,5,2000,28128,4760,23368
17632,4,57,2000,8,2,6
17633,4,177,2000,80,28,52
17634,4,8,2000,451,154,297
17635,4,73,2000,13,4,9
17636,4,9,2000,14,0,14
17637,4,49,2000,14,6,8
17638,4,74,2000,15,3,12
17639,4,50,2000,22,13,9
17640,53,66,2000,273,148,125
17641,53,54,2000,33326,17155,16171
17642,53,68,2000,217,117,100
17643,53,69,2000,807,435,372
17644,53,32,2000,240,164,76
17645,53,57,2000,213,123,90
17646,53,59,2000,5675,2908,2767
17647,53,35,2000,424,336,88
17648,53,36,2000,185,141,44
17649,53,63,2000,26662,13725,12937
17650,53,37,2000,6791,3426,3365
17651,53,64,2000,3363,2069,1294
17652,53,60,2000,3783,1972,1811
17653,147,134,2000,1320,649,671
17654,147,10,2000,613,292,321
17655,147,172,2000,1348,47,1301
17656,147,137,2000,1261,619,642
17657,147,39,2000,104,49,55
17658,147,69,2000,341,154,187
17659,147,5,2000,3032,1382,1650
17660,147,44,2000,190,86,104
17661,147,57,2000,165,58,107
17662,147,121,2000,254,121,133
17663,147,149,2000,1212,555,657
17664,147,122,2000,238,98,140
17665,147,123,2000,1709,707,1002
17666,147,124,2000,700,273,427
17667,147,125,2000,441,188,253
17668,147,150,2000,687,328,359
17669,147,73,2000,193,78,115
17670,147,162,2000,285,132,153
17671,147,48,2000,118,51,67
17672,147,9,2000,223,98,125
17673,147,61,2000,141,54,87
17674,147,127,2000,95,40,55
17675,147,115,2000,13860,4830,9030
17676,147,133,2000,11763,5449,6314
17677,147,148,2000,259,92,167
17678,147,49,2000,133,51,82
17679,147,130,2000,570,251,319
17680,147,50,2000,993,900,93
17681,147,131,2000,1104,530,574
17682,147,132,2000,4773,2178,2595
17683,105,2,2000,0,0,0
17684,105,141,2000,0,0,0
17685,105,52,2000,0,0,0
17686,105,134,2000,6355,2805,3550
17687,105,103,2000,27597,11994,15603
17688,105,66,2000,3220,1741,1479
17689,105,78,2000,0,0,0
17690,105,13,2000,0,0,0
17691,105,3,2000,0,0,0
17692,105,11,2000,0,0,0
17693,105,79,2000,0,0,0
17694,105,67,2000,1410,548,862
17695,105,53,2000,0,0,0
17696,105,95,2000,0,0,0
17697,105,30,2000,283,131,152
17698,105,116,2000,0,0,0
17699,105,29,2000,0,0,0
17700,105,135,2000,0,0,0
17701,105,153,2000,0,0,0
17702,105,106,2000,17172,6906,10266
17703,105,172,2000,10326,4661,5665
17704,105,107,2000,4169,1875,2294
17705,105,137,2000,0,0,0
17706,105,137,2000,0,0,0
17707,105,96,2000,239,130,109
17708,105,54,2000,0,0,0
17709,105,81,2000,1346,569,777
17710,105,31,2000,1158,554,604
17711,105,151,2000,0,0,0
17712,105,39,2000,453,141,312
17713,105,82,2000,0,0,0
17714,105,83,2000,102,67,35
17715,105,108,2000,1191,503,688
17716,105,97,2000,481,151,330
17717,105,138,2000,0,0,0
17718,105,120,2000,0,0,0
17719,105,40,2000,0,0,0
17720,105,42,2000,165,90,75
17721,105,68,2000,8402,3487,4915
17722,105,109,2000,624,265,359
17723,105,139,2000,0,0,0
17724,105,15,2000,0,0,0
17725,105,69,2000,19603,9421,10182
17726,105,156,2000,0,0,0
17727,105,56,2000,2743,1063,1680
17728,105,84,2000,0,0,0
17729,105,98,2000,158,42,116
17730,105,157,2000,0,0,0
17731,105,110,2000,1607,791,816
17732,105,85,2000,15,7,8
17733,105,99,2000,136,31,105
17734,105,32,2000,2865,1590,1275
17735,105,43,2000,0,0,0
17736,105,5,2000,762,316,446
17737,105,6,2000,0,0,0
17738,105,16,2000,0,0,0
17739,105,44,2000,220,48,172
17740,105,17,2000,1784,716,1068
17741,105,57,2000,55164,24840,30324
17742,105,86,2000,57,21,36
17743,105,177,2000,71102,34526,36576
17744,105,167,2000,0,0,0
17745,105,18,2000,0,0,0
17746,105,121,2000,0,0,0
17747,105,176,2000,0,0,0
17748,105,19,2000,0,0,0
17749,105,20,2000,16128,6222,9906
17750,105,46,2000,0,0,0
17751,105,159,2000,0,0,0
17752,105,143,2000,0,0,0
17753,105,70,2000,0,0,0
17754,105,47,2000,0,0,0
17755,105,71,2000,0,0,0
17756,105,122,2000,0,0,0
17757,105,123,2000,0,0,0
17758,105,7,2000,0,0,0
17759,105,160,2000,0,0,0
17760,105,58,2000,0,0,0
17761,105,100,2000,1261,554,707
17762,105,72,2000,0,0,0
17763,105,59,2000,0,0,0
17764,105,144,2000,0,0,0
17765,105,125,2000,1337,522,815
17766,105,21,2000,0,0,0
17767,105,150,2000,0,0,0
17768,105,8,2000,0,0,0
17769,105,73,2000,3508,1277,2231
17770,105,101,2000,501,169,332
17771,105,162,2000,0,0,0
17772,105,48,2000,143,33,110
17773,105,9,2000,172,66,106
17774,105,102,2000,559,234,325
17775,105,111,2000,28891,15340,13551
17776,105,112,2000,10840,4150,6690
17777,105,33,2000,7477,4249,3228
17778,105,61,2000,213713,102466,111247
17779,105,158,2000,0,0,0
17780,105,35,2000,3534,1901,1633
17781,105,36,2000,6515,3916,2599
17782,105,126,2000,0,0,0
17783,105,90,2000,0,0,0
17784,105,91,2000,0,0,0
17785,105,92,2000,0,0,0
17786,105,62,2000,0,0,0
17787,105,140,2000,0,0,0
17788,105,23,2000,0,0,0
17789,105,164,2000,0,0,0
17790,105,63,2000,0,0,0
17791,105,127,2000,0,0,0
17792,105,165,2000,0,0,0
17793,105,37,2000,0,0,0
17794,105,1,2000,0,0,0
17795,105,64,2000,0,0,0
17796,105,115,2000,0,0,0
17797,105,133,2000,0,0,0
17798,105,65,2000,43708,20118,23590
17799,105,113,2000,233,77,156
17800,105,49,2000,716,267,449
17801,105,74,2000,2951,1026,1925
17802,105,25,2000,3293,1442,1851
17803,105,169,2000,0,0,0
17804,105,166,2000,0,0,0
17805,105,93,2000,0,0,0
17806,105,27,2000,0,0,0
17807,105,146,2000,0,0,0
17808,105,26,2000,693,425,268
17809,105,170,2000,0,0,0
17810,105,130,2000,0,0,0
17811,105,38,2000,0,0,0
17812,105,60,2000,0,0,0
17813,105,142,2000,3400,1748,1652
17814,105,50,2000,4044,1518,2526
17815,105,131,2000,0,0,0
17816,105,152,2000,0,0,0
17817,105,114,2000,24799,11821,12978
17818,105,171,2000,0,0,0
17819,30,2,2000,223,62,161
17820,30,51,2000,528,252,276
17821,30,141,2000,178,80,98
17822,30,52,2000,0,0,0
17823,30,134,2000,4,2,2
17824,30,75,2000,21,8,13
17825,30,76,2000,3,0,3
17826,30,103,2000,53,29,24
17827,30,11,2000,1150,597,553
17828,30,77,2000,3,0,3
17829,30,66,2000,98,41,57
17830,30,12,2000,923,508,415
17831,30,78,2000,2,2,0
17832,30,13,2000,4,2,2
17833,30,3,2000,278,134,144
17834,30,79,2000,2,2,0
17835,30,29,2000,307,246,61
17836,30,67,2000,181,72,109
17837,30,95,2000,1,1,0
17838,30,151,2000,15,6,9
17839,30,4,2000,13,6,7
17840,30,53,2000,54,19,35
17841,30,147,2000,15,5,10
17842,30,105,2000,42,24,18
17843,30,152,2000,6,2,4
17844,30,116,2000,9,4,5
17845,30,153,2000,4,1,3
17846,30,135,2000,4,0,4
17847,30,80,2000,1,0,1
17848,30,136,2000,3,0,3
17849,30,106,2000,10,4,6
17850,30,172,2000,524,241,283
17851,30,107,2000,10,4,6
17852,30,137,2000,8,3,5
17853,30,96,2000,3,0,3
17854,30,54,2000,42,20,22
17855,30,81,2000,132,50,82
17856,30,14,2000,149,65,84
17857,30,31,2000,464,282,182
17858,30,176,2000,1,0,1
17859,30,137,2000,8,1,7
17860,30,39,2000,31,9,22
17861,30,118,2000,2,0,2
17862,30,82,2000,0,0,0
17863,30,83,2000,11,7,4
17864,30,108,2000,6,4,2
17865,30,142,2000,69,16,53
17866,30,97,2000,3,1,2
17867,30,119,2000,2,0,2
17868,30,40,2000,27,19,8
17869,30,148,2000,2,2,0
17870,30,120,2000,34,4,30
17871,30,42,2000,28,14,14
17872,30,68,2000,267,108,159
17873,30,139,2000,6,4,2
17874,30,155,2000,5,3,2
17875,30,15,2000,157,90,67
17876,30,69,2000,998,475,523
17877,30,156,2000,6,3,3
17878,30,55,2000,4,3,1
17879,30,56,2000,2643,1270,1373
17880,30,98,2000,3,3,0
17881,30,157,2000,6,1,5
17882,30,158,2000,3,1,2
17883,30,110,2000,2,0,2
17884,30,85,2000,3,0,3
17885,30,99,2000,1,0,1
17886,30,32,2000,174,106,68
17887,30,43,2000,66,29,37
17888,30,5,2000,135,30,105
17889,30,6,2000,155,32,123
17890,30,16,2000,358,87,271
17891,30,44,2000,6,3,3
17892,30,45,2000,0,0,0
17893,30,17,2000,169,65,104
17894,30,57,2000,511,178,333
17895,30,86,2000,3,2,1
17896,30,177,2000,61,30,31
17897,30,18,2000,105,15,90
17898,30,167,2000,452,319,133
17899,30,121,2000,6,3,3
17900,30,19,2000,47,12,35
17901,30,168,2000,41,25,16
17902,30,46,2000,58,45,13
17903,30,20,2000,379,87,292
17904,30,159,2000,3,1,2
17905,30,143,2000,99,46,53
17906,30,70,2000,2,0,2
17907,30,47,2000,50,44,6
17908,30,71,2000,4,2,2
17909,30,122,2000,1,0,1
17910,30,123,2000,0,0,0
17911,30,7,2000,1,0,1
17912,30,160,2000,0,0,0
17913,30,58,2000,16,8,8
17914,30,161,2000,2,0,2
17915,30,124,2000,0,0,0
17916,30,100,2000,12,7,5
17917,30,72,2000,2,1,1
17918,30,59,2000,15,6,9
17919,30,144,2000,41,16,25
17920,30,125,2000,14,5,9
17921,30,150,2000,2,0,2
17922,30,8,2000,3,0,3
17923,30,73,2000,132,46,86
17924,30,101,2000,19,2,17
17925,30,162,2000,45,6,39
17926,30,60,2000,1476,687,789
17927,30,48,2000,43,18,25
17928,30,21,2000,1,0,1
17929,30,9,2000,27,3,24
17930,30,102,2000,4,0,4
17931,30,111,2000,1,0,1
17932,30,112,2000,12,4,8
17933,30,33,2000,693,485,208
17934,30,61,2000,44,19,25
17935,30,22,2000,4,1,3
17936,30,35,2000,2642,1593,1049
17937,30,36,2000,10972,8539,2433
17938,30,126,2000,1,0,1
17939,30,62,2000,2,2,0
17940,30,23,2000,15,6,9
17941,30,164,2000,4,2,2
17942,30,63,2000,1227,661,566
17943,30,127,2000,0,0,0
17944,30,165,2000,0,0,0
17945,30,37,2000,151,115,36
17946,30,64,2000,19,9,10
17947,30,128,2000,2,0,2
17948,30,115,2000,61,33,28
17949,30,65,2000,674,314,360
17950,30,10,2000,5,1,4
17951,30,145,2000,21,3,18
17952,30,113,2000,0,0,0
17953,30,49,2000,58,24,34
17954,30,74,2000,76,33,43
17955,30,25,2000,738,134,604
17956,30,169,2000,53,30,23
17957,30,166,2000,0,0,0
17958,30,93,2000,0,0,0
17959,30,146,2000,41,10,31
17960,30,26,2000,2010,593,1417
17961,30,170,2000,115,76,39
17962,30,94,2000,2,0,2
17963,30,130,2000,3,0,3
17964,30,38,2000,3230,2492,738
17965,30,27,2000,26,11,15
17966,30,50,2000,1324,583,741
17967,30,131,2000,9,0,9
17968,30,114,2000,8,4,4
17969,30,171,2000,302,199,103
17970,30,1,2000,416,133,283
17971,30,28,2000,32,7,25
17972,30,132,2000,6,3,3
17973,30,133,2000,14,4,10
17974,152,151,2000,3071,1510,1561
17975,152,156,2000,29139,18781,10358
17976,152,160,2000,42260,24231,18029
17977,152,162,2000,3801,2023,1778
17978,152,164,2000,2965,1343,1622
17979,152,166,2000,10415,6874,3541
17980,116,67,2000,475,244,231
17981,116,137,2000,37951,19500,18451
17982,116,68,2000,237,121,116
17983,116,121,2000,202,87,115
17984,116,126,2000,66415,34127,32288
17985,116,130,2000,949,488,461
17986,116,131,2000,5692,2924,2768
17987,153,134,2000,2209,1061,1148
17988,153,103,2000,10,7,3
17989,153,67,2000,24,11,13
17990,153,105,2000,130,63,67
17991,153,172,2000,51,25,26
17992,153,81,2000,115,56,59
17993,153,68,2000,172,84,88
17994,153,139,2000,17,7,10
17995,153,155,2000,12,7,5
17996,153,69,2000,41,18,23
17997,153,156,2000,93,46,47
17998,153,157,2000,99,48,51
17999,153,57,2000,305,128,177
18000,153,177,2000,4,3,1
18001,153,71,2000,10,7,3
18002,153,160,2000,14,7,7
18003,153,100,2000,6,2,4
18004,153,125,2000,76,41,35
18005,153,73,2000,82,36,46
18006,153,162,2000,144,70,74
18007,153,112,2000,4,1,3
18008,153,61,2000,929,443,486
18009,153,158,2000,1138,462,676
18010,153,36,2000,92,45,47
18011,153,140,2000,3747,1915,1832
18012,153,164,2000,627,271,356
18013,153,165,2000,32,18,14
18014,153,65,2000,50,24,26
18015,153,74,2000,29,13,16
18016,153,38,2000,46,22,24
18017,153,50,2000,29,13,16
18018,135,134,2000,0,0,0
18019,135,136,2000,82221,41891,40330
18020,135,137,2000,0,0,0
18021,135,137,2000,0,0,0
18022,135,151,2000,0,0,0
18023,135,138,2000,0,0,0
18024,135,68,2000,10163,4703,5460
18025,135,139,2000,0,0,0
18026,135,69,2000,0,0,0
18027,135,56,2000,0,0,0
18028,135,157,2000,0,0,0
18029,135,57,2000,0,0,0
18030,135,159,2000,0,0,0
18031,135,160,2000,0,0,0
18032,135,73,2000,0,0,0
18033,135,162,2000,90495,38566,51929
18034,135,164,2000,0,0,0
18035,135,50,2000,0,0,0
18036,80,103,2000,13,8,5
18037,80,66,2000,52,11,41
18038,80,78,2000,190,91,99
18039,80,79,2000,209,58,151
18040,80,67,2000,13,6,7
18041,80,105,2000,73,39,34
18042,80,95,2000,359,165,194
18043,80,107,2000,235,86,149
18044,80,96,2000,284,82,202
18045,80,81,2000,753,341,412
18046,80,39,2000,19,7,12
18047,80,83,2000,68,15,53
18048,80,42,2000,11,6,5
18049,80,68,2000,40,15,25
18050,80,69,2000,140,46,94
18051,80,84,2000,17,7,10
18052,80,110,2000,198,101,97
18053,80,85,2000,19,7,12
18054,80,99,2000,777,404,373
18055,80,5,2000,144,68,76
18056,80,6,2000,11,3,8
18057,80,44,2000,258,124,134
18058,80,17,2000,13,11,2
18059,80,57,2000,94,12,82
18060,80,86,2000,7468,4199,3269
18061,80,177,2000,22,6,16
18062,80,121,2000,37,27,10
18063,80,100,2000,42,22,20
18064,80,73,2000,40,6,34
18065,80,101,2000,770,432,338
18066,80,162,2000,11,0,11
18067,80,9,2000,114,41,73
18068,80,102,2000,140,66,74
18069,80,112,2000,15,11,4
18070,80,88,2000,49,27,22
18071,80,91,2000,11,6,5
18072,80,92,2000,32,8,24
18073,80,115,2000,40,19,21
18074,80,133,2000,19,6,13
18075,80,65,2000,29,17,12
18076,80,74,2000,82,19,63
18077,80,93,2000,363,172,191
18078,80,50,2000,2134,955,1179
18079,80,131,2000,15,15,0
18080,80,132,2000,11,3,8
18081,136,135,2000,36353,16772,19581
18082,136,137,2000,839,387,452
18083,136,137,2000,301,139,162
18084,136,68,2000,1039,479,560
18085,136,139,2000,343,158,185
18086,136,143,2000,1286,593,693
18087,136,162,2000,17386,8021,9365
18088,136,145,2000,28613,13201,15412
18089,106,103,2000,45770,22979,22791
18090,106,105,2000,6886,3643,3243
18091,106,172,2000,2258,1026,1232
18092,106,107,2000,3913,2163,1750
18093,106,81,2000,2984,1426,1558
18094,106,83,2000,271,147,124
18095,106,108,2000,8857,4920,3937
18096,106,68,2000,3101,1506,1595
18097,106,69,2000,5359,2724,2635
18098,106,85,2000,45,20,25
18099,106,57,2000,3699,1683,2016
18100,106,100,2000,1700,852,848
18101,106,111,2000,1198,627,571
18102,106,112,2000,35460,21598,13862
18103,106,65,2000,8648,4178,4470
18104,106,114,2000,2238,1077,1161
18105,172,3,2000,1273,755,518
18106,172,105,2000,23509,10855,12654
18107,172,10,2000,1721,1158,563
18108,172,173,2000,1385,485,900
18109,172,5,2000,2839,1227,1612
18110,172,177,2000,2161,882,1279
18111,172,174,2000,5574,2347,3227
18112,172,9,2000,1394,596,798
18113,172,112,2000,4267,1971,2296
18114,172,36,2000,939,425,514
18115,172,1,2000,293705,146815,146890
18116,172,50,2000,2883,1123,1760
18117,107,103,2000,2582,1148,1434
18118,107,105,2000,1889,1071,818
18119,107,106,2000,1761,851,910
18120,107,172,2000,1551,680,871
18121,107,96,2000,822,430,392
18122,107,81,2000,1454,575,879
18123,107,83,2000,338,178,160
18124,107,108,2000,11964,5755,6209
18125,107,97,2000,315,144,171
18126,107,68,2000,1797,834,963
18127,107,69,2000,2230,985,1245
18128,107,98,2000,346,189,157
18129,107,99,2000,286,145,141
18130,107,57,2000,2470,885,1585
18131,107,177,2000,576,241,335
18132,107,100,2000,2236,1086,1150
18133,107,73,2000,341,134,207
18134,107,102,2000,1858,996,862
18135,107,112,2000,3788,1613,2175
18136,107,36,2000,542,326,216
18137,107,65,2000,5608,2581,3027
18138,107,74,2000,605,226,379
18139,107,50,2000,1026,466,560
18140,107,114,2000,364,146,218
18141,117,68,2000,532,231,301
18142,117,121,2000,85,47,38
18143,117,122,2000,10595,5744,4851
18144,117,131,2000,160,83,77
18145,137,134,2000,31100,16403,14697
18146,137,135,2000,5614,2496,3118
18147,137,136,2000,5249,1986,3263
18148,137,172,2000,459,40,419
18149,137,137,2000,183780,95242,88538
18150,137,81,2000,266,201,65
18151,137,151,2000,7549,3922,3627
18152,137,138,2000,786,393,393
18153,137,68,2000,5127,2552,2575
18154,137,139,2000,1572,883,689
18155,137,69,2000,288,170,118
18156,137,20,2000,580,241,339
18157,137,160,2000,16851,6120,10731
18158,137,161,2000,1564,395,1169
18159,137,61,2000,716,332,384
18160,137,36,2000,1280,850,430
18161,137,126,2000,12480,5933,6547
18162,137,164,2000,6591,1694,4897
18163,137,166,2000,1211,715,496
18164,137,134,2000,325733,165974,159759
18165,137,116,2000,36692,18696,17996
18166,137,137,2000,9470,4825,4645
18167,137,126,2000,85936,43788,42148
18168,137,129,2000,118742,60504,58238
18169,137,145,2000,16643,8480,8163
18170,137,130,2000,24177,12319,11858
18171,96,2,2000,3,2,1
18172,96,51,2000,3,0,3
18173,96,141,2000,9,5,4
18174,96,134,2000,2,1,1
18175,96,12,2000,2,1,1
18176,96,103,2000,1120,573,547
18177,96,66,2000,98,28,70
18178,96,78,2000,9,2,7
18179,96,13,2000,1,0,1
18180,96,3,2000,2,0,2
18181,96,11,2000,5,2,3
18182,96,79,2000,8,3,5
18183,96,67,2000,223,91,132
18184,96,4,2000,3,1,2
18185,96,105,2000,415,208,207
18186,96,95,2000,106,42,64
18187,96,30,2000,54,30,24
18188,96,29,2000,4,2,2
18189,96,135,2000,7,4,3
18190,96,80,2000,6,1,5
18191,96,10,2000,1,0,1
18192,96,106,2000,1327,641,686
18193,96,172,2000,222,82,140
18194,96,107,2000,5995,3037,2958
18195,96,137,2000,6,2,4
18196,96,137,2000,2,2,0
18197,96,54,2000,18,8,10
18198,96,81,2000,4391,2057,2334
18199,96,14,2000,2,0,2
18200,96,151,2000,1,1,0
18201,96,39,2000,49,20,29
18202,96,82,2000,4,4,0
18203,96,83,2000,838,550,288
18204,96,108,2000,971,436,535
18205,96,97,2000,8857,4792,4065
18206,96,120,2000,1,0,1
18207,96,40,2000,2,2,0
18208,96,42,2000,17,11,6
18209,96,68,2000,666,293,373
18210,96,109,2000,9,5,4
18211,96,139,2000,1,1,0
18212,96,15,2000,9,5,4
18213,96,69,2000,1424,597,827
18214,96,156,2000,1,0,1
18215,96,55,2000,3,3,0
18216,96,56,2000,26,8,18
18217,96,84,2000,6,2,4
18218,96,98,2000,2029,979,1050
18219,96,110,2000,21,9,12
18220,96,85,2000,54,22,32
18221,96,99,2000,2994,1688,1306
18222,96,173,2000,2506,1158,1348
18223,96,32,2000,56,26,30
18224,96,43,2000,1,1,0
18225,96,5,2000,42,16,26
18226,96,6,2000,77,14,63
18227,96,16,2000,11,4,7
18228,96,44,2000,23,11,12
18229,96,17,2000,130,46,84
18230,96,57,2000,1626,614,1012
18231,96,86,2000,166,94,72
18232,96,177,2000,216,91,125
18233,96,167,2000,4,4,0
18234,96,18,2000,8,2,6
18235,96,121,2000,6,0,6
18236,96,176,2000,28,14,14
18237,96,20,2000,68,22,46
18238,96,46,2000,1,1,0
18239,96,143,2000,8,4,4
18240,96,70,2000,3,1,2
18241,96,47,2000,7,3,4
18242,96,71,2000,11,8,3
18243,96,174,2000,1,0,1
18244,96,122,2000,2,2,0
18245,96,7,2000,1,1,0
18246,96,100,2000,2365,1259,1106
18247,96,72,2000,1,0,1
18248,96,87,2000,3,2,1
18249,96,144,2000,3,2,1
18250,96,125,2000,3,2,1
18251,96,21,2000,2,0,2
18252,96,8,2000,6,1,5
18253,96,73,2000,448,179,269
18254,96,77,2000,25,8,17
18255,96,101,2000,230085,115185,114900
18256,96,162,2000,2,2,0
18257,96,48,2000,58,22,36
18258,96,9,2000,7,0,7
18259,96,102,2000,10438,4910,5528
18260,96,111,2000,63,44,19
18261,96,112,2000,2887,1382,1505
18262,96,33,2000,231,130,101
18263,96,61,2000,59,25,34
18264,96,88,2000,272,106,166
18265,96,22,2000,2,1,1
18266,96,35,2000,76,39,37
18267,96,36,2000,457,297,160
18268,96,126,2000,1,1,0
18269,96,90,2000,1,1,0
18270,96,91,2000,1,1,0
18271,96,92,2000,1,0,1
18272,96,23,2000,10,3,7
18273,96,164,2000,1,1,0
18274,96,37,2000,17,6,11
18275,96,1,2000,1,0,1
18276,96,128,2000,1,1,0
18277,96,115,2000,44,24,20
18278,96,133,2000,1,0,1
18279,96,65,2000,1650,718,932
18280,96,145,2000,1,0,1
18281,96,113,2000,15,7,8
18282,96,148,2000,1,0,1
18283,96,49,2000,104,46,58
18284,96,74,2000,512,224,288
18285,96,25,2000,8,1,7
18286,96,93,2000,27,18,9
18287,96,146,2000,3,2,1
18288,96,26,2000,6,3,3
18289,96,130,2000,7,2,5
18290,96,38,2000,119,76,43
18291,96,60,2000,20,9,11
18292,96,142,2000,8,1,7
18293,96,50,2000,397,162,235
18294,96,131,2000,3,2,1
18295,96,114,2000,239,114,125
18296,96,171,2000,1,1,0
18297,54,51,2000,157,79,78
18298,54,141,2000,0,0,0
18299,54,103,2000,171,105,66
18300,54,66,2000,1461,843,618
18301,54,29,2000,0,0,0
18302,54,67,2000,197,116,81
18303,54,53,2000,430399,224706,205693
18304,54,105,2000,103,76,27
18305,54,30,2000,262,164,98
18306,54,106,2000,87,57,30
18307,54,172,2000,0,0,0
18308,54,107,2000,0,0,0
18309,54,31,2000,810,631,179
18310,54,39,2000,27,15,12
18311,54,142,2000,0,0,0
18312,54,40,2000,5,3,2
18313,54,42,2000,24,16,8
18314,54,68,2000,401,235,166
18315,54,69,2000,7773,4561,3212
18316,54,56,2000,128,65,63
18317,54,32,2000,971,714,257
18318,54,5,2000,0,0,0
18319,54,6,2000,0,0,0
18320,54,16,2000,0,0,0
18321,54,44,2000,10,5,5
18322,54,17,2000,0,0,0
18323,54,57,2000,1609,863,746
18324,54,177,2000,0,0,0
18325,54,18,2000,0,0,0
18326,54,167,2000,0,0,0
18327,54,46,2000,21,17,4
18328,54,20,2000,0,0,0
18329,54,143,2000,0,0,0
18330,54,47,2000,17,14,3
18331,54,71,2000,13,9,4
18332,54,100,2000,15,10,5
18333,54,59,2000,0,0,0
18334,54,144,2000,0,0,0
18335,54,73,2000,241,146,95
18336,54,162,2000,0,0,0
18337,54,60,2000,9737,4726,5011
18338,54,48,2000,30,19,11
18339,54,112,2000,41,27,14
18340,54,33,2000,595,492,103
18341,54,61,2000,25,16,9
18342,54,35,2000,314,212,102
18343,54,36,2000,0,0,0
18344,54,63,2000,0,0,0
18345,54,37,2000,529,416,113
18346,54,64,2000,20724,13573,7151
18347,54,115,2000,0,0,0
18348,54,65,2000,59,42,17
18349,54,145,2000,0,0,0
18350,54,49,2000,244,149,95
18351,54,74,2000,712,400,312
18352,54,25,2000,0,0,0
18353,54,26,2000,0,0,0
18354,54,38,2000,0,0,0
18355,54,50,2000,171,90,81
18356,54,132,2000,0,0,0
18357,81,51,2000,226,113,113
18358,81,141,2000,54,28,26
18359,81,134,2000,106,47,59
18360,81,103,2000,190,103,87
18361,81,30,2000,164,107,57
18362,81,106,2000,186,95,91
18363,81,172,2000,351,90,261
18364,81,107,2000,173,97,76
18365,81,31,2000,219,138,81
18366,81,83,2000,146,91,55
18367,81,108,2000,58,33,25
18368,81,68,2000,151,82,69
18369,81,69,2000,364,197,167
18370,81,84,2000,0,0,0
18371,81,98,2000,75,43,32
18372,81,85,2000,1226,389,837
18373,81,32,2000,84,55,29
18374,81,57,2000,194,59,135
18375,81,86,2000,353,201,152
18376,81,20,2000,65,32,33
18377,81,100,2000,440,246,194
18378,81,101,2000,294,203,91
18379,81,102,2000,98,72,26
18380,81,112,2000,88,56,32
18381,81,33,2000,115,82,33
18382,81,88,2000,155,92,63
18383,81,35,2000,65,50,15
18384,81,36,2000,2342,1610,732
18385,81,65,2000,5917,3279,2638
18386,81,38,2000,694,514,180
18387,81,50,2000,49,22,27
18388,14,2,2000,4,0,4
18389,14,51,2000,126,54,72
18390,14,141,2000,16,8,8
18391,14,103,2000,38,17,21
18392,14,11,2000,534,258,276
18393,14,66,2000,161,95,66
18394,14,12,2000,16,10,6
18395,14,13,2000,49,23,26
18396,14,3,2000,296,6,290
18397,14,29,2000,154,122,32
18398,14,67,2000,119,64,55
18399,14,151,2000,4,0,4
18400,14,53,2000,31,17,14
18401,14,147,2000,4,2,2
18402,14,105,2000,27,17,10
18403,14,30,2000,2799,2000,799
18404,14,116,2000,2,0,2
18405,14,135,2000,26,12,14
18406,14,106,2000,22,14,8
18407,14,172,2000,728,377,351
18408,14,107,2000,57,43,14
18409,14,96,2000,2,2,0
18410,14,54,2000,38,23,15
18411,14,81,2000,16,8,8
18412,14,31,2000,307,206,101
18413,14,176,2000,15,10,5
18414,14,137,2000,311,173,138
18415,14,39,2000,77,45,32
18416,14,118,2000,2,2,0
18417,14,83,2000,5,4,1
18418,14,108,2000,4,2,2
18419,14,142,2000,2358,1002,1356
18420,14,97,2000,5,2,3
18421,14,119,2000,2,2,0
18422,14,40,2000,13,10,3
18423,14,120,2000,37,23,14
18424,14,42,2000,225,171,54
18425,14,68,2000,417,254,163
18426,14,15,2000,6950,3340,3610
18427,14,69,2000,1181,684,497
18428,14,156,2000,38,19,19
18429,14,55,2000,2,0,2
18430,14,56,2000,10781,4829,5952
18431,14,85,2000,2,2,0
18432,14,99,2000,2,0,2
18433,14,32,2000,157,97,60
18434,14,43,2000,15,12,3
18435,14,5,2000,1250,524,726
18436,14,6,2000,547,214,333
18437,14,16,2000,143,47,96
18438,14,44,2000,353,239,114
18439,14,17,2000,174,80,94
18440,14,57,2000,219,115,104
18441,14,86,2000,7,4,3
18442,14,177,2000,38,23,15
18443,14,18,2000,201,76,125
18444,14,167,2000,108,68,40
18445,14,121,2000,38,19,19
18446,14,19,2000,106,47,59
18447,14,168,2000,11,6,5
18448,14,46,2000,75,54,21
18449,14,20,2000,1252,579,673
18450,14,143,2000,104,45,59
18451,14,47,2000,42,35,7
18452,14,71,2000,5,4,1
18453,14,122,2000,4,2,2
18454,14,123,2000,4,2,2
18455,14,58,2000,15,6,9
18456,14,124,2000,5,2,3
18457,14,100,2000,29,19,10
18458,14,144,2000,29,14,15
18459,14,125,2000,5,4,1
18460,14,150,2000,2,0,2
18461,14,8,2000,26,4,22
18462,14,73,2000,219,132,87
18463,14,101,2000,5,2,3
18464,14,162,2000,139,62,77
18465,14,60,2000,9,6,3
18466,14,48,2000,91,60,31
18467,14,21,2000,29,12,17
18468,14,9,2000,236,17,219
18469,14,102,2000,9,2,7
18470,14,111,2000,4,4,0
18471,14,112,2000,15,10,5
18472,14,33,2000,322,247,75
18473,14,61,2000,29,21,8
18474,14,88,2000,2,0,2
18475,14,22,2000,5,2,3
18476,14,35,2000,2459,1790,669
18477,14,36,2000,5913,3550,2363
18478,14,23,2000,106,50,56
18479,14,164,2000,4,2,2
18480,14,63,2000,1152,635,517
18481,14,127,2000,4,2,2
18482,14,165,2000,2,0,2
18483,14,37,2000,62,39,23
18484,14,64,2000,7,4,3
18485,14,128,2000,5,2,3
18486,14,115,2000,2258,1262,996
18487,14,65,2000,71,52,19
18488,14,10,2000,4491,3688,803
18489,14,145,2000,236,122,114
18490,14,113,2000,2,2,0
18491,14,49,2000,415,278,137
18492,14,74,2000,172,113,59
18493,14,25,2000,1481,365,1116
18494,14,169,2000,4,2,2
18495,14,93,2000,7,6,1
18496,14,146,2000,16,6,10
18497,14,26,2000,278,150,128
18498,14,170,2000,5,4,1
18499,14,130,2000,9,2,7
18500,14,38,2000,1490,1025,465
18501,14,27,2000,69,29,40
18502,14,50,2000,16552,9115,7437
18503,14,131,2000,66,35,31
18504,14,114,2000,2,2,0
18505,14,171,2000,33,19,14
18506,14,1,2000,29,25,4
18507,14,28,2000,7,4,3
18508,14,132,2000,62,41,21
18509,14,133,2000,139,83,56
18510,31,2,2000,103,26,77
18511,31,51,2000,88,32,56
18512,31,141,2000,161,21,140
18513,31,52,2000,8,4,4
18514,31,134,2000,67,8,59
18515,31,76,2000,3,0,3
18516,31,103,2000,152,75,77
18517,31,11,2000,453,173,280
18518,31,77,2000,0,0,0
18519,31,66,2000,3623,1903,1720
18520,31,12,2000,91,39,52
18521,31,78,2000,0,0,0
18522,31,13,2000,12,1,11
18523,31,3,2000,16,3,13
18524,31,79,2000,7,5,2
18525,31,29,2000,644,352,292
18526,31,67,2000,372,155,217
18527,31,95,2000,1,1,0
18528,31,151,2000,13,1,12
18529,31,4,2000,0,0,0
18530,31,53,2000,711,259,452
18531,31,147,2000,1,0,1
18532,31,105,2000,56,21,35
18533,31,30,2000,2308,789,1519
18534,31,152,2000,3,1,2
18535,31,116,2000,0,0,0
18536,31,153,2000,7,3,4
18537,31,135,2000,3,1,2
18538,31,80,2000,0,0,0
18539,31,136,2000,4,0,4
18540,31,106,2000,15,5,10
18541,31,172,2000,605,231,374
18542,31,173,2000,12,8,4
18543,31,107,2000,36,14,22
18544,31,117,2000,1,0,1
18545,31,137,2000,32,5,27
18546,31,96,2000,5,1,4
18547,31,54,2000,835,326,509
18548,31,81,2000,247,49,198
18549,31,14,2000,27,5,22
18550,31,176,2000,43,32,11
18551,31,137,2000,16,3,13
18552,31,39,2000,64,24,40
18553,31,118,2000,3,1,2
18554,31,82,2000,0,0,0
18555,31,83,2000,3,1,2
18556,31,108,2000,19,7,12
18557,31,142,2000,77,17,60
18558,31,97,2000,7,3,4
18559,31,138,2000,1,1,0
18560,31,119,2000,1,0,1
18561,31,40,2000,31,17,14
18562,31,148,2000,1,1,0
18563,31,120,2000,39,7,32
18564,31,42,2000,164,79,85
18565,31,68,2000,1781,840,941
18566,31,139,2000,0,0,0
18567,31,155,2000,4,3,1
18568,31,15,2000,176,72,104
18569,31,69,2000,4750,2274,2476
18570,31,156,2000,21,5,16
18571,31,55,2000,0,0,0
18572,31,56,2000,889,373,516
18573,31,84,2000,0,0,0
18574,31,98,2000,4,1,3
18575,31,157,2000,11,1,10
18576,31,158,2000,4,0,4
18577,31,110,2000,1,0,1
18578,31,85,2000,11,5,6
18579,31,99,2000,1,1,0
18580,31,32,2000,3053,1446,1607
18581,31,43,2000,9,4,5
18582,31,5,2000,119,35,84
18583,31,6,2000,93,26,67
18584,31,16,2000,131,24,107
18585,31,44,2000,33,11,22
18586,31,17,2000,69,21,48
18587,31,57,2000,509,152,357
18588,31,86,2000,3,1,2
18589,31,177,2000,95,43,52
18590,31,18,2000,51,7,44
18591,31,167,2000,909,447,462
18592,31,121,2000,21,7,14
18593,31,19,2000,27,9,18
18594,31,168,2000,75,35,40
18595,31,46,2000,65,38,27
18596,31,20,2000,101,16,85
18597,31,149,2000,3,0,3
18598,31,159,2000,4,3,1
18599,31,143,2000,49,13,36
18600,31,70,2000,0,0,0
18601,31,47,2000,81,45,36
18602,31,71,2000,8,3,5
18603,31,122,2000,12,4,8
18604,31,123,2000,9,5,4
18605,31,7,2000,0,0,0
18606,31,160,2000,8,1,7
18607,31,58,2000,4,1,3
18608,31,161,2000,1,0,1
18609,31,124,2000,1,0,1
18610,31,100,2000,39,17,22
18611,31,72,2000,1,0,1
18612,31,59,2000,57,17,40
18613,31,144,2000,51,8,43
18614,31,125,2000,1,0,1
18615,31,150,2000,4,1,3
18616,31,8,2000,8,3,5
18617,31,73,2000,271,91,180
18618,31,101,2000,8,1,7
18619,31,162,2000,33,5,28
18620,31,60,2000,263,51,212
18621,31,48,2000,48,21,27
18622,31,21,2000,0,0,0
18623,31,9,2000,45,8,37
18624,31,102,2000,5,1,4
18625,31,111,2000,15,7,8
18626,31,112,2000,33,7,26
18627,31,33,2000,12165,7317,4848
18628,31,61,2000,19,8,11
18629,31,22,2000,13,8,5
18630,31,35,2000,5889,2815,3074
18631,31,36,2000,6565,3539,3026
18632,31,126,2000,7,1,6
18633,31,90,2000,3,0,3
18634,31,91,2000,1,0,1
18635,31,92,2000,0,0,0
18636,31,62,2000,1,1,0
18637,31,140,2000,0,0,0
18638,31,23,2000,8,1,7
18639,31,164,2000,15,3,12
18640,31,63,2000,2363,936,1427
18641,31,127,2000,1,0,1
18642,31,165,2000,1,1,0
18643,31,37,2000,140506,64023,76483
18644,31,64,2000,128,58,70
18645,31,128,2000,3,1,2
18646,31,115,2000,76,34,42
18647,31,65,2000,84,32,52
18648,31,10,2000,15,4,11
18649,31,145,2000,33,8,25
18650,31,113,2000,1,0,1
18651,31,49,2000,104,34,70
18652,31,74,2000,189,75,114
18653,31,25,2000,215,26,189
18654,31,169,2000,32,18,14
18655,31,166,2000,8,3,5
18656,31,93,2000,1,0,1
18657,31,146,2000,77,12,65
18658,31,26,2000,109,28,81
18659,31,170,2000,23,13,10
18660,31,130,2000,8,4,4
18661,31,38,2000,16397,8126,8271
18662,31,27,2000,15,3,12
18663,31,50,2000,701,210,491
18664,31,131,2000,9,3,6
18665,31,114,2000,17,5,12
18666,31,171,2000,88,45,43
18667,31,1,2000,7208,2258,4950
18668,31,28,2000,55,8,47
18669,31,132,2000,9,1,8
18670,31,133,2000,11,3,8
18671,39,2,2000,2941,1347,1594
18672,39,51,2000,84,49,35
18673,39,141,2000,907,290,617
18674,39,52,2000,1,0,1
18675,39,134,2000,106,54,52
18676,39,76,2000,0,0,0
18677,39,103,2000,965,505,460
18678,39,11,2000,459,214,245
18679,39,77,2000,0,0,0
18680,39,66,2000,1525,774,751
18681,39,12,2000,95,65,30
18682,39,78,2000,9,7,2
18683,39,13,2000,95,48,47
18684,39,3,2000,398,228,170
18685,39,79,2000,24,10,14
18686,39,29,2000,144,105,39
18687,39,67,2000,1233,610,623
18688,39,95,2000,5,2,3
18689,39,151,2000,33,10,23
18690,39,4,2000,9,1,8
18691,39,53,2000,18844,9242,9602
18692,39,147,2000,61,34,27
18693,39,105,2000,1542,1017,525
18694,39,30,2000,666,386,280
18695,39,152,2000,21,7,14
18696,39,116,2000,241,132,109
18697,39,153,2000,18,9,9
18698,39,135,2000,137,50,87
18699,39,136,2000,2,0,2
18700,39,106,2000,1326,664,662
18701,39,172,2000,3580,2078,1502
18702,39,173,2000,491,246,245
18703,39,174,2000,0,0,0
18704,39,107,2000,2040,933,1107
18705,39,117,2000,16,5,11
18706,39,137,2000,84,40,44
18707,39,96,2000,93,33,60
18708,39,54,2000,579,277,302
18709,39,81,2000,170,98,72
18710,39,14,2000,151,87,64
18711,39,31,2000,217,138,79
18712,39,176,2000,258,148,110
18713,39,137,2000,169,71,98
18714,39,118,2000,16,9,7
18715,39,82,2000,9,4,5
18716,39,83,2000,77,53,24
18717,39,108,2000,379,201,178
18718,39,142,2000,1282,424,858
18719,39,97,2000,50,29,21
18720,39,138,2000,0,0,0
18721,39,119,2000,84,47,37
18722,39,40,2000,460,319,141
18723,39,148,2000,40,17,23
18724,39,120,2000,1081,488,593
18725,39,41,2000,10636,6284,4352
18726,39,42,2000,3826,2539,1287
18727,39,68,2000,4238,1861,2377
18728,39,109,2000,0,0,0
18729,39,139,2000,5,2,3
18730,39,155,2000,483,192,291
18731,39,15,2000,83,42,41
18732,39,69,2000,28060,14915,13145
18733,39,156,2000,965,381,584
18734,39,56,2000,1093,316,777
18735,39,84,2000,7,2,5
18736,39,98,2000,133,71,62
18737,39,157,2000,54,26,28
18738,39,158,2000,31,5,26
18739,39,110,2000,99,71,28
18740,39,85,2000,130,49,81
18741,39,99,2000,69,44,25
18742,39,32,2000,1641,774,867
18743,39,43,2000,5955,3046,2909
18744,39,5,2000,4391,2551,1840
18745,39,6,2000,11483,4513,6970
18746,39,16,2000,12988,5399,7589
18747,39,44,2000,1153,445,708
18748,39,17,2000,1454,526,928
18749,39,57,2000,3333,1018,2315
18750,39,86,2000,132,64,68
18751,39,177,2000,1323,873,450
18752,39,18,2000,967,385,582
18753,39,167,2000,43,33,10
18754,39,121,2000,996,542,454
18755,39,19,2000,962,417,545
18756,39,168,2000,2,1,1
18757,39,46,2000,667,407,260
18758,39,20,2000,12396,5619,6777
18759,39,149,2000,40,28,12
18760,39,159,2000,106,48,58
18761,39,143,2000,170,62,108
18762,39,70,2000,11,6,5
18763,39,47,2000,944,583,361
18764,39,71,2000,226,105,121
18765,39,122,2000,22,10,12
18766,39,123,2000,47,28,19
18767,39,7,2000,2,2,0
18768,39,160,2000,26,10,16
18769,39,58,2000,58,25,33
18770,39,161,2000,26,12,14
18771,39,124,2000,110,55,55
18772,39,100,2000,461,262,199
18773,39,72,2000,7,2,5
18774,39,59,2000,1965,933,1032
18775,39,144,2000,4881,2158,2723
18776,39,125,2000,122,74,48
18777,39,150,2000,37,25,12
18778,39,8,2000,118,53,65
18779,39,73,2000,4835,2062,2773
18780,39,101,2000,122,67,55
18781,39,162,2000,558,213,345
18782,39,60,2000,1322,647,675
18783,39,48,2000,16652,10181,6471
18784,39,21,2000,13,9,4
18785,39,9,2000,10049,4614,5435
18786,39,102,2000,37,15,22
18787,39,111,2000,54,29,25
18788,39,112,2000,547,324,223
18789,39,33,2000,10954,7164,3790
18790,39,61,2000,681,319,362
18791,39,88,2000,0,0,0
18792,39,22,2000,31,21,10
18793,39,35,2000,1993,1174,819
18794,39,36,2000,3493,2344,1149
18795,39,126,2000,129,67,62
18796,39,90,2000,0,0,0
18797,39,91,2000,0,0,0
18798,39,92,2000,8,1,7
18799,39,62,2000,0,0,0
18800,39,140,2000,0,0,0
18801,39,23,2000,191,93,98
18802,39,164,2000,81,33,48
18803,39,63,2000,5891,2799,3092
18804,39,127,2000,21,13,8
18805,39,165,2000,255,119,136
18806,39,37,2000,121,75,46
18807,39,64,2000,64,37,27
18808,39,128,2000,11586,5426,6160
18809,39,115,2000,984,488,496
18810,39,129,2000,0,0,0
18811,39,65,2000,2747,1326,1421
18812,39,10,2000,8005,3948,4057
18813,39,145,2000,206,60,146
18814,39,113,2000,26,11,15
18815,39,49,2000,19772,11431,8341
18816,39,74,2000,1922,934,988
18817,39,25,2000,1304,739,565
18818,39,169,2000,7,4,3
18819,39,166,2000,99,25,74
18820,39,93,2000,151,85,66
18821,39,146,2000,723,194,529
18822,39,26,2000,30089,14237,15852
18823,39,170,2000,4,2,2
18824,39,130,2000,941,582,359
18825,39,38,2000,695,428,267
18826,39,27,2000,192,86,106
18827,39,50,2000,14074,5621,8453
18828,39,131,2000,792,442,350
18829,39,114,2000,204,98,106
18830,39,171,2000,42,29,13
18831,39,1,2000,8651,4246,4405
18832,39,28,2000,141,70,71
18833,39,132,2000,342,205,137
18834,39,133,2000,268,141,127
18835,118,120,2000,11023,6151,4872
18836,118,128,2000,83230,38656,44574
18837,118,28,2000,238,123,115
18838,82,76,2000,290,135,155
18839,82,78,2000,7,5,2
18840,82,79,2000,95,44,51
18841,82,172,2000,23,7,16
18842,82,81,2000,7,7,0
18843,82,68,2000,45,15,30
18844,82,109,2000,13,11,2
18845,82,69,2000,17,11,6
18846,82,110,2000,108,48,60
18847,82,85,2000,873,441,432
18848,82,5,2000,15,6,9
18849,82,86,2000,74,48,26
18850,82,20,2000,19,5,14
18851,82,87,2000,93,44,49
18852,82,73,2000,6,4,2
18853,82,77,2000,26,18,8
18854,82,162,2000,29,18,11
18855,82,88,2000,10,1,9
18856,82,90,2000,36,21,15
18857,82,75,2000,11,4,7
18858,82,91,2000,161,80,81
18859,82,92,2000,72,31,41
18860,82,113,2000,11,5,6
18861,82,25,2000,10,4,6
18862,82,93,2000,175,72,103
18863,82,50,2000,362,174,188
18864,83,76,2000,325,168,157
18865,83,103,2000,3227,1399,1828
18866,83,66,2000,1179,198,981
18867,83,78,2000,111,66,45
18868,83,13,2000,26,4,22
18869,83,67,2000,598,238,360
18870,83,4,2000,11,0,11
18871,83,53,2000,7,0,7
18872,83,105,2000,1160,648,512
18873,83,30,2000,436,194,242
18874,83,116,2000,4,4,0
18875,83,135,2000,4,0,4
18876,83,153,2000,4,4,0
18877,83,136,2000,4,0,4
18878,83,106,2000,2310,834,1476
18879,83,172,2000,4413,1979,2434
18880,83,107,2000,5737,2865,2872
18881,83,96,2000,1896,1178,718
18882,83,81,2000,8335,3729,4606
18883,83,31,2000,15,8,7
18884,83,39,2000,85,14,71
18885,83,82,2000,29,8,21
18886,83,108,2000,1160,653,507
18887,83,97,2000,447,223,224
18888,83,42,2000,55,18,37
18889,83,68,2000,3083,1215,1868
18890,83,69,2000,6209,2554,3655
18891,83,56,2000,115,41,74
18892,83,98,2000,580,176,404
18893,83,110,2000,55,18,37
18894,83,85,2000,228652,82141,146511
18895,83,99,2000,529,264,265
18896,83,32,2000,62,26,36
18897,83,5,2000,351,161,190
18898,83,6,2000,85,8,77
18899,83,16,2000,7,0,7
18900,83,44,2000,62,29,33
18901,83,17,2000,226,47,179
18902,83,57,2000,8501,2539,5962
18903,83,86,2000,514,176,338
18904,83,177,2000,1534,720,814
18905,83,167,2000,4,0,4
18906,83,20,2000,876,340,536
18907,83,58,2000,40,26,14
18908,83,100,2000,2122,1229,893
18909,83,144,2000,26,11,15
18910,83,73,2000,706,214,492
18911,83,77,2000,403,201,202
18912,83,101,2000,507,266,241
18913,83,162,2000,51,11,40
18914,83,48,2000,82,29,53
18915,83,9,2000,203,33,170
18916,83,102,2000,854,384,470
18917,83,111,2000,75,26,49
18918,83,112,2000,2432,1006,1426
18919,83,33,2000,580,516,64
18920,83,61,2000,195,62,133
18921,83,88,2000,10708,5928,4780
18922,83,35,2000,37,18,19
18923,83,36,2000,351,219,132
18924,83,90,2000,93,26,67
18925,83,75,2000,170,73,97
18926,83,23,2000,29,0,29
18927,83,63,2000,220,89,131
18928,83,115,2000,296,125,171
18929,83,65,2000,8982,3329,5653
18930,83,113,2000,126,84,42
18931,83,49,2000,451,362,89
18932,83,74,2000,2614,967,1647
18933,83,25,2000,93,41,52
18934,83,93,2000,122,59,63
18935,83,26,2000,89,43,46
18936,83,94,2000,4,0,4
18937,83,38,2000,148,92,56
18938,83,60,2000,7,0,7
18939,83,50,2000,710,256,454
18940,83,114,2000,1985,1222,763
18941,108,2,2000,23,9,14
18942,108,51,2000,30,14,16
18943,108,141,2000,20,5,15
18944,108,134,2000,18,11,7
18945,108,103,2000,2239,923,1316
18946,108,66,2000,227,99,128
18947,108,78,2000,20,9,11
18948,108,11,2000,16,8,8
18949,108,67,2000,355,174,181
18950,108,105,2000,1101,592,509
18951,108,30,2000,81,44,37
18952,108,135,2000,19,6,13
18953,108,106,2000,4702,2130,2572
18954,108,172,2000,1214,490,724
18955,108,107,2000,71556,37251,34305
18956,108,96,2000,389,209,180
18957,108,54,2000,34,12,22
18958,108,81,2000,1242,555,687
18959,108,31,2000,131,36,95
18960,108,39,2000,76,24,52
18961,108,83,2000,147,82,65
18962,108,97,2000,217,114,103
18963,108,42,2000,53,33,20
18964,108,68,2000,939,464,475
18965,108,155,2000,14,3,11
18966,108,69,2000,1827,916,911
18967,108,156,2000,16,5,11
18968,108,56,2000,30,6,24
18969,108,98,2000,179,92,87
18970,108,85,2000,40,12,28
18971,108,99,2000,195,107,88
18972,108,173,2000,41,17,24
18973,108,32,2000,90,55,35
18974,108,5,2000,95,31,64
18975,108,6,2000,80,23,57
18976,108,16,2000,15,1,14
18977,108,44,2000,83,35,48
18978,108,17,2000,216,83,133
18979,108,57,2000,1595,649,946
18980,108,86,2000,16,9,7
18981,108,177,2000,305,128,177
18982,108,18,2000,30,6,24
18983,108,176,2000,202,91,111
18984,108,20,2000,184,65,119
18985,108,100,2000,937,505,432
18986,108,144,2000,20,8,12
18987,108,73,2000,344,152,192
18988,108,101,2000,163,80,83
18989,108,162,2000,21,1,20
18990,108,48,2000,98,50,48
18991,108,9,2000,22,2,20
18992,108,102,2000,400,195,205
18993,108,111,2000,101,47,54
18994,108,112,2000,5682,2322,3360
18995,108,33,2000,130,65,65
18996,108,61,2000,152,57,95
18997,108,88,2000,208,101,107
18998,108,35,2000,126,70,56
18999,108,36,2000,620,395,225
19000,108,23,2000,37,14,23
19001,108,37,2000,21,11,10
19002,108,1,2000,20,9,11
19003,108,115,2000,51,15,36
19004,108,65,2000,3099,1520,1579
19005,108,49,2000,145,68,77
19006,108,74,2000,814,276,538
19007,108,25,2000,27,8,19
19008,108,93,2000,19,11,8
19009,108,38,2000,167,94,73
19010,108,60,2000,1,1,0
19011,108,142,2000,35,11,24
19012,108,50,2000,895,420,475
19013,108,114,2000,398,148,250
19014,142,2,2000,154,37,117
19015,142,51,2000,88,35,53
19016,142,141,2000,648,439,209
19017,142,134,2000,21,11,10
19018,142,76,2000,13,7,6
19019,142,12,2000,24,1,23
19020,142,103,2000,183,74,109
19021,142,66,2000,442,254,188
19022,142,78,2000,11,9,2
19023,142,13,2000,294,155,139
19024,142,3,2000,186,22,164
19025,142,11,2000,118,74,44
19026,142,67,2000,411,215,196
19027,142,53,2000,46,23,23
19028,142,105,2000,96,59,37
19029,142,30,2000,50,30,20
19030,142,116,2000,27,3,24
19031,142,29,2000,204,122,82
19032,142,135,2000,92,16,76
19033,142,10,2000,164,73,91
19034,142,136,2000,244,91,153
19035,142,106,2000,20,10,10
19036,142,172,2000,562,187,375
19037,142,107,2000,43,11,32
19038,142,117,2000,664,124,540
19039,142,137,2000,55,18,37
19040,142,137,2000,96,35,61
19041,142,54,2000,76,18,58
19042,142,14,2000,63,30,33
19043,142,31,2000,148,88,60
19044,142,151,2000,27,1,26
19045,142,39,2000,221,112,109
19046,142,108,2000,9,7,2
19047,142,97,2000,155,90,65
19048,142,120,2000,478,283,195
19049,142,119,2000,388,196,192
19050,142,40,2000,19,10,9
19051,142,42,2000,182,110,72
19052,142,68,2000,2089,1014,1075
19053,142,118,2000,271,110,161
19054,142,155,2000,22,6,16
19055,142,69,2000,5649,2703,2946
19056,142,156,2000,172,44,128
19057,142,55,2000,7,3,4
19058,142,56,2000,934,556,378
19059,142,98,2000,7,4,3
19060,142,157,2000,105,10,95
19061,142,32,2000,98,60,38
19062,142,5,2000,910,342,568
19063,142,6,2000,111,48,63
19064,142,16,2000,7793,4107,3686
19065,142,44,2000,70,44,26
19066,142,17,2000,518,215,303
19067,142,57,2000,3058,1497,1561
19068,142,177,2000,843,417,426
19069,142,167,2000,155,73,82
19070,142,18,2000,3836,1807,2029
19071,142,121,2000,101,34,67
19072,142,176,2000,76,31,45
19073,142,19,2000,2188,835,1353
19074,142,168,2000,46,11,35
19075,142,20,2000,2324,1353,971
19076,142,159,2000,35,15,20
19077,142,143,2000,3669,1690,1979
19078,142,122,2000,30,2,28
19079,142,123,2000,21,4,17
19080,142,7,2000,21,6,15
19081,142,160,2000,158,36,122
19082,142,161,2000,114,32,82
19083,142,100,2000,48,32,16
19084,142,72,2000,60,31,29
19085,142,144,2000,776,606,170
19086,142,125,2000,13,5,8
19087,142,21,2000,397,141,256
19088,142,150,2000,196,132,64
19089,142,73,2000,726,386,340
19090,142,162,2000,593,167,426
19091,142,48,2000,89,41,48
19092,142,9,2000,452,162,290
19093,142,33,2000,278,147,131
19094,142,61,2000,34,19,15
19095,142,158,2000,68,1,67
19096,142,22,2000,292,118,174
19097,142,35,2000,177,106,71
19098,142,36,2000,5477,3527,1950
19099,142,126,2000,33,7,26
19100,142,23,2000,5987,2271,3716
19101,142,164,2000,311,62,249
19102,142,127,2000,15,5,10
19103,142,165,2000,46,26,20
19104,142,37,2000,46,28,18
19105,142,128,2000,11540,5187,6353
19106,142,115,2000,164,72,92
19107,142,133,2000,25,5,20
19108,142,65,2000,303,152,151
19109,142,129,2000,0,0,0
19110,142,145,2000,9388,4276,5112
19111,142,49,2000,259,119,140
19112,142,74,2000,998,491,507
19113,142,25,2000,5549,2581,2968
19114,142,169,2000,95,28,67
19115,142,27,2000,523,222,301
19116,142,146,2000,572,323,249
19117,142,26,2000,654,194,460
19118,142,170,2000,35,10,25
19119,142,130,2000,64,11,53
19120,142,38,2000,125,85,40
19121,142,60,2000,88,37,51
19122,142,50,2000,2299,1106,1193
19123,142,131,2000,107,25,82
19124,142,152,2000,48,7,41
19125,142,171,2000,82,18,64
19126,142,28,2000,4167,1753,2414
19127,142,132,2000,19,6,13
19128,97,103,2000,166,69,97
19129,97,66,2000,10,6,4
19130,97,3,2000,6,0,6
19131,97,79,2000,35,18,17
19132,97,67,2000,49,25,24
19133,97,105,2000,198,113,85
19134,97,95,2000,218,116,102
19135,97,106,2000,207,108,99
19136,97,172,2000,187,70,117
19137,97,107,2000,363,194,169
19138,97,96,2000,818,431,387
19139,97,81,2000,80,37,43
19140,97,83,2000,43,20,23
19141,97,108,2000,97,53,44
19142,97,68,2000,150,68,82
19143,97,69,2000,229,95,134
19144,97,98,2000,6212,3355,2857
19145,97,99,2000,9525,5531,3994
19146,97,173,2000,7,4,3
19147,97,5,2000,10,4,6
19148,97,6,2000,14,5,9
19149,97,44,2000,12,5,7
19150,97,17,2000,68,36,32
19151,97,57,2000,233,77,156
19152,97,86,2000,9,4,5
19153,97,177,2000,35,10,25
19154,97,100,2000,1438,791,647
19155,97,73,2000,35,12,23
19156,97,101,2000,4545,2230,2315
19157,97,102,2000,354,192,162
19158,97,111,2000,15,7,8
19159,97,112,2000,172,74,98
19160,97,61,2000,11,3,8
19161,97,88,2000,58,27,31
19162,97,36,2000,16,9,7
19163,97,65,2000,473,202,271
19164,97,49,2000,25,10,15
19165,97,74,2000,51,25,26
19166,97,50,2000,77,30,47
19167,97,114,2000,67,24,43
19168,138,135,2000,333,115,218
19169,138,68,2000,1903,1070,833
19170,138,139,2000,107,48,59
19171,138,162,2000,150,72,78
19172,138,140,2000,623,253,370
19173,138,65,2000,534,225,309
19174,119,134,2000,620,282,338
19175,119,116,2000,1663,792,871
19176,119,172,2000,98,10,88
19177,119,117,2000,93,48,45
19178,119,137,2000,1224,584,640
19179,119,120,2000,91,43,48
19180,119,68,2000,211,112,99
19181,119,5,2000,70,46,24
19182,119,121,2000,217,100,117
19183,119,123,2000,343,180,163
19184,119,125,2000,896,546,350
19185,119,126,2000,414,223,191
19186,119,128,2000,1775,778,997
19187,119,115,2000,189,73,116
19188,119,133,2000,168,49,119
19189,119,129,2000,1284,554,730
19190,119,145,2000,180,78,102
19191,119,130,2000,1190,444,746
19192,119,50,2000,43,29,14
19193,119,131,2000,375,189,186
19194,119,132,2000,151,57,94
19195,40,2,2000,0,0,0
19196,40,51,2000,0,0,0
19197,40,141,2000,0,0,0
19198,40,52,2000,0,0,0
19199,40,134,2000,0,0,0
19200,40,76,2000,0,0,0
19201,40,103,2000,0,0,0
19202,40,11,2000,595,231,364
19203,40,66,2000,0,0,0
19204,40,12,2000,1437,582,855
19205,40,13,2000,0,0,0
19206,40,3,2000,0,0,0
19207,40,79,2000,0,0,0
19208,40,29,2000,14756,8494,6262
19209,40,67,2000,0,0,0
19210,40,95,2000,0,0,0
19211,40,151,2000,0,0,0
19212,40,4,2000,0,0,0
19213,40,53,2000,0,0,0
19214,40,105,2000,0,0,0
19215,40,30,2000,0,0,0
19216,40,153,2000,0,0,0
19217,40,135,2000,0,0,0
19218,40,106,2000,0,0,0
19219,40,172,2000,124,65,59
19220,40,173,2000,0,0,0
19221,40,107,2000,0,0,0
19222,40,137,2000,0,0,0
19223,40,96,2000,0,0,0
19224,40,54,2000,0,0,0
19225,40,81,2000,0,0,0
19226,40,14,2000,0,0,0
19227,40,31,2000,0,0,0
19228,40,176,2000,0,0,0
19229,40,137,2000,0,0,0
19230,40,39,2000,52,17,35
19231,40,83,2000,0,0,0
19232,40,108,2000,0,0,0
19233,40,142,2000,0,0,0
19234,40,97,2000,0,0,0
19235,40,120,2000,0,0,0
19236,40,41,2000,0,0,0
19237,40,42,2000,1369,632,737
19238,40,68,2000,88,48,40
19239,40,155,2000,0,0,0
19240,40,15,2000,1572,776,796
19241,40,69,2000,970,481,489
19242,40,156,2000,0,0,0
19243,40,55,2000,0,0,0
19244,40,56,2000,0,0,0
19245,40,98,2000,0,0,0
19246,40,157,2000,0,0,0
19247,40,110,2000,0,0,0
19248,40,99,2000,0,0,0
19249,40,32,2000,76,37,39
19250,40,43,2000,0,0,0
19251,40,5,2000,53,18,35
19252,40,6,2000,0,0,0
19253,40,16,2000,0,0,0
19254,40,44,2000,0,0,0
19255,40,17,2000,0,0,0
19256,40,57,2000,0,0,0
19257,40,86,2000,0,0,0
19258,40,177,2000,0,0,0
19259,40,18,2000,0,0,0
19260,40,167,2000,3808,2155,1653
19261,40,121,2000,0,0,0
19262,40,19,2000,0,0,0
19263,40,168,2000,565,317,248
19264,40,46,2000,4289,2473,1816
19265,40,20,2000,0,0,0
19266,40,143,2000,0,0,0
19267,40,70,2000,0,0,0
19268,40,47,2000,2083,1189,894
19269,40,71,2000,0,0,0
19270,40,122,2000,0,0,0
19271,40,123,2000,0,0,0
19272,40,58,2000,0,0,0
19273,40,161,2000,0,0,0
19274,40,124,2000,0,0,0
19275,40,100,2000,0,0,0
19276,40,72,2000,0,0,0
19277,40,59,2000,0,0,0
19278,40,144,2000,0,0,0
19279,40,125,2000,0,0,0
19280,40,150,2000,0,0,0
19281,40,8,2000,0,0,0
19282,40,73,2000,0,0,0
19283,40,101,2000,0,0,0
19284,40,162,2000,0,0,0
19285,40,60,2000,0,0,0
19286,40,48,2000,0,0,0
19287,40,21,2000,0,0,0
19288,40,9,2000,0,0,0
19289,40,102,2000,0,0,0
19290,40,111,2000,0,0,0
19291,40,112,2000,0,0,0
19292,40,33,2000,496,300,196
19293,40,61,2000,0,0,0
19294,40,22,2000,0,0,0
19295,40,35,2000,0,0,0
19296,40,36,2000,188970,116580,72390
19297,40,126,2000,0,0,0
19298,40,90,2000,0,0,0
19299,40,23,2000,0,0,0
19300,40,164,2000,0,0,0
19301,40,63,2000,0,0,0
19302,40,165,2000,0,0,0
19303,40,37,2000,0,0,0
19304,40,64,2000,0,0,0
19305,40,128,2000,0,0,0
19306,40,115,2000,0,0,0
19307,40,65,2000,0,0,0
19308,40,10,2000,0,0,0
19309,40,145,2000,0,0,0
19310,40,113,2000,0,0,0
19311,40,49,2000,188,80,108
19312,40,74,2000,0,0,0
19313,40,25,2000,0,0,0
19314,40,169,2000,355,187,168
19315,40,166,2000,0,0,0
19316,40,93,2000,0,0,0
19317,40,146,2000,0,0,0
19318,40,26,2000,0,0,0
19319,40,170,2000,371,219,152
19320,40,130,2000,0,0,0
19321,40,38,2000,24457,12389,12068
19322,40,27,2000,0,0,0
19323,40,50,2000,64,24,40
19324,40,131,2000,0,0,0
19325,40,114,2000,0,0,0
19326,40,171,2000,1082,583,499
19327,40,1,2000,0,0,0
19328,40,28,2000,0,0,0
19329,40,132,2000,0,0,0
19330,40,133,2000,0,0,0
19331,148,134,2000,166,81,85
19332,148,147,2000,83,48,35
19333,148,116,2000,255,128,127
19334,148,137,2000,36,17,19
19335,148,137,2000,193,94,99
19336,148,120,2000,15,7,8
19337,148,149,2000,131,98,33
19338,148,159,2000,18,9,9
19339,148,125,2000,13127,5097,8030
19340,148,126,2000,112,57,55
19341,148,128,2000,116,56,60
19342,148,115,2000,12272,6386,5886
19343,148,130,2000,30,15,15
19344,120,116,2000,35,13,22
19345,120,137,2000,90,33,57
19346,120,119,2000,6843,2530,4313
19347,120,118,2000,3258,1205,2053
19348,120,126,2000,132,49,83
19349,120,128,2000,389419,207097,182322
19350,120,129,2000,131405,48585,82820
19351,120,145,2000,18417,6809,11608
19352,120,130,2000,192,71,121
19353,120,28,2000,127,47,80
19354,41,105,2000,6,3,3
19355,41,30,2000,3,1,2
19356,41,172,2000,1,0,1
19357,41,107,2000,43,18,25
19358,41,54,2000,0,0,0
19359,41,39,2000,2528,1144,1384
19360,41,120,2000,1,0,1
19361,41,69,2000,16,7,9
19362,41,156,2000,0,0,0
19363,41,43,2000,218,92,126
19364,41,5,2000,38,23,15
19365,41,121,2000,2,0,2
19366,41,47,2000,0,0,0
19367,41,48,2000,129,67,62
19368,41,112,2000,1,1,0
19369,41,33,2000,49,20,29
19370,41,35,2000,11,4,7
19371,41,36,2000,9,6,3
19372,41,63,2000,13,5,8
19373,41,115,2000,1,1,0
19374,41,49,2000,59,26,33
19375,41,146,2000,3,0,3
19376,41,50,2000,88,48,40
19377,42,2,2000,284,143,141
19378,42,51,2000,34,12,22
19379,42,141,2000,377,50,327
19380,42,52,2000,1,0,1
19381,42,134,2000,94,34,60
19382,42,76,2000,0,0,0
19383,42,103,2000,132,55,77
19384,42,11,2000,19,10,9
19385,42,77,2000,0,0,0
19386,42,66,2000,262,108,154
19387,42,12,2000,8,5,3
19388,42,78,2000,3,2,1
19389,42,13,2000,3,2,1
19390,42,3,2000,347,105,242
19391,42,79,2000,7,2,5
19392,42,29,2000,32,19,13
19393,42,67,2000,173,71,102
19394,42,95,2000,2,1,1
19395,42,151,2000,1,0,1
19396,42,4,2000,0,0,0
19397,42,53,2000,200,94,106
19398,42,147,2000,3,2,1
19399,42,105,2000,243,138,105
19400,42,30,2000,421,172,249
19401,42,152,2000,1,1,0
19402,42,116,2000,5,2,3
19403,42,153,2000,4,2,2
19404,42,135,2000,24,8,16
19405,42,136,2000,3,0,3
19406,42,106,2000,183,87,96
19407,42,172,2000,1783,917,866
19408,42,107,2000,352,157,195
19409,42,117,2000,2,1,1
19410,42,137,2000,12,6,6
19411,42,96,2000,21,10,11
19412,42,54,2000,104,50,54
19413,42,81,2000,125,42,83
19414,42,14,2000,64,14,50
19415,42,31,2000,283,141,142
19416,42,176,2000,1,1,0
19417,42,137,2000,277,97,180
19418,42,39,2000,595,237,358
19419,42,118,2000,2,1,1
19420,42,82,2000,1,0,1
19421,42,83,2000,34,16,18
19422,42,108,2000,45,20,25
19423,42,142,2000,342,38,304
19424,42,97,2000,17,8,9
19425,42,138,2000,0,0,0
19426,42,119,2000,9,6,3
19427,42,40,2000,6569,3568,3001
19428,42,148,2000,0,0,0
19429,42,120,2000,584,243,341
19430,42,68,2000,916,337,579
19431,42,139,2000,1,1,0
19432,42,155,2000,169,14,155
19433,42,15,2000,9,6,3
19434,42,69,2000,3013,1120,1893
19435,42,156,2000,248,55,193
19436,42,56,2000,394,61,333
19437,42,84,2000,0,0,0
19438,42,98,2000,25,6,19
19439,42,157,2000,8,1,7
19440,42,158,2000,3,0,3
19441,42,110,2000,8,5,3
19442,42,85,2000,1,0,1
19443,42,99,2000,14,10,4
19444,42,32,2000,734,311,423
19445,42,43,2000,101,42,59
19446,42,5,2000,986,349,637
19447,42,6,2000,1762,663,1099
19448,42,16,2000,2699,1121,1578
19449,42,44,2000,168,40,128
19450,42,17,2000,391,117,274
19451,42,57,2000,806,188,618
19452,42,86,2000,29,10,19
19453,42,177,2000,538,262,276
19454,42,18,2000,118,23,95
19455,42,167,2000,44,23,21
19456,42,121,2000,180,83,97
19457,42,19,2000,61,20,41
19458,42,168,2000,2,2,0
19459,42,46,2000,234,131,103
19460,42,20,2000,249,72,177
19461,42,159,2000,34,5,29
19462,42,143,2000,61,20,41
19463,42,47,2000,135,81,54
19464,42,71,2000,27,10,17
19465,42,122,2000,3,2,1
19466,42,123,2000,2,0,2
19467,42,7,2000,1,0,1
19468,42,160,2000,3,0,3
19469,42,58,2000,18,4,14
19470,42,161,2000,0,0,0
19471,42,124,2000,22,11,11
19472,42,100,2000,129,62,67
19473,42,72,2000,2,0,2
19474,42,59,2000,0,0,0
19475,42,144,2000,871,141,730
19476,42,125,2000,18,14,4
19477,42,150,2000,24,13,11
19478,42,8,2000,82,28,54
19479,42,73,2000,615,148,467
19480,42,101,2000,41,25,16
19481,42,162,2000,245,35,210
19482,42,60,2000,0,0,0
19483,42,48,2000,802,372,430
19484,42,21,2000,2,1,1
19485,42,9,2000,334,100,234
19486,42,102,2000,12,2,10
19487,42,111,2000,6,3,3
19488,42,112,2000,161,84,77
19489,42,33,2000,987,506,481
19490,42,61,2000,119,38,81
19491,42,22,2000,4,2,2
19492,42,35,2000,593,240,353
19493,42,36,2000,2602,1550,1052
19494,42,126,2000,24,13,11
19495,42,90,2000,1,0,1
19496,42,91,2000,1,0,1
19497,42,92,2000,2,0,2
19498,42,62,2000,0,0,0
19499,42,23,2000,169,82,87
19500,42,164,2000,34,4,30
19501,42,63,2000,0,0,0
19502,42,127,2000,2,1,1
19503,42,165,2000,36,6,30
19504,42,37,2000,14,6,8
19505,42,64,2000,4,1,3
19506,42,128,2000,3490,1513,1977
19507,42,115,2000,175,78,97
19508,42,129,2000,0,0,0
19509,42,65,2000,655,236,419
19510,42,10,2000,304,134,170
19511,42,145,2000,0,0,0
19512,42,113,2000,3,1,2
19513,42,49,2000,23584,10912,12672
19514,42,74,2000,517,207,310
19515,42,25,2000,161,58,103
19516,42,169,2000,3,2,1
19517,42,166,2000,12,1,11
19518,42,93,2000,13,6,7
19519,42,146,2000,252,31,221
19520,42,26,2000,1808,375,1433
19521,42,170,2000,4,2,2
19522,42,94,2000,0,0,0
19523,42,130,2000,22,8,14
19524,42,38,2000,183,106,77
19525,42,27,2000,30,7,23
19526,42,50,2000,2297,651,1646
19527,42,131,2000,145,54,91
19528,42,114,2000,43,13,30
19529,42,171,2000,11,6,5
19530,42,1,2000,2424,1198,1226
19531,42,28,2000,19,7,12
19532,42,132,2000,59,32,27
19533,42,133,2000,19,8,11
19534,68,2,2000,3563,1580,1983
19535,68,51,2000,3611,1687,1924
19536,68,141,2000,839920,376506,463414
19537,68,52,2000,1313,736,577
19538,68,134,2000,12243,5444,6799
19539,68,75,2000,9,3,6
19540,68,76,2000,20,15,5
19541,68,103,2000,10793,6097,4696
19542,68,11,2000,6970,3910,3060
19543,68,77,2000,10,6,4
19544,68,66,2000,12429,8438,3991
19545,68,12,2000,426,216,210
19546,68,78,2000,69,42,27
19547,68,13,2000,58,31,27
19548,68,3,2000,2340,842,1498
19549,68,79,2000,45,25,20
19550,68,29,2000,1199,741,458
19551,68,67,2000,136250,80957,55293
19552,68,95,2000,7,6,1
19553,68,151,2000,12218,5663,6555
19554,68,4,2000,255,98,157
19555,68,53,2000,8898,4568,4330
19556,68,147,2000,194,106,88
19557,68,105,2000,21756,13208,8548
19558,68,30,2000,10012,5718,4294
19559,68,152,2000,4079,1900,2179
19560,68,116,2000,1431,803,628
19561,68,153,2000,17416,9578,7838
19562,68,135,2000,39229,21433,17796
19563,68,136,2000,2719,1203,1516
19564,68,106,2000,14060,7372,6688
19565,68,172,2000,44375,24227,20148
19566,68,173,2000,2371,1319,1052
19567,68,174,2000,118,61,57
19568,68,107,2000,16023,9149,6874
19569,68,117,2000,20078,10569,9509
19570,68,137,2000,51524,24783,26741
19571,68,96,2000,448,252,196
19572,68,54,2000,11140,5347,5793
19573,68,81,2000,2162,1286,876
19574,68,14,2000,1142,599,543
19575,68,31,2000,12288,7652,4636
19576,68,176,2000,105,66,39
19577,68,137,2000,34614,17577,17037
19578,68,39,2000,7210,4620,2590
19579,68,118,2000,3247,1569,1678
19580,68,82,2000,792,528,264
19581,68,83,2000,483,322,161
19582,68,108,2000,1688,1085,603
19583,68,142,2000,23905,8651,15254
19584,68,97,2000,1064,636,428
19585,68,138,2000,153,88,65
19586,68,119,2000,171,110,61
19587,68,40,2000,881,556,325
19588,68,148,2000,9,6,3
19589,68,120,2000,4099,2568,1531
19590,68,41,2000,4,3,1
19591,68,42,2000,4698,3527,1171
19592,68,139,2000,8453,4509,3944
19593,68,155,2000,1415,691,724
19594,68,15,2000,1424,745,679
19595,68,69,2000,182688,114897,67791
19596,68,156,2000,5936,2876,3060
19597,68,55,2000,67,46,21
19598,68,56,2000,14818,7761,7057
19599,68,98,2000,1719,899,820
19600,68,157,2000,8321,3740,4581
19601,68,158,2000,8581,3596,4985
19602,68,110,2000,32,19,13
19603,68,85,2000,27950,15810,12140
19604,68,99,2000,514,305,209
19605,68,32,2000,14270,6849,7421
19606,68,43,2000,422,265,157
19607,68,5,2000,27486,14448,13038
19608,68,6,2000,24869,11567,13302
19609,68,16,2000,4912,2125,2787
19610,68,44,2000,7135,4574,2561
19611,68,45,2000,13,10,3
19612,68,17,2000,6245,3191,3054
19613,68,57,2000,555528,289009,266519
19614,68,86,2000,493,305,188
19615,68,177,2000,19232,12482,6750
19616,68,18,2000,1001,331,670
19617,68,167,2000,464,270,194
19618,68,121,2000,1008,694,314
19619,68,19,2000,724,292,432
19620,68,168,2000,109,75,34
19621,68,46,2000,1395,782,613
19622,68,20,2000,41094,17519,23575
19623,68,149,2000,10,4,6
19624,68,159,2000,855,341,514
19625,68,143,2000,1441,687,754
19626,68,70,2000,109,52,57
19627,68,47,2000,1647,967,680
19628,68,71,2000,8534,5038,3496
19629,68,122,2000,41245,25002,16243
19630,68,123,2000,82,42,40
19631,68,7,2000,4,1,3
19632,68,160,2000,52487,19100,33387
19633,68,58,2000,969,542,427
19634,68,161,2000,12017,3830,8187
19635,68,124,2000,40565,24418,16147
19636,68,100,2000,6712,4250,2462
19637,68,72,2000,3494,1764,1730
19638,68,59,2000,1011,492,519
19639,68,87,2000,6,6,0
19640,68,144,2000,760148,353364,406784
19641,68,125,2000,1116,621,495
19642,68,150,2000,111,60,51
19643,68,8,2000,753,408,345
19644,68,73,2000,36645,20456,16189
19645,68,101,2000,521,341,180
19646,68,162,2000,2886,1319,1567
19647,68,60,2000,79353,40035,39318
19648,68,48,2000,3468,2283,1185
19649,68,21,2000,22,9,13
19650,68,9,2000,16586,6322,10264
19651,68,102,2000,381,225,156
19652,68,111,2000,804,449,355
19653,68,112,2000,8418,5009,3409
19654,68,33,2000,143793,95709,48084
19655,68,61,2000,831900,413356,418544
19656,68,88,2000,309,155,154
19657,68,22,2000,160,88,72
19658,68,35,2000,33993,18021,15972
19659,68,36,2000,22760,15454,7306
19660,68,126,2000,3354,1836,1518
19661,68,90,2000,6,4,2
19662,68,91,2000,165,113,52
19663,68,92,2000,99,72,27
19664,68,62,2000,264,130,134
19665,68,140,2000,136,80,56
19666,68,23,2000,1326,608,718
19667,68,164,2000,78572,33587,44985
19668,68,63,2000,2021,985,1036
19669,68,127,2000,457,326,131
19670,68,165,2000,759,399,360
19671,68,37,2000,2950,1747,1203
19672,68,64,2000,3571,1994,1577
19673,68,128,2000,1581,817,764
19674,68,115,2000,2552,1519,1033
19675,68,65,2000,461791,258212,203579
19676,68,10,2000,35177,16455,18722
19677,68,145,2000,1205,462,743
19678,68,113,2000,284,165,119
19679,68,49,2000,11292,7816,3476
19680,68,74,2000,64818,37734,27084
19681,68,25,2000,14526,6032,8494
19682,68,169,2000,32,18,14
19683,68,166,2000,15461,7259,8202
19684,68,93,2000,286,204,82
19685,68,146,2000,294250,127368,166882
19686,68,26,2000,256739,123100,133639
19687,68,170,2000,230,130,100
19688,68,94,2000,7,4,3
19689,68,130,2000,448,264,184
19690,68,38,2000,8378,5624,2754
19691,68,27,2000,283,124,159
19692,68,50,2000,108951,58744,50207
19693,68,131,2000,670,386,284
19694,68,114,2000,2198,1197,1001
19695,68,171,2000,322,185,137
19696,68,1,2000,105501,56693,48808
19697,68,28,2000,970,529,441
19698,68,132,2000,293,161,132
19699,68,133,2000,411,231,180
19700,109,141,2000,93,47,46
19701,109,67,2000,145,74,71
19702,109,105,2000,7840,3964,3876
19703,109,172,2000,1440,727,713
19704,109,82,2000,542,385,157
19705,109,68,2000,20826,9526,11300
19706,109,110,2000,2696,1363,1333
19707,109,85,2000,13157,6652,6505
19708,109,57,2000,132,67,65
19709,109,112,2000,379,192,187
19710,109,91,2000,1408,712,696
19711,109,113,2000,15472,7822,7650
19712,139,141,2000,57,22,35
19713,139,134,2000,572,234,338
19714,139,67,2000,258,116,142
19715,139,116,2000,87,35,52
19716,139,135,2000,26199,13126,13073
19717,139,136,2000,2339,928,1411
19718,139,172,2000,179,51,128
19719,139,137,2000,8440,4499,3941
19720,139,137,2000,4607,2113,2494
19721,139,151,2000,26999,13296,13703
19722,139,138,2000,44984,22711,22273
19723,139,68,2000,8312,3596,4716
19724,139,69,2000,46,20,26
19725,139,156,2000,3291,482,2809
19726,139,157,2000,2574,670,1904
19727,139,17,2000,7,3,4
19728,139,177,2000,16,7,9
19729,139,176,2000,83,33,50
19730,139,20,2000,1293,393,900
19731,139,160,2000,28529,10200,18329
19732,139,144,2000,369,187,182
19733,139,162,2000,12367,3383,8984
19734,139,126,2000,108,53,55
19735,139,140,2000,3366,1781,1585
19736,139,164,2000,15776,3200,12576
19737,139,115,2000,7,0,7
19738,139,25,2000,15,7,8
19739,139,166,2000,11905,5967,5938
19740,139,146,2000,116,51,65
19741,139,152,2000,3616,1433,2183
19742,155,157,2000,38423,16030,22393
19743,155,159,2000,173,80,93
19744,155,160,2000,8805,3204,5601
19745,155,161,2000,3100,454,2646
19746,155,158,2000,11733,5998,5735
19747,155,164,2000,112746,56483,56263
19748,155,165,2000,2218,1027,1191
19749,15,2,2000,42,20,22
19750,15,51,2000,11,7,4
19751,15,141,2000,18,11,7
19752,15,12,2000,5780,3795,1985
19753,15,103,2000,16,8,8
19754,15,66,2000,26,12,14
19755,15,11,2000,12268,5547,6721
19756,15,67,2000,23,14,9
19757,15,30,2000,225,124,101
19758,15,29,2000,1059,857,202
19759,15,172,2000,74,38,36
19760,15,81,2000,13,6,7
19761,15,31,2000,34,22,12
19762,15,40,2000,120,83,37
19763,15,42,2000,12,9,3
19764,15,68,2000,41,27,14
19765,15,69,2000,607,334,273
19766,15,56,2000,159,76,83
19767,15,32,2000,49,28,21
19768,15,5,2000,32,13,19
19769,15,6,2000,120,53,67
19770,15,17,2000,32,12,20
19771,15,57,2000,18,7,11
19772,15,167,2000,1651,718,933
19773,15,168,2000,242,163,79
19774,15,20,2000,10,6,4
19775,15,46,2000,199,130,69
19776,15,47,2000,205,157,48
19777,15,8,2000,18,0,18
19778,15,73,2000,12,8,4
19779,15,9,2000,86,7,79
19780,15,112,2000,22,20,2
19781,15,33,2000,175,126,49
19782,15,35,2000,213,162,51
19783,15,36,2000,35672,20440,15232
19784,15,65,2000,20,10,10
19785,15,74,2000,15,8,7
19786,15,169,2000,145,92,53
19787,15,26,2000,455,139,316
19788,15,170,2000,197,128,69
19789,15,38,2000,11706,6674,5032
19790,15,50,2000,34,10,24
19791,15,171,2000,736,476,260
19792,69,2,2000,69794,32463,37331
19793,69,51,2000,11394,5106,6288
19794,69,141,2000,16238,3335,12903
19795,69,134,2000,0,0,0
19796,69,103,2000,4732,2871,1861
19797,69,11,2000,10202,5091,5111
19798,69,66,2000,181487,86088,95399
19799,69,12,2000,12642,6233,6409
19800,69,3,2000,5841,1200,4641
19801,69,29,2000,19854,12724,7130
19802,69,67,2000,22711,11901,10810
19803,69,151,2000,1108,279,829
19804,69,53,2000,151087,76190,74897
19805,69,105,2000,23338,17846,5492
19806,69,30,2000,33214,15630,17584
19807,69,152,2000,2029,196,1833
19808,69,116,2000,429,162,267
19809,69,135,2000,9001,3016,5985
19810,69,136,2000,297,40,257
19811,69,106,2000,6279,3560,2719
19812,69,172,2000,49190,22006,27184
19813,69,107,2000,8584,6047,2537
19814,69,137,2000,1337,546,791
19815,69,96,2000,762,511,251
19816,69,54,2000,209603,106303,103300
19817,69,81,2000,7251,3908,3343
19818,69,14,2000,933,413,520
19819,69,31,2000,423416,228991,194425
19820,69,176,2000,1628,838,790
19821,69,137,2000,14396,6281,8115
19822,69,39,2000,20265,11914,8351
19823,69,83,2000,4643,3645,998
19824,69,108,2000,3541,2195,1346
19825,69,142,2000,13558,3582,9976
19826,69,97,2000,483,301,182
19827,69,119,2000,5143,2395,2748
19828,69,40,2000,9153,6415,2738
19829,69,120,2000,14795,6874,7921
19830,69,42,2000,15373,11126,4247
19831,69,68,2000,106502,59620,46882
19832,69,139,2000,241,70,171
19833,69,155,2000,2614,366,2248
19834,69,15,2000,10482,5993,4489
19835,69,156,2000,22086,10175,11911
19836,69,56,2000,353263,166537,186726
19837,69,98,2000,653,402,251
19838,69,157,2000,1993,381,1612
19839,69,85,2000,408,240,168
19840,69,99,2000,557,387,170
19841,69,32,2000,88901,34696,54205
19842,69,43,2000,1500,784,716
19843,69,5,2000,34011,10659,23352
19844,69,6,2000,104331,44682,59649
19845,69,16,2000,58884,20582,38302
19846,69,44,2000,15167,7348,7819
19847,69,17,2000,8951,3795,5156
19848,69,57,2000,498084,196719,301365
19849,69,86,2000,1269,771,498
19850,69,177,2000,31276,17545,13731
19851,69,18,2000,10558,3353,7205
19852,69,167,2000,487090,280375,206715
19853,69,121,2000,4570,3152,1418
19854,69,168,2000,32977,19056,13921
19855,69,46,2000,12990,7904,5086
19856,69,20,2000,49663,21407,28256
19857,69,159,2000,3116,481,2635
19858,69,143,2000,2698,839,1859
19859,69,70,2000,163,104,59
19860,69,47,2000,16516,11591,4925
19861,69,71,2000,5782,2773,3009
19862,69,122,2000,646,386,260
19863,69,160,2000,809,167,642
19864,69,58,2000,344,211,133
19865,69,100,2000,5867,4092,1775
19866,69,59,2000,43133,20149,22984
19867,69,144,2000,77592,31923,45669
19868,69,8,2000,1905,536,1369
19869,69,73,2000,107095,51297,55798
19870,69,101,2000,615,344,271
19871,69,162,2000,14877,3398,11479
19872,69,60,2000,53889,27513,26376
19873,69,48,2000,7344,4254,3090
19874,69,9,2000,35783,12375,23408
19875,69,102,2000,267,160,107
19876,69,111,2000,826,566,260
19877,69,112,2000,7957,5252,2705
19878,69,33,2000,670656,387351,283305
19879,69,61,2000,129271,58420,70851
19880,69,35,2000,322922,152875,170047
19881,69,36,2000,903777,542959,360818
19882,69,126,2000,873,380,493
19883,69,23,2000,747,266,481
19884,69,164,2000,2571,449,2122
19885,69,63,2000,597290,279017,318273
19886,69,165,2000,5223,869,4354
19887,69,37,2000,24447,10276,14171
19888,69,64,2000,26160,13163,12997
19889,69,128,2000,7749,3462,4287
19890,69,115,2000,5060,3106,1954
19891,69,65,2000,125158,62434,62724
19892,69,10,2000,48894,21277,27617
19893,69,145,2000,0,0,0
19894,69,49,2000,18246,10520,7726
19895,69,74,2000,36709,21344,15365
19896,69,25,2000,25116,10743,14373
19897,69,169,2000,8044,4404,3640
19898,69,166,2000,11277,3497,7780
19899,69,93,2000,454,287,167
19900,69,146,2000,23332,8216,15116
19901,69,26,2000,1604965,725019,879946
19902,69,170,2000,3519,2018,1501
19903,69,130,2000,1288,609,679
19904,69,38,2000,155257,92723,62534
19905,69,50,2000,111510,46878,64632
19906,69,131,2000,997,446,551
19907,69,114,2000,733,421,312
19908,69,171,2000,15193,8642,6551
19909,69,1,2000,81335,38660,42675
19910,69,28,2000,1693,538,1155
19911,69,132,2000,381,164,217
19912,156,141,2000,8,2,6
19913,156,105,2000,8,4,4
19914,156,135,2000,68,25,43
19915,156,10,2000,17,8,9
19916,156,136,2000,9,2,7
19917,156,172,2000,135,24,111
19918,156,137,2000,18,10,8
19919,156,151,2000,9987,4925,5062
19920,156,120,2000,18,10,8
19921,156,68,2000,130,61,69
19922,156,155,2000,21,8,13
19923,156,157,2000,82,33,49
19924,156,5,2000,506,216,290
19925,156,17,2000,27,13,14
19926,156,57,2000,137,58,79
19927,156,177,2000,33,13,20
19928,156,121,2000,9,2,7
19929,156,20,2000,585,251,334
19930,156,159,2000,13084,6030,7054
19931,156,160,2000,4004,1172,2832
19932,156,161,2000,10,3,7
19933,156,73,2000,146,64,82
19934,156,162,2000,16584,7707,8877
19935,156,9,2000,52,24,28
19936,156,33,2000,38,20,18
19937,156,36,2000,52,30,22
19938,156,126,2000,299,191,108
19939,156,164,2000,59,22,37
19940,156,165,2000,2385,1142,1243
19941,156,145,2000,20,4,16
19942,156,74,2000,116,51,65
19943,156,25,2000,41,19,22
19944,156,166,2000,72060,39689,32371
19945,156,142,2000,23,11,12
19946,156,50,2000,1084,554,530
19947,156,131,2000,7,3,4
19948,156,152,2000,46451,20838,25613
19949,55,144,2000,1107,375,732
19950,55,65,2000,2077,1461,616
19951,55,50,2000,3607,1727,1880
19952,56,2,2000,331,52,279
19953,56,51,2000,400253,165118,235135
19954,56,141,2000,317,128,189
19955,56,52,2000,4,0,4
19956,56,134,2000,19,11,8
19957,56,75,2000,17,8,9
19958,56,76,2000,14,5,9
19959,56,103,2000,626,393,233
19960,56,11,2000,8899,4636,4263
19961,56,77,2000,92,42,50
19962,56,66,2000,2232,1517,715
19963,56,12,2000,387,234,153
19964,56,78,2000,21,13,8
19965,56,13,2000,26,13,13
19966,56,3,2000,4694,150,4544
19967,56,79,2000,8,3,5
19968,56,29,2000,564,404,160
19969,56,67,2000,4629,2724,1905
19970,56,95,2000,2,1,1
19971,56,151,2000,9,3,6
19972,56,4,2000,3,0,3
19973,56,53,2000,363,224,139
19974,56,147,2000,3,3,0
19975,56,105,2000,2094,1392,702
19976,56,30,2000,38534,23581,14953
19977,56,152,2000,7,3,4
19978,56,116,2000,137,75,62
19979,56,153,2000,34,16,18
19980,56,135,2000,434,213,221
19981,56,80,2000,10,7,3
19982,56,136,2000,24,7,17
19983,56,106,2000,391,245,146
19984,56,172,2000,560,240,320
19985,56,173,2000,51,24,27
19986,56,107,2000,385,300,85
19987,56,117,2000,0,0,0
19988,56,137,2000,843,423,420
19989,56,96,2000,27,18,9
19990,56,54,2000,355,235,120
19991,56,81,2000,208,154,54
19992,56,14,2000,22334,12841,9493
19993,56,31,2000,3692,2080,1612
19994,56,176,2000,11,7,4
19995,56,137,2000,1215,679,536
19996,56,39,2000,813,573,240
19997,56,118,2000,24,14,10
19998,56,82,2000,398,358,40
19999,56,83,2000,169,146,23
20000,56,108,2000,46,41,5
20001,56,142,2000,32396,15510,16886
20002,56,97,2000,34,23,11
20003,56,138,2000,0,0,0
20004,56,119,2000,99,57,42
20005,56,40,2000,60,40,20
20006,56,148,2000,13,10,3
20007,56,120,2000,2484,1570,914
20008,56,41,2000,2,2,0
20009,56,42,2000,841,711,130
20010,56,68,2000,6549,4106,2443
20011,56,109,2000,4,2,2
20012,56,139,2000,45,20,25
20013,56,155,2000,44,23,21
20014,56,15,2000,71047,38251,32796
20015,56,69,2000,100521,54033,46488
20016,56,156,2000,403,120,283
20017,56,55,2000,12,8,4
20018,56,84,2000,6,5,1
20019,56,98,2000,33,26,7
20020,56,157,2000,24,8,16
20021,56,158,2000,7,6,1
20022,56,110,2000,12,7,5
20023,56,85,2000,32,18,14
20024,56,99,2000,33,23,10
20025,56,32,2000,1572,960,612
20026,56,43,2000,32,23,9
20027,56,5,2000,6983,546,6437
20028,56,6,2000,1279,446,833
20029,56,16,2000,6875,2105,4770
20030,56,44,2000,494,367,127
20031,56,45,2000,12,5,7
20032,56,17,2000,667,289,378
20033,56,57,2000,5876,3509,2367
20034,56,86,2000,65,32,33
20035,56,177,2000,555,392,163
20036,56,18,2000,813,197,616
20037,56,167,2000,24182,12796,11386
20038,56,121,2000,365,229,136
20039,56,19,2000,147,60,87
20040,56,168,2000,211,122,89
20041,56,46,2000,56,44,12
20042,56,20,2000,2207,890,1317
20043,56,149,2000,2,2,0
20044,56,159,2000,21,9,12
20045,56,143,2000,587,253,334
20046,56,70,2000,6,3,3
20047,56,47,2000,167,132,35
20048,56,71,2000,98,56,42
20049,56,122,2000,140,78,62
20050,56,7,2000,4,2,2
20051,56,160,2000,17,5,12
20052,56,58,2000,99,66,33
20053,56,161,2000,5,2,3
20054,56,124,2000,52,38,14
20055,56,100,2000,360,283,77
20056,56,72,2000,22,14,8
20057,56,87,2000,2,0,2
20058,56,144,2000,795,391,404
20059,56,125,2000,65,41,24
20060,56,150,2000,7,1,6
20061,56,8,2000,14,4,10
20062,56,73,2000,3056,2139,917
20063,56,101,2000,30,18,12
20064,56,162,2000,1872,524,1348
20065,56,60,2000,928,416,512
20066,56,48,2000,455,333,122
20067,56,21,2000,3,1,2
20068,56,9,2000,10780,400,10380
20069,56,102,2000,137,84,53
20070,56,111,2000,56,50,6
20071,56,112,2000,168,128,40
20072,56,33,2000,15330,8643,6687
20073,56,61,2000,289,208,81
20074,56,88,2000,20,10,10
20075,56,22,2000,12,2,10
20076,56,35,2000,26311,12585,13726
20077,56,36,2000,72032,41759,30273
20078,56,126,2000,125,32,93
20079,56,90,2000,6,3,3
20080,56,92,2000,114,18,96
20081,56,62,2000,9,6,3
20082,56,140,2000,4,2,2
20083,56,23,2000,456,200,256
20084,56,164,2000,46,18,28
20085,56,63,2000,5057,2874,2183
20086,56,127,2000,33,25,8
20087,56,165,2000,258,92,166
20088,56,37,2000,407,291,116
20089,56,64,2000,107,78,29
20090,56,128,2000,66,29,37
20091,56,115,2000,5497,3107,2390
20092,56,65,2000,963,693,270
20093,56,10,2000,811,536,275
20094,56,145,2000,1404,678,726
20095,56,113,2000,2,1,1
20096,56,49,2000,5380,3108,2272
20097,56,74,2000,3535,2066,1469
20098,56,25,2000,5996,1219,4777
20099,56,169,2000,66,42,24
20100,56,166,2000,14,10,4
20101,56,93,2000,10,7,3
20102,56,146,2000,291,107,184
20103,56,26,2000,75879,44661,31218
20104,56,170,2000,97,55,42
20105,56,130,2000,93,57,36
20106,56,38,2000,16512,12368,4144
20107,56,27,2000,77,28,49
20108,56,50,2000,13169,8457,4712
20109,56,131,2000,398,181,217
20110,56,114,2000,119,82,37
20111,56,171,2000,5167,2801,2366
20112,56,1,2000,224,100,124
20113,56,28,2000,25,8,17
20114,56,132,2000,240,114,126
20115,56,133,2000,450,250,200
20116,84,76,2000,35,18,17
20117,84,78,2000,27,14,13
20118,84,79,2000,161,81,80
20119,84,82,2000,67,34,33
20120,84,110,2000,308,261,47
20121,84,86,2000,105,53,52
20122,84,87,2000,9,4,5
20123,84,90,2000,14,6,8
20124,84,91,2000,147,74,73
20125,84,92,2000,341,263,78
20126,84,93,2000,1980,1331,649
20127,98,103,2000,350,155,195
20128,98,105,2000,151,82,69
20129,98,95,2000,579,313,266
20130,98,106,2000,191,93,98
20131,98,172,2000,415,201,214
20132,98,107,2000,730,391,339
20133,98,96,2000,734,415,319
20134,98,81,2000,418,200,218
20135,98,83,2000,68,36,32
20136,98,108,2000,105,51,54
20137,98,97,2000,12037,7881,4156
20138,98,68,2000,163,65,98
20139,98,109,2000,13,7,6
20140,98,69,2000,404,189,215
20141,98,85,2000,10,5,5
20142,98,99,2000,5295,3302,1993
20143,98,6,2000,12,5,7
20144,98,17,2000,83,32,51
20145,98,57,2000,232,81,151
20146,98,177,2000,94,41,53
20147,98,20,2000,15,4,11
20148,98,100,2000,11070,5696,5374
20149,98,73,2000,89,40,49
20150,98,101,2000,5404,2939,2465
20151,98,9,2000,16,9,7
20152,98,102,2000,190,106,84
20153,98,111,2000,38,18,20
20154,98,112,2000,288,142,146
20155,98,61,2000,17,3,14
20156,98,88,2000,65,32,33
20157,98,23,2000,20,6,14
20158,98,65,2000,833,364,469
20159,98,49,2000,30,13,17
20160,98,74,2000,96,39,57
20161,98,25,2000,49,18,31
20162,98,26,2000,15,10,5
20163,98,142,2000,20,17,3
20164,98,50,2000,142,63,79
20165,98,114,2000,89,36,53
20166,157,2,2000,0,0,0
20167,157,51,2000,0,0,0
20168,157,141,2000,0,0,0
20169,157,52,2000,0,0,0
20170,157,134,2000,0,0,0
20171,157,76,2000,0,0,0
20172,157,12,2000,0,0,0
20173,157,103,2000,0,0,0
20174,157,66,2000,0,0,0
20175,157,78,2000,0,0,0
20176,157,13,2000,0,0,0
20177,157,3,2000,0,0,0
20178,157,11,2000,0,0,0
20179,157,79,2000,0,0,0
20180,157,67,2000,166,60,106
20181,157,4,2000,0,0,0
20182,157,53,2000,0,0,0
20183,157,147,2000,0,0,0
20184,157,105,2000,199,67,132
20185,157,95,2000,0,0,0
20186,157,30,2000,0,0,0
20187,157,116,2000,0,0,0
20188,157,135,2000,0,0,0
20189,157,153,2000,78,33,45
20190,157,10,2000,0,0,0
20191,157,136,2000,0,0,0
20192,157,106,2000,0,0,0
20193,157,172,2000,166,35,131
20194,157,107,2000,0,0,0
20195,157,117,2000,0,0,0
20196,157,137,2000,0,0,0
20197,157,137,2000,0,0,0
20198,157,96,2000,0,0,0
20199,157,54,2000,0,0,0
20200,157,81,2000,75,35,40
20201,157,151,2000,1897,775,1122
20202,157,39,2000,0,0,0
20203,157,82,2000,0,0,0
20204,157,83,2000,0,0,0
20205,157,108,2000,0,0,0
20206,157,97,2000,0,0,0
20207,157,138,2000,0,0,0
20208,157,120,2000,0,0,0
20209,157,119,2000,0,0,0
20210,157,42,2000,0,0,0
20211,157,68,2000,1325,490,835
20212,157,118,2000,0,0,0
20213,157,139,2000,0,0,0
20214,157,155,2000,654,230,424
20215,157,69,2000,0,0,0
20216,157,156,2000,0,0,0
20217,157,85,2000,0,0,0
20218,157,99,2000,0,0,0
20219,157,5,2000,0,0,0
20220,157,17,2000,0,0,0
20221,157,57,2000,0,0,0
20222,157,177,2000,33,16,17
20223,157,18,2000,0,0,0
20224,157,121,2000,0,0,0
20225,157,176,2000,0,0,0
20226,157,20,2000,0,0,0
20227,157,149,2000,0,0,0
20228,157,46,2000,0,0,0
20229,157,159,2000,138141,71142,66999
20230,157,143,2000,0,0,0
20231,157,70,2000,0,0,0
20232,157,122,2000,0,0,0
20233,157,123,2000,0,0,0
20234,157,160,2000,19422,8179,11243
20235,157,161,2000,478,150,328
20236,157,124,2000,0,0,0
20237,157,144,2000,0,0,0
20238,157,125,2000,0,0,0
20239,157,150,2000,0,0,0
20240,157,8,2000,0,0,0
20241,157,73,2000,0,0,0
20242,157,101,2000,0,0,0
20243,157,162,2000,734,172,562
20244,157,48,2000,0,0,0
20245,157,9,2000,0,0,0
20246,157,33,2000,0,0,0
20247,157,61,2000,295,137,158
20248,157,158,2000,3495,1493,2002
20249,157,35,2000,0,0,0
20250,157,36,2000,596,203,393
20251,157,126,2000,0,0,0
20252,157,92,2000,0,0,0
20253,157,140,2000,0,0,0
20254,157,23,2000,523,227,296
20255,157,164,2000,8455,2619,5836
20256,157,63,2000,0,0,0
20257,157,127,2000,0,0,0
20258,157,165,2000,365828,188401,177427
20259,157,1,2000,0,0,0
20260,157,64,2000,0,0,0
20261,157,128,2000,0,0,0
20262,157,115,2000,0,0,0
20263,157,133,2000,0,0,0
20264,157,65,2000,73,35,38
20265,157,129,2000,0,0,0
20266,157,145,2000,0,0,0
20267,157,148,2000,0,0,0
20268,157,49,2000,0,0,0
20269,157,74,2000,0,0,0
20270,157,25,2000,36,7,29
20271,157,169,2000,0,0,0
20272,157,166,2000,1833,583,1250
20273,157,146,2000,0,0,0
20274,157,26,2000,0,0,0
20275,157,130,2000,0,0,0
20276,157,38,2000,104,50,54
20277,157,142,2000,0,0,0
20278,157,50,2000,0,0,0
20279,157,131,2000,0,0,0
20280,157,152,2000,598,201,397
20281,157,114,2000,0,0,0
20282,157,171,2000,0,0,0
20283,158,153,2000,576,341,235
20284,158,68,2000,111,33,78
20285,158,155,2000,1534,756,778
20286,158,157,2000,4968,2183,2785
20287,158,159,2000,908,336,572
20288,158,161,2000,563,282,281
20289,158,61,2000,827,365,462
20290,158,164,2000,8119,4528,3591
20291,158,165,2000,960,489,471
20292,110,76,2000,10,6,4
20293,110,78,2000,8,4,4
20294,110,79,2000,216,103,113
20295,110,105,2000,1074,425,649
20296,110,172,2000,580,237,343
20297,110,82,2000,25,10,15
20298,110,84,2000,108,50,58
20299,110,86,2000,165,76,89
20300,110,91,2000,264,111,153
20301,110,92,2000,205,93,112
20302,110,113,2000,2314,1176,1138
20303,110,93,2000,430,195,235
20304,110,50,2000,290,132,158
20305,85,103,2000,419,179,240
20306,85,66,2000,152,24,128
20307,85,106,2000,300,107,193
20308,85,172,2000,313,132,181
20309,85,107,2000,746,366,380
20310,85,96,2000,246,151,95
20311,85,81,2000,1084,477,607
20312,85,83,2000,2170,956,1214
20313,85,68,2000,400,155,245
20314,85,69,2000,808,326,482
20315,85,57,2000,1106,324,782
20316,85,177,2000,198,91,107
20317,85,100,2000,275,157,118
20318,85,112,2000,316,128,188
20319,85,88,2000,1394,759,635
20320,85,65,2000,1170,426,744
20321,85,74,2000,340,123,217
20322,85,114,2000,257,156,101
20323,99,103,2000,142,64,78
20324,99,67,2000,19,6,13
20325,99,105,2000,176,107,69
20326,99,95,2000,271,132,139
20327,99,80,2000,67,33,34
20328,99,106,2000,230,117,113
20329,99,172,2000,443,166,277
20330,99,107,2000,644,289,355
20331,99,96,2000,639,305,334
20332,99,81,2000,455,148,307
20333,99,83,2000,101,39,62
20334,99,108,2000,342,114,228
20335,99,97,2000,6574,3625,2949
20336,99,68,2000,107,47,60
20337,99,69,2000,218,77,141
20338,99,98,2000,3421,1724,1697
20339,99,85,2000,33,5,28
20340,99,17,2000,67,24,43
20341,99,57,2000,194,50,144
20342,99,86,2000,20,4,16
20343,99,177,2000,103,48,55
20344,99,18,2000,30,15,15
20345,99,176,2000,47,15,32
20346,99,100,2000,1164,602,562
20347,99,73,2000,68,21,47
20348,99,101,2000,5768,2927,2841
20349,99,102,2000,296,131,165
20350,99,111,2000,26,11,15
20351,99,112,2000,285,125,160
20352,99,88,2000,96,38,58
20353,99,36,2000,19,8,11
20354,99,65,2000,391,173,218
20355,99,49,2000,23,11,12
20356,99,74,2000,46,14,32
20357,99,50,2000,76,24,52
20358,99,114,2000,50,19,31
20359,173,3,2000,366,128,238
20360,173,172,2000,1886037,908170,977867
20361,173,174,2000,60316,29587,30729
20362,173,68,2000,1811,589,1222
20363,173,69,2000,1629,415,1214
20364,173,5,2000,14864,7205,7659
20365,173,44,2000,574,230,344
20366,173,57,2000,530,188,342
20367,173,177,2000,11711,5356,6355
20368,173,8,2000,7706,3715,3991
20369,173,73,2000,842,282,560
20370,173,9,2000,6237,2382,3855
20371,173,61,2000,90,47,43
20372,173,36,2000,72,57,15
20373,173,65,2000,331,156,175
20374,173,10,2000,646,394,252
20375,173,74,2000,600,171,429
20376,173,50,2000,14585,5212,9373
20377,173,1,2000,9023,5245,3778
20378,32,2,2000,532,206,326
20379,32,51,2000,129,66,63
20380,32,141,2000,467,116,351
20381,32,52,2000,0,0,0
20382,32,134,2000,53,19,34
20383,32,76,2000,0,0,0
20384,32,103,2000,223,105,118
20385,32,11,2000,144,80,64
20386,32,77,2000,0,0,0
20387,32,66,2000,5523,2586,2937
20388,32,12,2000,103,55,48
20389,32,78,2000,5,2,3
20390,32,13,2000,10,5,5
20391,32,3,2000,46,6,40
20392,32,79,2000,3,2,1
20393,32,29,2000,159,107,52
20394,32,67,2000,1104,551,553
20395,32,95,2000,1,0,1
20396,32,151,2000,18,3,15
20397,32,4,2000,0,0,0
20398,32,53,2000,264,113,151
20399,32,147,2000,4,2,2
20400,32,105,2000,346,162,184
20401,32,30,2000,1429,788,641
20402,32,152,2000,0,0,0
20403,32,116,2000,0,0,0
20404,32,153,2000,0,0,0
20405,32,135,2000,136,38,98
20406,32,80,2000,0,0,0
20407,32,136,2000,1,1,0
20408,32,106,2000,108,52,56
20409,32,172,2000,7543,3574,3969
20410,32,107,2000,135,65,70
20411,32,117,2000,0,0,0
20412,32,137,2000,55,9,46
20413,32,96,2000,22,7,15
20414,32,54,2000,1595,868,727
20415,32,81,2000,417,243,174
20416,32,14,2000,189,96,93
20417,32,31,2000,1088,690,398
20418,32,176,2000,0,0,0
20419,32,137,2000,18,6,12
20420,32,39,2000,249,105,144
20421,32,118,2000,0,0,0
20422,32,82,2000,0,0,0
20423,32,83,2000,24,11,13
20424,32,108,2000,76,29,47
20425,32,142,2000,529,118,411
20426,32,97,2000,9,6,3
20427,32,138,2000,0,0,0
20428,32,119,2000,6,4,2
20429,32,40,2000,87,65,22
20430,32,148,2000,0,0,0
20431,32,120,2000,90,24,66
20432,32,41,2000,0,0,0
20433,32,42,2000,476,250,226
20434,32,68,2000,2613,1257,1356
20435,32,139,2000,4,2,2
20436,32,155,2000,7,3,4
20437,32,15,2000,144,67,77
20438,32,69,2000,21290,11161,10129
20439,32,156,2000,85,29,56
20440,32,56,2000,903,469,434
20441,32,84,2000,4,2,2
20442,32,98,2000,12,7,5
20443,32,157,2000,29,5,24
20444,32,158,2000,6,0,6
20445,32,110,2000,3,1,2
20446,32,85,2000,0,0,0
20447,32,99,2000,7,3,4
20448,32,43,2000,88,49,39
20449,32,5,2000,755,270,485
20450,32,6,2000,1389,540,849
20451,32,16,2000,565,182,383
20452,32,44,2000,548,270,278
20453,32,17,2000,1147,484,663
20454,32,57,2000,2609,990,1619
20455,32,86,2000,19,7,12
20456,32,177,2000,919,463,456
20457,32,18,2000,270,69,201
20458,32,167,2000,362,193,169
20459,32,121,2000,60,28,32
20460,32,19,2000,119,41,78
20461,32,168,2000,90,72,18
20462,32,46,2000,96,73,23
20463,32,20,2000,235,55,180
20464,32,149,2000,4,1,3
20465,32,159,2000,23,7,16
20466,32,143,2000,217,77,140
20467,32,70,2000,5,3,2
20468,32,47,2000,99,57,42
20469,32,71,2000,94,44,50
20470,32,122,2000,22,13,9
20471,32,123,2000,0,0,0
20472,32,160,2000,15,2,13
20473,32,58,2000,25,13,12
20474,32,161,2000,3,0,3
20475,32,124,2000,35,16,19
20476,32,100,2000,288,140,148
20477,32,72,2000,4,2,2
20478,32,59,2000,27,10,17
20479,32,144,2000,128,36,92
20480,32,125,2000,15,6,9
20481,32,150,2000,6,2,4
20482,32,8,2000,38,13,25
20483,32,73,2000,1843,777,1066
20484,32,101,2000,15,7,8
20485,32,162,2000,799,262,537
20486,32,60,2000,98,36,62
20487,32,48,2000,793,493,300
20488,32,21,2000,11,8,3
20489,32,9,2000,158,53,105
20490,32,102,2000,18,6,12
20491,32,111,2000,14,8,6
20492,32,112,2000,149,74,75
20493,32,33,2000,2752,1843,909
20494,32,61,2000,224,90,134
20495,32,22,2000,23,10,13
20496,32,35,2000,146208,79089,67119
20497,32,36,2000,3069,1988,1081
20498,32,126,2000,12,6,6
20499,32,90,2000,3,2,1
20500,32,91,2000,0,0,0
20501,32,92,2000,3,2,1
20502,32,62,2000,0,0,0
20503,32,23,2000,220,61,159
20504,32,164,2000,17,5,12
20505,32,63,2000,16841,8613,8228
20506,32,127,2000,0,0,0
20507,32,165,2000,20,1,19
20508,32,37,2000,15089,9765,5324
20509,32,64,2000,282,140,142
20510,32,128,2000,272,59,213
20511,32,115,2000,230,110,120
20512,32,65,2000,819,408,411
20513,32,10,2000,36,15,21
20514,32,145,2000,117,27,90
20515,32,113,2000,0,0,0
20516,32,49,2000,1043,541,502
20517,32,74,2000,1512,715,797
20518,32,25,2000,846,212,634
20519,32,169,2000,12,6,6
20520,32,166,2000,6,2,4
20521,32,93,2000,9,6,3
20522,32,146,2000,129,21,108
20523,32,26,2000,1452,447,1005
20524,32,170,2000,0,0,0
20525,32,130,2000,22,8,14
20526,32,38,2000,19867,12131,7736
20527,32,27,2000,123,56,67
20528,32,50,2000,3661,1569,2092
20529,32,131,2000,40,12,28
20530,32,114,2000,46,26,20
20531,32,171,2000,79,46,33
20532,32,1,2000,2345,1231,1114
20533,32,28,2000,186,55,131
20534,32,132,2000,12,7,5
20535,32,133,2000,27,9,18
20536,43,2,2000,1,0,1
20537,43,51,2000,20,13,7
20538,43,141,2000,23,5,18
20539,43,52,2000,0,0,0
20540,43,134,2000,19,7,12
20541,43,76,2000,0,0,0
20542,43,103,2000,13,4,9
20543,43,11,2000,2,2,0
20544,43,77,2000,0,0,0
20545,43,66,2000,72,38,34
20546,43,12,2000,3,2,1
20547,43,78,2000,1,1,0
20548,43,13,2000,1,0,1
20549,43,3,2000,0,0,0
20550,43,79,2000,1,0,1
20551,43,29,2000,1,0,1
20552,43,67,2000,77,41,36
20553,43,95,2000,1,1,0
20554,43,151,2000,0,0,0
20555,43,53,2000,18,8,10
20556,43,105,2000,28,18,10
20557,43,30,2000,74,40,34
20558,43,152,2000,0,0,0
20559,43,153,2000,37,19,18
20560,43,135,2000,2,0,2
20561,43,136,2000,0,0,0
20562,43,106,2000,52,21,31
20563,43,172,2000,177,94,83
20564,43,107,2000,62,35,27
20565,43,137,2000,0,0,0
20566,43,96,2000,6,2,4
20567,43,54,2000,11,5,6
20568,43,81,2000,14,6,8
20569,43,14,2000,3,1,2
20570,43,31,2000,85,50,35
20571,43,176,2000,0,0,0
20572,43,137,2000,2,0,2
20573,43,39,2000,2302,1261,1041
20574,43,118,2000,0,0,0
20575,43,82,2000,1,0,1
20576,43,83,2000,5,4,1
20577,43,108,2000,13,7,6
20578,43,142,2000,15,4,11
20579,43,97,2000,1,1,0
20580,43,138,2000,1,1,0
20581,43,119,2000,1,0,1
20582,43,40,2000,21,13,8
20583,43,120,2000,31,15,16
20584,43,41,2000,308,183,125
20585,43,42,2000,119,82,37
20586,43,68,2000,257,131,126
20587,43,139,2000,0,0,0
20588,43,155,2000,5,2,3
20589,43,15,2000,4,2,2
20590,43,69,2000,1040,690,350
20591,43,156,2000,19,8,11
20592,43,55,2000,0,0,0
20593,43,56,2000,10,4,6
20594,43,98,2000,27,11,16
20595,43,157,2000,7,2,5
20596,43,158,2000,0,0,0
20597,43,110,2000,13,8,5
20598,43,85,2000,1,1,0
20599,43,99,2000,14,3,11
20600,43,32,2000,63,37,26
20601,43,5,2000,148,83,65
20602,43,6,2000,18,4,14
20603,43,16,2000,15,5,10
20604,43,44,2000,54,25,29
20605,43,17,2000,19,7,12
20606,43,57,2000,107,46,61
20607,43,86,2000,9,5,4
20608,43,177,2000,44,29,15
20609,43,18,2000,12,7,5
20610,43,167,2000,1,1,0
20611,43,121,2000,23,13,10
20612,43,19,2000,1,0,1
20613,43,168,2000,1,1,0
20614,43,46,2000,19,6,13
20615,43,20,2000,19,6,13
20616,43,159,2000,0,0,0
20617,43,143,2000,0,0,0
20618,43,70,2000,0,0,0
20619,43,47,2000,32,13,19
20620,43,71,2000,75,37,38
20621,43,122,2000,1,0,1
20622,43,123,2000,1,0,1
20623,43,160,2000,0,0,0
20624,43,58,2000,1,1,0
20625,43,161,2000,0,0,0
20626,43,124,2000,7,4,3
20627,43,100,2000,38,27,11
20628,43,72,2000,1,1,0
20629,43,59,2000,0,0,0
20630,43,144,2000,84,25,59
20631,43,125,2000,7,5,2
20632,43,150,2000,19,8,11
20633,43,8,2000,15,4,11
20634,43,73,2000,153,88,65
20635,43,101,2000,3,3,0
20636,43,162,2000,33,10,23
20637,43,60,2000,10,4,6
20638,43,48,2000,836,468,368
20639,43,21,2000,0,0,0
20640,43,9,2000,12,5,7
20641,43,102,2000,2,1,1
20642,43,111,2000,2,1,1
20643,43,112,2000,39,24,15
20644,43,33,2000,1491,826,665
20645,43,61,2000,97,35,62
20646,43,88,2000,1,0,1
20647,43,22,2000,2,2,0
20648,43,35,2000,66,20,46
20649,43,36,2000,508,287,221
20650,43,126,2000,1,0,1
20651,43,92,2000,0,0,0
20652,43,62,2000,0,0,0
20653,43,23,2000,2,2,0
20654,43,164,2000,6,2,4
20655,43,63,2000,614,264,350
20656,43,165,2000,10,4,6
20657,43,37,2000,3,2,1
20658,43,64,2000,11,4,7
20659,43,128,2000,1,1,0
20660,43,115,2000,63,40,23
20661,43,65,2000,154,59,95
20662,43,10,2000,102,68,34
20663,43,145,2000,0,0,0
20664,43,49,2000,1547,811,736
20665,43,74,2000,73,34,39
20666,43,25,2000,14,3,11
20667,43,169,2000,3,2,1
20668,43,166,2000,1,0,1
20669,43,93,2000,3,2,1
20670,43,146,2000,12,2,10
20671,43,26,2000,35,13,22
20672,43,170,2000,0,0,0
20673,43,130,2000,6,6,0
20674,43,38,2000,22,15,7
20675,43,27,2000,1,0,1
20676,43,50,2000,721,314,407
20677,43,131,2000,10,6,4
20678,43,114,2000,6,2,4
20679,43,171,2000,2,1,1
20680,43,1,2000,220,119,101
20681,43,28,2000,0,0,0
20682,43,132,2000,4,3,1
20683,43,133,2000,8,8,0
20684,5,2,2000,12794,6201,6593
20685,5,3,2000,3879114,1842778,2036336
20686,5,4,2000,8131,3887,4244
20687,5,172,2000,92343,44760,47583
20688,5,68,2000,1397,733,664
20689,5,69,2000,2626,1688,938
20690,5,6,2000,2086,1129,957
20691,5,16,2000,610,316,294
20692,5,177,2000,876,524,352
20693,5,167,2000,2696,2593,103
20694,5,121,2000,2912,1516,1396
20695,5,19,2000,7437,3823,3614
20696,5,7,2000,243,112,131
20697,5,124,2000,362,221,141
20698,5,8,2000,664187,355275,308912
20699,5,162,2000,790,383,407
20700,5,9,2000,1353231,650498,702733
20701,5,61,2000,191,102,89
20702,5,23,2000,5476,2590,2886
20703,5,10,2000,189850,94651,95199
20704,5,26,2000,129,68,61
20705,5,36,2000,1649,852,797
20706,5,130,2000,872,446,426
20707,5,27,2000,14662,7249,7413
20708,5,50,2000,5952,3119,2833
20709,5,1,2000,692,385,307
20710,5,132,2000,831,426,405
20711,6,2,2000,2232283,999992,1232291
20712,6,11,2000,1287,630,657
20713,6,12,2000,3046,1414,1632
20714,6,16,2000,204812,95121,109691
20715,6,9,2000,15251,6432,8819
20716,6,26,2000,1110,507,603
20717,6,170,2000,944,422,522
20718,16,2,2000,269,201,68
20719,16,119,2000,694,358,336
20720,16,5,2000,200,125,75
20721,16,6,2000,42602,22823,19779
20722,16,18,2000,8905,4262,4643
20723,16,19,2000,345,179,166
20724,16,20,2000,1311,878,433
20725,16,161,2000,172,71,101
20726,16,144,2000,504,306,198
20727,16,9,2000,587,250,337
20728,16,36,2000,235,118,117
20729,16,23,2000,580,266,314
20730,16,128,2000,357,161,196
20731,16,129,2000,254,54,200
20732,16,145,2000,3267,698,2569
20733,16,25,2000,5338,3179,2159
20734,16,27,2000,248,93,155
20735,16,146,2000,269,63,206
20736,16,26,2000,13885,5684,8201
20737,16,142,2000,12375,3790,8585
20738,16,28,2000,1724,573,1151
20739,44,2,2000,173,33,140
20740,44,51,2000,346,142,204
20741,44,141,2000,686,196,490
20742,44,52,2000,3,3,0
20743,44,134,2000,559,277,282
20744,44,75,2000,2,1,1
20745,44,76,2000,3,1,2
20746,44,103,2000,382,199,183
20747,44,11,2000,62,30,32
20748,44,77,2000,8,4,4
20749,44,66,2000,397,202,195
20750,44,12,2000,59,27,32
20751,44,78,2000,31,15,16
20752,44,13,2000,96,49,47
20753,44,3,2000,1264,641,623
20754,44,79,2000,23,12,11
20755,44,29,2000,712,398,314
20756,44,67,2000,822,420,402
20757,44,95,2000,3,3,0
20758,44,151,2000,39,24,15
20759,44,4,2000,8,3,5
20760,44,53,2000,748,389,359
20761,44,147,2000,93,42,51
20762,44,105,2000,3040,1544,1496
20763,44,30,2000,1081,574,507
20764,44,152,2000,11,3,8
20765,44,116,2000,56,27,29
20766,44,153,2000,5,1,4
20767,44,135,2000,405,232,173
20768,44,80,2000,29,16,13
20769,44,136,2000,12,4,8
20770,44,106,2000,164,96,68
20771,44,172,2000,7229,3667,3562
20772,44,173,2000,1108,565,543
20773,44,137,2000,1312,667,645
20774,44,96,2000,12,7,5
20775,44,54,2000,589,283,306
20776,44,81,2000,96,52,44
20777,44,14,2000,158,78,80
20778,44,31,2000,3400,1727,1673
20779,44,176,2000,153,90,63
20780,44,137,2000,60,33,27
20781,44,39,2000,522,235,287
20782,44,118,2000,2,1,1
20783,44,82,2000,2,1,1
20784,44,83,2000,12,4,8
20785,44,108,2000,46,31,15
20786,44,142,2000,621,196,425
20787,44,97,2000,31,18,13
20788,44,119,2000,45,16,29
20789,44,40,2000,1529,779,750
20790,44,148,2000,25,15,10
20791,44,120,2000,179,97,82
20792,44,41,2000,5,3,2
20793,44,42,2000,603,305,298
20794,44,68,2000,5996,3650,2346
20795,44,139,2000,6,3,3
20796,44,155,2000,66,31,35
20797,44,15,2000,298,133,165
20798,44,69,2000,7601,3830,3771
20799,44,156,2000,587,320,267
20800,44,55,2000,45,22,23
20801,44,56,2000,304,120,184
20802,44,84,2000,17,7,10
20803,44,98,2000,145,76,69
20804,44,157,2000,59,25,34
20805,44,158,2000,2,1,1
20806,44,110,2000,34,21,13
20807,44,85,2000,6,3,3
20808,44,99,2000,14,9,5
20809,44,32,2000,2144,1088,1056
20810,44,43,2000,45,22,23
20811,44,5,2000,6019,3052,2967
20812,44,6,2000,519,175,344
20813,44,16,2000,528,202,326
20814,44,17,2000,255,117,138
20815,44,57,2000,3745,1508,2237
20816,44,86,2000,139,94,45
20817,44,177,2000,616,408,208
20818,44,18,2000,131,57,74
20819,44,167,2000,301,163,138
20820,44,121,2000,562,323,239
20821,44,19,2000,235,94,141
20822,44,168,2000,37,21,16
20823,44,46,2000,9021,4573,4448
20824,44,20,2000,154,66,88
20825,44,149,2000,45,25,20
20826,44,159,2000,125,54,71
20827,44,143,2000,511,217,294
20828,44,70,2000,3,1,2
20829,44,47,2000,15984,8106,7878
20830,44,71,2000,73,42,31
20831,44,122,2000,14,9,5
20832,44,123,2000,88,42,46
20833,44,7,2000,3,3,0
20834,44,160,2000,34,18,16
20835,44,58,2000,184,96,88
20836,44,161,2000,9,4,5
20837,44,124,2000,451,194,257
20838,44,100,2000,355,245,110
20839,44,72,2000,8,3,5
20840,44,87,2000,2,1,1
20841,44,144,2000,318,97,221
20842,44,125,2000,46,22,24
20843,44,150,2000,43,27,16
20844,44,8,2000,159,51,108
20845,44,73,2000,2765,1332,1433
20846,44,101,2000,19,10,9
20847,44,162,2000,10745,5458,5287
20848,44,60,2000,763,323,440
20849,44,48,2000,355,187,168
20850,44,21,2000,57,28,29
20851,44,9,2000,3770,1910,1860
20852,44,102,2000,19,12,7
20853,44,111,2000,31,21,10
20854,44,112,2000,147,97,50
20855,44,33,2000,40650,20626,20024
20856,44,61,2000,979,496,483
20857,44,22,2000,40,19,21
20858,44,35,2000,5520,2809,2711
20859,44,36,2000,2943,1499,1444
20860,44,126,2000,93,55,38
20861,44,90,2000,3,1,2
20862,44,91,2000,8,3,5
20863,44,92,2000,3,1,2
20864,44,23,2000,501,244,257
20865,44,164,2000,26,13,13
20866,44,127,2000,12,7,5
20867,44,165,2000,229,93,136
20868,44,37,2000,5284,2679,2605
20869,44,64,2000,87,46,41
20870,44,128,2000,618,290,328
20871,44,115,2000,4979,2522,2457
20872,44,65,2000,4000,2026,1974
20873,44,10,2000,278,115,163
20874,44,145,2000,687,247,440
20875,44,113,2000,14,9,5
20876,44,49,2000,1168,593,575
20877,44,74,2000,644,386,258
20878,44,25,2000,133,42,91
20879,44,169,2000,25,15,10
20880,44,166,2000,133,54,79
20881,44,93,2000,131,82,49
20882,44,146,2000,116,22,94
20883,44,26,2000,570,136,434
20884,44,170,2000,6,3,3
20885,44,94,2000,2,0,2
20886,44,130,2000,175,96,79
20887,44,38,2000,2189,1117,1072
20888,44,27,2000,235,114,121
20889,44,50,2000,131924,66837,65087
20890,44,131,2000,147,82,65
20891,44,114,2000,65,36,29
20892,44,171,2000,108,61,47
20893,44,1,2000,740,460,280
20894,44,28,2000,36,15,21
20895,44,132,2000,396,209,187
20896,44,133,2000,1480,750,730
20897,45,44,2000,1771,1031,740
20898,45,115,2000,387,203,184
20899,45,50,2000,34442,17778,16664
20900,17,2,2000,2790,1485,1305
20901,17,141,2000,30056,16176,13880
20902,17,12,2000,14990,7956,7034
20903,17,103,2000,31828,16754,15074
20904,17,66,2000,6206,3344,2862
20905,17,67,2000,4690,2610,2080
20906,17,105,2000,7274,4132,3142
20907,17,30,2000,19308,10663,8645
20908,17,29,2000,31040,16895,14145
20909,17,106,2000,3024,1628,1396
20910,17,172,2000,921,510,411
20911,17,107,2000,1800,1055,745
20912,17,39,2000,1411,908,503
20913,17,120,2000,57163,28685,28478
20914,17,42,2000,474,347,127
20915,17,68,2000,27534,15004,12530
20916,17,15,2000,21123,11006,10117
20917,17,69,2000,26847,15177,11670
20918,17,56,2000,2030,1107,923
20919,17,32,2000,15268,8297,6971
20920,17,5,2000,18502,9669,8833
20921,17,6,2000,51786,26598,25188
20922,17,16,2000,75702,38983,36719
20923,17,57,2000,5066,2755,2311
20924,17,167,2000,9275,5082,4193
20925,17,168,2000,1657,926,731
20926,17,20,2000,4960,2940,2020
20927,17,46,2000,7916,4372,3544
20928,17,143,2000,19423,10320,9103
20929,17,47,2000,10706,5923,4783
20930,17,100,2000,1923,1018,905
20931,17,144,2000,166953,87323,79630
20932,17,73,2000,4832,2793,2039
20933,17,112,2000,1336,750,586
20934,17,33,2000,86990,47961,39029
20935,17,35,2000,125991,69858,56133
20936,17,36,2000,162154,90208,71946
20937,17,115,2000,10107,5385,4722
20938,17,65,2000,2829,1612,1217
20939,17,49,2000,1056,630,426
20940,17,74,2000,3228,1882,1346
20941,17,25,2000,10960,5887,5073
20942,17,169,2000,3754,1921,1833
20943,17,146,2000,36146,19183,16963
20944,17,26,2000,31716,16535,15181
20945,17,170,2000,1187,631,556
20946,17,38,2000,164271,90449,73822
20947,17,142,2000,22599,11925,10674
20948,17,50,2000,18218,9782,8436
20949,17,114,2000,5280,2824,2456
20950,17,171,2000,29428,15438,13990
20951,17,28,2000,36041,19439,16602
20952,57,2,2000,201,37,164
20953,57,51,2000,274408,128232,146176
20954,57,141,2000,15810,4635,11175
20955,57,52,2000,19,12,7
20956,57,134,2000,1744,886,858
20957,57,76,2000,11,10,1
20958,57,103,2000,20245,12443,7802
20959,57,11,2000,279,175,104
20960,57,66,2000,10099,7860,2239
20961,57,12,2000,98,59,39
20962,57,78,2000,27,19,8
20963,57,13,2000,3,3,0
20964,57,3,2000,23300,7784,15516
20965,57,79,2000,22,10,12
20966,57,29,2000,1674,1495,179
20967,57,67,2000,9092,6177,2915
20968,57,95,2000,16,7,9
20969,57,151,2000,1205,537,668
20970,57,4,2000,36,12,24
20971,57,53,2000,26839,13227,13612
20972,57,147,2000,10,5,5
20973,57,105,2000,28883,23121,5762
20974,57,30,2000,10400,6640,3760
20975,57,152,2000,4866,1968,2898
20976,57,116,2000,553,368,185
20977,57,153,2000,5037,4038,999
20978,57,135,2000,3468,1713,1755
20979,57,136,2000,124,68,56
20980,57,106,2000,5164,3327,1837
20981,57,172,2000,74865,38894,35971
20982,57,107,2000,14993,11556,3437
20983,57,117,2000,11,8,3
20984,57,137,2000,3287,1657,1630
20985,57,96,2000,509,400,109
20986,57,54,2000,29115,16635,12480
20987,57,81,2000,11659,10341,1318
20988,57,14,2000,195,110,85
20989,57,31,2000,5675,5242,433
20990,57,176,2000,40,29,11
20991,57,137,2000,2031,1090,941
20992,57,39,2000,2610,1898,712
20993,57,118,2000,22,12,10
20994,57,82,2000,44,29,15
20995,57,83,2000,17793,14361,3432
20996,57,108,2000,21748,14695,7053
20997,57,142,2000,43336,15508,27828
20998,57,97,2000,5302,3833,1469
20999,57,138,2000,60,22,38
21000,57,119,2000,7417,5559,1858
21001,57,40,2000,392,364,28
21002,57,148,2000,8,7,1
21003,57,120,2000,5569,3974,1595
21004,57,42,2000,2210,1969,241
21005,57,68,2000,46478,33231,13247
21006,57,139,2000,136,66,70
21007,57,155,2000,641,202,439
21008,57,15,2000,317,212,105
21009,57,69,2000,55640,38463,17177
21010,57,156,2000,34369,15463,18906
21011,57,56,2000,10037,5101,4936
21012,57,84,2000,8,5,3
21013,57,98,2000,598,478,120
21014,57,157,2000,1276,471,805
21015,57,158,2000,268,112,156
21016,57,110,2000,32,31,1
21017,57,85,2000,228,173,55
21018,57,99,2000,560,452,108
21019,57,32,2000,5052,4472,580
21020,57,43,2000,227,166,61
21021,57,5,2000,43109,19677,23432
21022,57,6,2000,8971,3823,5148
21023,57,16,2000,1498,471,1027
21024,57,44,2000,2307,1529,778
21025,57,17,2000,2553,1108,1445
21026,57,86,2000,173,120,53
21027,57,177,2000,7130,4981,2149
21028,57,18,2000,2973,963,2010
21029,57,167,2000,542,500,42
21030,57,121,2000,1050,703,347
21031,57,19,2000,106,39,67
21032,57,168,2000,79,68,11
21033,57,46,2000,636,607,29
21034,57,20,2000,4149,1656,2493
21035,57,149,2000,6,2,4
21036,57,159,2000,212,107,105
21037,57,143,2000,3371,1908,1463
21038,57,70,2000,38,24,14
21039,57,47,2000,580,534,46
21040,57,71,2000,628,395,233
21041,57,122,2000,1097,913,184
21042,57,123,2000,49,31,18
21043,57,7,2000,11,3,8
21044,57,160,2000,501,237,264
21045,57,58,2000,1137,964,173
21046,57,161,2000,385,124,261
21047,57,124,2000,10538,6133,4405
21048,57,100,2000,4023,3150,873
21049,57,72,2000,203,136,67
21050,57,59,2000,6055,2910,3145
21051,57,144,2000,285569,121332,164237
21052,57,125,2000,314,234,80
21053,57,150,2000,35,30,5
21054,57,8,2000,195,90,105
21055,57,73,2000,9831,6531,3300
21056,57,101,2000,436,307,129
21057,57,162,2000,26781,16918,9863
21058,57,60,2000,44512,18698,25814
21059,57,48,2000,975,737,238
21060,57,21,2000,40,25,15
21061,57,9,2000,24765,8043,16722
21062,57,102,2000,580,476,104
21063,57,111,2000,577,480,97
21064,57,112,2000,46699,31316,15383
21065,57,33,2000,43160,33574,9586
21066,57,61,2000,5245,3706,1539
21067,57,22,2000,2,0,2
21068,57,35,2000,118736,67922,50814
21069,57,36,2000,14816,12926,1890
21070,57,126,2000,631,358,273
21071,57,90,2000,9,8,1
21072,57,91,2000,11,8,3
21073,57,92,2000,6,3,3
21074,57,62,2000,3105,1618,1487
21075,57,140,2000,43,34,9
21076,57,23,2000,92,46,46
21077,57,164,2000,49429,8179,41250
21078,57,63,2000,78207,39117,39090
21079,57,127,2000,859,707,152
21080,57,165,2000,818,430,388
21081,57,37,2000,3273,2725,548
21082,57,64,2000,4828,3186,1642
21083,57,128,2000,6842,4554,2288
21084,57,115,2000,1238,834,404
21085,57,129,2000,0,0,0
21086,57,65,2000,19545,16276,3269
21087,57,10,2000,41977,20401,21576
21088,57,145,2000,813,268,545
21089,57,113,2000,21,15,6
21090,57,49,2000,4038,3015,1023
21091,57,74,2000,22130,14607,7523
21092,57,25,2000,3399,1383,2016
21093,57,169,2000,30,17,13
21094,57,166,2000,1395,676,719
21095,57,93,2000,82,66,16
21096,57,146,2000,75563,28327,47236
21097,57,26,2000,9618,4484,5134
21098,57,170,2000,44,42,2
21099,57,130,2000,363,224,139
21100,57,38,2000,13711,11536,2175
21101,57,27,2000,19,12,7
21102,57,50,2000,31644,20601,11043
21103,57,131,2000,786,498,288
21104,57,114,2000,2596,1686,910
21105,57,171,2000,1161,1086,75
21106,57,1,2000,2017,1203,814
21107,57,28,2000,227,119,108
21108,57,132,2000,159,90,69
21109,57,133,2000,151,108,43
21110,86,76,2000,165,85,80
21111,86,78,2000,713,365,348
21112,86,79,2000,575,294,281
21113,86,95,2000,7,4,3
21114,86,96,2000,106,61,45
21115,86,81,2000,1928,981,947
21116,86,82,2000,148,76,72
21117,86,97,2000,143,82,61
21118,86,84,2000,222,114,108
21119,86,98,2000,326,185,141
21120,86,99,2000,173,99,74
21121,86,5,2000,1213,459,754
21122,86,101,2000,134,76,58
21123,86,102,2000,80,45,35
21124,86,90,2000,103,53,50
21125,86,91,2000,353,180,173
21126,86,92,2000,242,124,118
21127,86,93,2000,2476,1269,1207
21128,86,50,2000,5103,2642,2461
21129,177,103,2000,3072,1653,1419
21130,177,66,2000,476,256,220
21131,177,3,2000,7177,3861,3316
21132,177,67,2000,525,282,243
21133,177,105,2000,254413,136880,117533
21134,177,172,2000,335600,180561,155039
21135,177,39,2000,542,292,250
21136,177,142,2000,1103,593,510
21137,177,42,2000,613,330,283
21138,177,68,2000,5371,2890,2481
21139,177,69,2000,4295,2311,1984
21140,177,156,2000,1657,891,766
21141,177,5,2000,10065,5415,4650
21142,177,6,2000,6167,3318,2849
21143,177,44,2000,974,524,450
21144,177,57,2000,1579,850,729
21145,177,100,2000,1740,936,804
21146,177,73,2000,904,486,418
21147,177,162,2000,1741,937,804
21148,177,48,2000,380,204,176
21149,177,9,2000,7499,4035,3464
21150,177,112,2000,46174,24843,21331
21151,177,33,2000,742,399,343
21152,177,61,2000,370,199,171
21153,177,36,2000,4893,2632,2261
21154,177,65,2000,1338,720,618
21155,177,10,2000,5655,3042,2613
21156,177,49,2000,1158,623,535
21157,177,74,2000,907,488,419
21158,177,50,2000,16526,8891,7635
21159,177,1,2000,16909,9097,7812
21160,18,2,2000,76,30,46
21161,18,141,2000,417,248,169
21162,18,66,2000,141,61,80
21163,18,13,2000,515,204,311
21164,18,3,2000,8402,2388,6014
21165,18,11,2000,32,22,10
21166,18,67,2000,88,47,41
21167,18,53,2000,74,40,34
21168,18,105,2000,129,67,62
21169,18,30,2000,62,36,26
21170,18,10,2000,15147,13712,1435
21171,18,136,2000,32,8,24
21172,18,172,2000,11240,10008,1232
21173,18,107,2000,30,18,12
21174,18,54,2000,31,23,8
21175,18,14,2000,160,85,75
21176,18,31,2000,29,18,11
21177,18,39,2000,62,28,34
21178,18,120,2000,93,86,7
21179,18,119,2000,91,40,51
21180,18,68,2000,480,235,245
21181,18,69,2000,869,412,457
21182,18,156,2000,34,11,23
21183,18,56,2000,75,49,26
21184,18,173,2000,47,19,28
21185,18,32,2000,712,407,305
21186,18,5,2000,4273,547,3726
21187,18,6,2000,115,57,58
21188,18,16,2000,55884,22236,33648
21189,18,44,2000,64,37,27
21190,18,17,2000,1906,636,1270
21191,18,57,2000,375,198,177
21192,18,177,2000,126,44,82
21193,18,167,2000,25,17,8
21194,18,176,2000,102,30,72
21195,18,19,2000,912,265,647
21196,18,20,2000,2230,1240,990
21197,18,143,2000,1182,501,681
21198,18,161,2000,83,19,64
21199,18,144,2000,726,567,159
21200,18,21,2000,772,402,370
21201,18,8,2000,220,93,127
21202,18,73,2000,243,123,120
21203,18,162,2000,32,11,21
21204,18,48,2000,53,28,25
21205,18,9,2000,3949,1621,2328
21206,18,33,2000,100,61,39
21207,18,22,2000,272,73,199
21208,18,35,2000,330,262,68
21209,18,36,2000,724,537,187
21210,18,23,2000,6108,2001,4107
21211,18,63,2000,72,59,13
21212,18,37,2000,28,19,9
21213,18,128,2000,92,38,54
21214,18,115,2000,72,23,49
21215,18,65,2000,370,220,150
21216,18,129,2000,336,119,217
21217,18,145,2000,2727,966,1761
21218,18,49,2000,109,63,46
21219,18,74,2000,243,121,122
21220,18,25,2000,57624,25346,32278
21221,18,27,2000,254,107,147
21222,18,146,2000,316,155,161
21223,18,26,2000,1245,314,931
21224,18,38,2000,480,413,67
21225,18,60,2000,107,78,29
21226,18,142,2000,287377,83332,204045
21227,18,50,2000,981,424,557
21228,18,28,2000,2889,962,1927
21229,167,12,2000,35532,16633,18899
21230,167,11,2000,6716,2932,3784
21231,167,29,2000,50780,26988,23792
21232,167,172,2000,1588,733,855
21233,167,40,2000,817,458,359
21234,167,15,2000,2405,962,1443
21235,167,176,2000,45244,23414,21830
21236,167,168,2000,4946,2749,2197
21237,167,46,2000,817,412,405
21238,167,47,2000,3222,1558,1664
21239,167,36,2000,2032883,1113836,919047
21240,167,169,2000,11617,5590,6027
21241,167,26,2000,34443,17182,17261
21242,167,170,2000,771,321,450
21243,167,38,2000,248273,133932,114341
21244,167,171,2000,168223,84354,83869
21245,121,116,2000,198,99,99
21246,121,137,2000,672,337,335
21247,121,120,2000,20846,9447,11399
21248,121,119,2000,961,482,479
21249,121,125,2000,535,267,268
21250,121,150,2000,61,30,31
21251,121,126,2000,3273,1643,1630
21252,121,128,2000,159197,76974,82223
21253,121,115,2000,101,51,50
21254,121,129,2000,81156,39262,41894
21255,121,145,2000,56360,28299,28061
21256,121,130,2000,261491,136880,124611
21257,121,131,2000,51289,25615,25674
21258,19,2,2000,1219,396,823
21259,19,13,2000,363,266,97
21260,19,3,2000,136047,26035,110012
21261,19,10,2000,20680,11809,8871
21262,19,136,2000,795,257,538
21263,19,120,2000,2026,657,1369
21264,19,119,2000,2877,934,1943
21265,19,68,2000,853,404,449
21266,19,5,2000,418664,120343,298321
21267,19,18,2000,21710,8681,13029
21268,19,20,2000,4125,1339,2786
21269,19,144,2000,1457,473,984
21270,19,8,2000,1294,420,874
21271,19,73,2000,662,328,334
21272,19,162,2000,1060,344,716
21273,19,9,2000,139783,38581,101202
21274,19,22,2000,96,77,19
21275,19,23,2000,733,285,448
21276,19,128,2000,1929,626,1303
21277,19,129,2000,0,0,0
21278,19,145,2000,28031,11053,16978
21279,19,25,2000,10073,3270,6803
21280,19,27,2000,9199,5407,3792
21281,19,146,2000,878,285,593
21282,19,26,2000,7319,2376,4943
21283,19,142,2000,119693,44058,75635
21284,19,50,2000,6491,2682,3809
21285,19,28,2000,33307,10814,22493
21286,168,12,2000,8631,4178,4453
21287,168,11,2000,4449,2130,2319
21288,168,29,2000,18775,11564,7211
21289,168,172,2000,438,215,223
21290,168,40,2000,1033,597,436
21291,168,42,2000,237,97,140
21292,168,15,2000,6156,3135,3021
21293,168,69,2000,5589,3202,2387
21294,168,167,2000,24298,14610,9688
21295,168,176,2000,1280,710,570
21296,168,46,2000,1658,949,709
21297,168,47,2000,4686,2695,1991
21298,168,33,2000,5368,3281,2087
21299,168,35,2000,701,377,324
21300,168,36,2000,212391,125361,87030
21301,168,1,2000,178,63,115
21302,168,169,2000,9937,5026,4911
21303,168,26,2000,993,519,474
21304,168,170,2000,1846,1048,798
21305,168,38,2000,51798,30902,20896
21306,168,171,2000,14993,8276,6717
21307,46,2,2000,24,2,22
21308,46,51,2000,8,4,4
21309,46,141,2000,12,2,10
21310,46,52,2000,0,0,0
21311,46,134,2000,2,1,1
21312,46,75,2000,9,3,6
21313,46,76,2000,0,0,0
21314,46,103,2000,20,13,7
21315,46,11,2000,1073,404,669
21316,46,77,2000,1,0,1
21317,46,66,2000,104,48,56
21318,46,12,2000,3109,1241,1868
21319,46,13,2000,0,0,0
21320,46,3,2000,5,0,5
21321,46,79,2000,3,1,2
21322,46,29,2000,77583,48083,29500
21323,46,67,2000,28,11,17
21324,46,151,2000,0,0,0
21325,46,53,2000,3,0,3
21326,46,147,2000,0,0,0
21327,46,105,2000,17,9,8
21328,46,30,2000,50,19,31
21329,46,116,2000,1,0,1
21330,46,153,2000,1,0,1
21331,46,135,2000,1,0,1
21332,46,106,2000,2,0,2
21333,46,172,2000,326,151,175
21334,46,107,2000,4,4,0
21335,46,137,2000,2,0,2
21336,46,96,2000,0,0,0
21337,46,54,2000,8,1,7
21338,46,81,2000,70,25,45
21339,46,14,2000,3,2,1
21340,46,31,2000,176,115,61
21341,46,176,2000,14,5,9
21342,46,137,2000,0,0,0
21343,46,39,2000,151,32,119
21344,46,83,2000,0,0,0
21345,46,108,2000,0,0,0
21346,46,142,2000,11,1,10
21347,46,119,2000,0,0,0
21348,46,40,2000,4069,2195,1874
21349,46,41,2000,0,0,0
21350,46,42,2000,170,69,101
21351,46,68,2000,128,61,67
21352,46,139,2000,0,0,0
21353,46,155,2000,0,0,0
21354,46,15,2000,2039,886,1153
21355,46,69,2000,4256,1377,2879
21356,46,156,2000,0,0,0
21357,46,56,2000,12,5,7
21358,46,98,2000,0,0,0
21359,46,32,2000,285,149,136
21360,46,43,2000,9,2,7
21361,46,5,2000,74,18,56
21362,46,6,2000,30,8,22
21363,46,16,2000,5,2,3
21364,46,44,2000,28,19,9
21365,46,17,2000,43,15,28
21366,46,57,2000,57,21,36
21367,46,86,2000,0,0,0
21368,46,177,2000,9,5,4
21369,46,18,2000,7,1,6
21370,46,167,2000,8726,4647,4079
21371,46,121,2000,0,0,0
21372,46,19,2000,2,1,1
21373,46,168,2000,1233,679,554
21374,46,20,2000,40,4,36
21375,46,143,2000,3,2,1
21376,46,70,2000,0,0,0
21377,46,47,2000,27884,16255,11629
21378,46,71,2000,1,1,0
21379,46,122,2000,1,0,1
21380,46,123,2000,1,1,0
21381,46,160,2000,3,0,3
21382,46,58,2000,3,1,2
21383,46,161,2000,0,0,0
21384,46,124,2000,0,0,0
21385,46,100,2000,12,5,7
21386,46,72,2000,0,0,0
21387,46,59,2000,0,0,0
21388,46,144,2000,5,3,2
21389,46,125,2000,0,0,0
21390,46,150,2000,0,0,0
21391,46,8,2000,2,1,1
21392,46,73,2000,42,8,34
21393,46,101,2000,1,1,0
21394,46,162,2000,8,1,7
21395,46,60,2000,0,0,0
21396,46,48,2000,52,18,34
21397,46,9,2000,34,3,31
21398,46,111,2000,2,1,1
21399,46,112,2000,7,2,5
21400,46,33,2000,1526,947,579
21401,46,61,2000,2,0,2
21402,46,22,2000,0,0,0
21403,46,35,2000,69,31,38
21404,46,36,2000,234753,143385,91368
21405,46,126,2000,1,0,1
21406,46,23,2000,0,0,0
21407,46,63,2000,0,0,0
21408,46,165,2000,3,0,3
21409,46,37,2000,17,10,7
21410,46,64,2000,4,3,1
21411,46,128,2000,0,0,0
21412,46,115,2000,3,1,2
21413,46,129,2000,2,1,1
21414,46,65,2000,17,6,11
21415,46,10,2000,12,1,11
21416,46,145,2000,2,0,2
21417,46,49,2000,206,69,137
21418,46,74,2000,24,9,15
21419,46,25,2000,10,1,9
21420,46,169,2000,821,413,408
21421,46,166,2000,1,0,1
21422,46,93,2000,0,0,0
21423,46,146,2000,0,0,0
21424,46,26,2000,25,5,20
21425,46,170,2000,928,480,448
21426,46,130,2000,2,1,1
21427,46,38,2000,53157,27320,25837
21428,46,27,2000,2,0,2
21429,46,50,2000,218,66,152
21430,46,131,2000,0,0,0
21431,46,114,2000,5,3,2
21432,46,171,2000,2919,1587,1332
21433,46,1,2000,7,1,6
21434,46,28,2000,1,0,1
21435,46,132,2000,0,0,0
21436,46,133,2000,2,0,2
21437,20,13,2000,234,102,132
21438,20,3,2000,3814,1192,2622
21439,20,10,2000,6876,6845,31
21440,20,172,2000,5103,4996,107
21441,20,68,2000,218,117,101
21442,20,69,2000,395,206,189
21443,20,32,2000,323,203,120
21444,20,5,2000,1940,273,1667
21445,20,16,2000,25369,11100,14269
21446,20,17,2000,865,317,548
21447,20,18,2000,1012,619,393
21448,20,19,2000,414,132,282
21449,20,143,2000,536,250,286
21450,20,144,2000,330,283,47
21451,20,21,2000,351,201,150
21452,20,9,2000,1793,809,984
21453,20,36,2000,329,268,61
21454,20,23,2000,2773,999,1774
21455,20,129,2000,152,59,93
21456,20,145,2000,1238,483,755
21457,20,25,2000,26159,12652,13507
21458,20,26,2000,565,157,408
21459,20,38,2000,218,206,12
21460,20,142,2000,130459,41597,88862
21461,20,50,2000,445,212,233
21462,20,28,2000,1311,480,831
21463,149,147,2000,102,57,45
21464,149,172,2000,114,49,65
21465,149,156,2000,85,29,56
21466,149,5,2000,215,95,120
21467,149,123,2000,36,14,22
21468,149,125,2000,23,7,16
21469,149,150,2000,4,1,3
21470,149,9,2000,215,95,120
21471,149,115,2000,2441,1185,1256
21472,149,133,2000,66,32,34
21473,149,148,2000,36,19,17
21474,149,130,2000,130,58,72
21475,149,131,2000,81,41,40
21476,149,132,2000,66,32,34
21477,159,151,2000,61,26,35
21478,159,68,2000,284,141,143
21479,159,155,2000,630,275,355
21480,159,69,2000,890,453,437
21481,159,156,2000,9542,4381,5161
21482,159,157,2000,31145,13125,18020
21483,159,5,2000,742,283,459
21484,159,57,2000,242,99,143
21485,159,20,2000,4056,1862,2194
21486,159,160,2000,1889,659,1230
21487,159,73,2000,286,141,145
21488,159,162,2000,2294,917,1377
21489,159,158,2000,2171,1128,1043
21490,159,164,2000,233,78,155
21491,159,165,2000,71154,33513,37641
21492,159,65,2000,275,130,145
21493,159,49,2000,1075,536,539
21494,159,74,2000,142,66,76
21495,159,166,2000,240,104,136
21496,159,50,2000,1099,542,557
21497,159,152,2000,373,153,220
21498,143,2,2000,236,81,155
21499,143,51,2000,223,84,139
21500,143,141,2000,2642,1371,1271
21501,143,66,2000,554,312,242
21502,143,13,2000,712,207,505
21503,143,3,2000,919,53,866
21504,143,11,2000,188,84,104
21505,143,67,2000,496,242,254
21506,143,53,2000,243,91,152
21507,143,105,2000,188,91,97
21508,143,29,2000,560,270,290
21509,143,10,2000,270,126,144
21510,143,136,2000,631,197,434
21511,143,172,2000,2264,770,1494
21512,143,117,2000,3162,527,2635
21513,143,137,2000,297,91,206
21514,143,137,2000,320,89,231
21515,143,39,2000,567,220,347
21516,143,97,2000,520,222,298
21517,143,120,2000,1347,593,754
21518,143,119,2000,1459,562,897
21519,143,42,2000,611,273,338
21520,143,68,2000,3699,1560,2139
21521,143,118,2000,1047,338,709
21522,143,69,2000,5172,2549,2623
21523,143,156,2000,452,109,343
21524,143,56,2000,1925,948,977
21525,143,32,2000,249,139,110
21526,143,5,2000,3564,976,2588
21527,143,6,2000,303,94,209
21528,143,16,2000,50384,19558,30826
21529,143,57,2000,4923,2251,2672
21530,143,177,2000,740,322,418
21531,143,167,2000,591,139,452
21532,143,18,2000,15015,5265,9750
21533,143,121,2000,246,101,145
21534,143,19,2000,7947,2042,5905
21535,143,20,2000,8143,3700,4443
21536,143,160,2000,249,71,178
21537,143,161,2000,264,69,195
21538,143,72,2000,202,79,123
21539,143,144,2000,3605,2161,1444
21540,143,21,2000,1247,307,940
21541,143,73,2000,1304,678,626
21542,143,162,2000,2098,582,1516
21543,143,48,2000,246,114,132
21544,143,9,2000,1810,552,1258
21545,143,33,2000,499,320,179
21546,143,158,2000,230,3,227
21547,143,22,2000,1040,282,758
21548,143,35,2000,438,277,161
21549,143,36,2000,5331,2317,3014
21550,143,23,2000,26101,7470,18631
21551,143,164,2000,824,131,693
21552,143,165,2000,175,69,106
21553,143,128,2000,76918,25699,51219
21554,143,115,2000,476,169,307
21555,143,65,2000,534,247,287
21556,143,129,2000,1307,457,850
21557,143,145,2000,10616,3710,6906
21558,143,49,2000,551,217,334
21559,143,74,2000,686,351,335
21560,143,25,2000,20428,7175,13253
21561,143,169,2000,499,131,368
21562,143,27,2000,2044,750,1294
21563,143,146,2000,2270,1037,1233
21564,143,26,2000,1865,567,1298
21565,143,170,2000,175,48,127
21566,143,38,2000,644,369,275
21567,143,142,2000,15455,5436,10019
21568,143,50,2000,5321,2300,3021
21569,143,131,2000,196,60,136
21570,143,171,2000,277,43,234
21571,143,28,2000,15734,4907,10827
21572,70,2,2000,0,0,0
21573,70,51,2000,0,0,0
21574,70,141,2000,0,0,0
21575,70,52,2000,0,0,0
21576,70,134,2000,0,0,0
21577,70,103,2000,0,0,0
21578,70,11,2000,0,0,0
21579,70,66,2000,2608,1461,1147
21580,70,12,2000,0,0,0
21581,70,78,2000,0,0,0
21582,70,3,2000,0,0,0
21583,70,29,2000,0,0,0
21584,70,67,2000,22,9,13
21585,70,53,2000,419,231,188
21586,70,105,2000,65,45,20
21587,70,30,2000,24,0,24
21588,70,152,2000,0,0,0
21589,70,135,2000,0,0,0
21590,70,106,2000,0,0,0
21591,70,172,2000,52,25,27
21592,70,107,2000,1,0,1
21593,70,96,2000,0,0,0
21594,70,54,2000,157,89,68
21595,70,81,2000,0,0,0
21596,70,31,2000,13,0,13
21597,70,137,2000,0,0,0
21598,70,39,2000,22,4,18
21599,70,83,2000,2,1,1
21600,70,108,2000,0,0,0
21601,70,142,2000,0,0,0
21602,70,97,2000,0,0,0
21603,70,119,2000,0,0,0
21604,70,40,2000,17,0,17
21605,70,120,2000,0,0,0
21606,70,42,2000,1,0,1
21607,70,68,2000,73,37,36
21608,70,155,2000,0,0,0
21609,70,15,2000,0,0,0
21610,70,69,2000,1489,745,744
21611,70,56,2000,102,54,48
21612,70,98,2000,0,0,0
21613,70,157,2000,0,0,0
21614,70,85,2000,0,0,0
21615,70,99,2000,0,0,0
21616,70,32,2000,9,0,9
21617,70,43,2000,1,1,0
21618,70,5,2000,0,0,0
21619,70,6,2000,0,0,0
21620,70,16,2000,0,0,0
21621,70,44,2000,9,4,5
21622,70,17,2000,0,0,0
21623,70,57,2000,1471,600,871
21624,70,86,2000,0,0,0
21625,70,177,2000,0,0,0
21626,70,18,2000,0,0,0
21627,70,167,2000,0,0,0
21628,70,121,2000,0,0,0
21629,70,19,2000,0,0,0
21630,70,168,2000,0,0,0
21631,70,46,2000,0,0,0
21632,70,143,2000,0,0,0
21633,70,47,2000,0,0,0
21634,70,71,2000,6,2,4
21635,70,122,2000,0,0,0
21636,70,7,2000,0,0,0
21637,70,58,2000,0,0,0
21638,70,124,2000,0,0,0
21639,70,100,2000,0,0,0
21640,70,72,2000,0,0,0
21641,70,59,2000,110,0,110
21642,70,144,2000,0,0,0
21643,70,125,2000,0,0,0
21644,70,8,2000,0,0,0
21645,70,73,2000,62,31,31
21646,70,101,2000,0,0,0
21647,70,162,2000,0,0,0
21648,70,60,2000,614,287,327
21649,70,48,2000,13,7,6
21650,70,9,2000,0,0,0
21651,70,102,2000,0,0,0
21652,70,111,2000,0,0,0
21653,70,112,2000,0,0,0
21654,70,33,2000,15,0,15
21655,70,61,2000,640,325,315
21656,70,35,2000,8,7,1
21657,70,36,2000,20,16,4
21658,70,91,2000,0,0,0
21659,70,164,2000,0,0,0
21660,70,63,2000,536,0,536
21661,70,127,2000,0,0,0
21662,70,37,2000,24,16,8
21663,70,64,2000,73,50,23
21664,70,128,2000,0,0,0
21665,70,115,2000,1,0,1
21666,70,65,2000,585,286,299
21667,70,10,2000,0,0,0
21668,70,49,2000,24,13,11
21669,70,74,2000,4823,2458,2365
21670,70,25,2000,0,0,0
21671,70,93,2000,0,0,0
21672,70,146,2000,0,0,0
21673,70,26,2000,1158,581,577
21674,70,130,2000,0,0,0
21675,70,38,2000,9,8,1
21676,70,27,2000,0,0,0
21677,70,50,2000,47,15,32
21678,70,131,2000,0,0,0
21679,70,114,2000,0,0,0
21680,70,171,2000,0,0,0
21681,70,1,2000,0,0,0
21682,70,132,2000,0,0,0
21683,70,133,2000,0,0,0
21684,47,2,2000,35,12,23
21685,47,51,2000,0,0,0
21686,47,141,2000,0,0,0
21687,47,134,2000,0,0,0
21688,47,103,2000,72,33,39
21689,47,11,2000,681,211,470
21690,47,77,2000,0,0,0
21691,47,66,2000,41,21,20
21692,47,12,2000,1340,418,922
21693,47,78,2000,0,0,0
21694,47,13,2000,0,0,0
21695,47,3,2000,0,0,0
21696,47,29,2000,56088,31736,24352
21697,47,67,2000,26,7,19
21698,47,95,2000,0,0,0
21699,47,151,2000,0,0,0
21700,47,53,2000,0,0,0
21701,47,105,2000,65,35,30
21702,47,30,2000,28,4,24
21703,47,135,2000,0,0,0
21704,47,106,2000,0,0,0
21705,47,172,2000,137,56,81
21706,47,107,2000,0,0,0
21707,47,137,2000,0,0,0
21708,47,54,2000,0,0,0
21709,47,81,2000,0,0,0
21710,47,14,2000,3,3,0
21711,47,31,2000,57,29,28
21712,47,176,2000,0,0,0
21713,47,137,2000,0,0,0
21714,47,39,2000,87,24,63
21715,47,82,2000,0,0,0
21716,47,108,2000,0,0,0
21717,47,142,2000,3,0,3
21718,47,119,2000,0,0,0
21719,47,40,2000,1107,532,575
21720,47,120,2000,0,0,0
21721,47,42,2000,65,26,39
21722,47,68,2000,188,104,84
21723,47,155,2000,0,0,0
21724,47,15,2000,896,361,535
21725,47,69,2000,1605,749,856
21726,47,156,2000,0,0,0
21727,47,56,2000,9,3,6
21728,47,157,2000,0,0,0
21729,47,110,2000,0,0,0
21730,47,99,2000,0,0,0
21731,47,32,2000,115,55,60
21732,47,43,2000,6,3,3
21733,47,5,2000,0,0,0
21734,47,6,2000,21,4,17
21735,47,16,2000,0,0,0
21736,47,44,2000,16,8,8
21737,47,17,2000,26,9,17
21738,47,57,2000,35,14,21
21739,47,86,2000,0,0,0
21740,47,177,2000,11,6,5
21741,47,18,2000,0,0,0
21742,47,167,2000,6544,3256,3288
21743,47,121,2000,0,0,0
21744,47,19,2000,0,0,0
21745,47,168,2000,606,306,300
21746,47,46,2000,8333,4274,4059
21747,47,20,2000,104,9,95
21748,47,159,2000,0,0,0
21749,47,143,2000,0,0,0
21750,47,71,2000,0,0,0
21751,47,122,2000,0,0,0
21752,47,123,2000,0,0,0
21753,47,7,2000,0,0,0
21754,47,160,2000,0,0,0
21755,47,58,2000,0,0,0
21756,47,161,2000,0,0,0
21757,47,124,2000,0,0,0
21758,47,100,2000,0,0,0
21759,47,72,2000,0,0,0
21760,47,144,2000,0,0,0
21761,47,125,2000,0,0,0
21762,47,150,2000,0,0,0
21763,47,8,2000,0,0,0
21764,47,73,2000,28,10,18
21765,47,101,2000,0,0,0
21766,47,162,2000,3,0,3
21767,47,60,2000,0,0,0
21768,47,48,2000,38,10,28
21769,47,21,2000,0,0,0
21770,47,9,2000,31,4,27
21771,47,111,2000,0,0,0
21772,47,112,2000,0,0,0
21773,47,33,2000,3830,2200,1630
21774,47,61,2000,3,0,3
21775,47,22,2000,0,0,0
21776,47,35,2000,31,14,17
21777,47,36,2000,95271,51140,44131
21778,47,126,2000,0,0,0
21779,47,23,2000,0,0,0
21780,47,63,2000,0,0,0
21781,47,37,2000,14,6,8
21782,47,64,2000,0,0,0
21783,47,128,2000,0,0,0
21784,47,115,2000,0,0,0
21785,47,65,2000,732,311,421
21786,47,10,2000,0,0,0
21787,47,145,2000,0,0,0
21788,47,113,2000,0,0,0
21789,47,49,2000,241,83,158
21790,47,74,2000,20,8,12
21791,47,25,2000,0,0,0
21792,47,169,2000,516,229,287
21793,47,166,2000,0,0,0
21794,47,146,2000,0,0,0
21795,47,26,2000,35,8,27
21796,47,170,2000,375,205,170
21797,47,130,2000,0,0,0
21798,47,38,2000,20051,9470,10581
21799,47,27,2000,14,5,9
21800,47,50,2000,246,126,120
21801,47,131,2000,0,0,0
21802,47,114,2000,19,12,7
21803,47,171,2000,1626,791,835
21804,47,1,2000,57,16,41
21805,47,132,2000,0,0,0
21806,47,133,2000,0,0,0
21807,71,2,2000,0,0,0
21808,71,51,2000,264,128,136
21809,71,141,2000,88,47,41
21810,71,52,2000,0,0,0
21811,71,134,2000,0,0,0
21812,71,76,2000,0,0,0
21813,71,103,2000,35,17,18
21814,71,11,2000,0,0,0
21815,71,77,2000,0,0,0
21816,71,66,2000,469,270,199
21817,71,12,2000,0,0,0
21818,71,78,2000,0,0,0
21819,71,13,2000,0,0,0
21820,71,3,2000,26,11,15
21821,71,79,2000,0,0,0
21822,71,29,2000,38,35,3
21823,71,67,2000,12679,6294,6385
21824,71,151,2000,0,0,0
21825,71,4,2000,0,0,0
21826,71,53,2000,2130,1059,1071
21827,71,147,2000,0,0,0
21828,71,105,2000,262,178,84
21829,71,30,2000,96,64,32
21830,71,152,2000,0,0,0
21831,71,116,2000,0,0,0
21832,71,153,2000,1422,785,637
21833,71,135,2000,53,33,20
21834,71,136,2000,0,0,0
21835,71,106,2000,51,24,27
21836,71,172,2000,927,477,450
21837,71,107,2000,23,16,7
21838,71,117,2000,0,0,0
21839,71,137,2000,0,0,0
21840,71,96,2000,0,0,0
21841,71,54,2000,365,178,187
21842,71,81,2000,20,13,7
21843,71,14,2000,2,1,1
21844,71,31,2000,83,56,27
21845,71,176,2000,0,0,0
21846,71,137,2000,85,46,39
21847,71,39,2000,1630,845,785
21848,71,118,2000,0,0,0
21849,71,82,2000,101,74,27
21850,71,83,2000,31,20,11
21851,71,108,2000,0,0,0
21852,71,142,2000,22,9,13
21853,71,97,2000,0,0,0
21854,71,138,2000,0,0,0
21855,71,119,2000,0,0,0
21856,71,40,2000,16,13,3
21857,71,148,2000,0,0,0
21858,71,120,2000,0,0,0
21859,71,42,2000,653,387,266
21860,71,68,2000,17116,9066,8050
21861,71,139,2000,0,0,0
21862,71,155,2000,0,0,0
21863,71,15,2000,0,0,0
21864,71,69,2000,8612,4722,3890
21865,71,156,2000,0,0,0
21866,71,55,2000,0,0,0
21867,71,56,2000,983,493,490
21868,71,84,2000,0,0,0
21869,71,98,2000,0,0,0
21870,71,157,2000,0,0,0
21871,71,158,2000,0,0,0
21872,71,110,2000,0,0,0
21873,71,85,2000,0,0,0
21874,71,99,2000,0,0,0
21875,71,32,2000,122,82,40
21876,71,43,2000,290,168,122
21877,71,5,2000,170,89,81
21878,71,6,2000,204,100,104
21879,71,16,2000,0,0,0
21880,71,44,2000,765,402,363
21881,71,17,2000,37,16,21
21882,71,57,2000,16274,7997,8277
21883,71,86,2000,0,0,0
21884,71,177,2000,249,139,110
21885,71,18,2000,0,0,0
21886,71,167,2000,0,0,0
21887,71,121,2000,0,0,0
21888,71,19,2000,0,0,0
21889,71,168,2000,0,0,0
21890,71,46,2000,7,6,1
21891,71,20,2000,30,19,11
21892,71,159,2000,0,0,0
21893,71,143,2000,0,0,0
21894,71,70,2000,0,0,0
21895,71,47,2000,12,8,4
21896,71,122,2000,0,0,0
21897,71,123,2000,0,0,0
21898,71,160,2000,0,0,0
21899,71,58,2000,12,5,7
21900,71,161,2000,0,0,0
21901,71,124,2000,46,32,14
21902,71,100,2000,24,18,6
21903,71,72,2000,0,0,0
21904,71,59,2000,5012,2271,2741
21905,71,144,2000,216,125,91
21906,71,125,2000,0,0,0
21907,71,150,2000,0,0,0
21908,71,8,2000,27,8,19
21909,71,73,2000,3163,1597,1566
21910,71,101,2000,0,0,0
21911,71,162,2000,0,0,0
21912,71,60,2000,304,140,164
21913,71,48,2000,154,73,81
21914,71,21,2000,0,0,0
21915,71,9,2000,0,0,0
21916,71,102,2000,0,0,0
21917,71,111,2000,0,0,0
21918,71,112,2000,87,55,32
21919,71,33,2000,570,353,217
21920,71,61,2000,50254,24395,25859
21921,71,22,2000,0,0,0
21922,71,35,2000,303,202,101
21923,71,36,2000,344,257,87
21924,71,126,2000,22,13,9
21925,71,92,2000,0,0,0
21926,71,62,2000,0,0,0
21927,71,140,2000,0,0,0
21928,71,23,2000,0,0,0
21929,71,164,2000,26,12,14
21930,71,63,2000,2507,1236,1271
21931,71,127,2000,0,0,0
21932,71,165,2000,0,0,0
21933,71,37,2000,63,35,28
21934,71,64,2000,49,24,25
21935,71,128,2000,0,0,0
21936,71,115,2000,41,20,21
21937,71,65,2000,2397,1243,1154
21938,71,10,2000,0,0,0
21939,71,145,2000,0,0,0
21940,71,113,2000,0,0,0
21941,71,49,2000,967,528,439
21942,71,74,2000,468,268,200
21943,71,25,2000,0,0,0
21944,71,169,2000,0,0,0
21945,71,166,2000,0,0,0
21946,71,93,2000,0,0,0
21947,71,146,2000,118,41,77
21948,71,26,2000,177,90,87
21949,71,170,2000,0,0,0
21950,71,130,2000,0,0,0
21951,71,38,2000,154,135,19
21952,71,27,2000,0,0,0
21953,71,50,2000,3760,1720,2040
21954,71,131,2000,0,0,0
21955,71,114,2000,0,0,0
21956,71,171,2000,0,0,0
21957,71,1,2000,63,44,19
21958,71,28,2000,0,0,0
21959,71,132,2000,0,0,0
21960,71,133,2000,0,0,0
21961,174,172,2000,204282,113647,90635
21962,174,173,2000,14240,6250,7990
21963,174,61,2000,1594,636,958
21964,122,172,2000,1458,638,820
21965,122,117,2000,8050,3510,4540
21966,122,68,2000,6567,2862,3705
21967,122,5,2000,1152,505,647
21968,123,116,2000,5677,2595,3082
21969,123,137,2000,1509,685,824
21970,123,137,2000,2389,1120,1269
21971,123,5,2000,2583,1186,1397
21972,123,125,2000,58576,27951,30625
21973,123,126,2000,4947,2330,2617
21974,123,128,2000,59,26,33
21975,123,115,2000,8837,4869,3968
21976,123,50,2000,1578,759,819
21977,123,131,2000,10278,5695,4583
21978,123,132,2000,45797,27033,18764
21979,123,133,2000,39732,22315,17417
21980,7,66,2000,21,10,11
21981,7,3,2000,5286,2372,2914
21982,7,10,2000,7720,3469,4251
21983,7,68,2000,86,39,47
21984,7,69,2000,162,73,89
21985,7,5,2000,11427,5140,6287
21986,7,57,2000,374,170,204
21987,7,177,2000,83,38,45
21988,7,20,2000,8,3,5
21989,7,9,2000,100,45,55
21990,7,49,2000,36,17,19
21991,7,74,2000,92,42,50
21992,7,142,2000,33,15,18
21993,7,50,2000,89,40,49
21994,160,2,2000,0,0,0
21995,160,51,2000,0,0,0
21996,160,141,2000,554,291,263
21997,160,52,2000,0,0,0
21998,160,134,2000,67,29,38
21999,160,135,2000,567,244,323
22000,160,136,2000,0,0,0
22001,160,106,2000,0,0,0
22002,160,172,2000,76,30,46
22003,160,137,2000,3856,1835,2021
22004,160,137,2000,0,0,0
22005,160,54,2000,0,0,0
22006,160,151,2000,520,216,304
22007,160,138,2000,0,0,0
22008,160,68,2000,2347,1130,1217
22009,160,139,2000,4279,1982,2297
22010,160,155,2000,570,260,310
22011,160,156,2000,2388,1083,1305
22012,160,84,2000,0,0,0
22013,160,157,2000,14659,7352,7307
22014,160,17,2000,0,0,0
22015,160,177,2000,0,0,0
22016,160,167,2000,0,0,0
22017,160,176,2000,0,0,0
22018,160,159,2000,562,277,285
22019,160,143,2000,0,0,0
22020,160,161,2000,12423,5320,7103
22021,160,144,2000,0,0,0
22022,160,162,2000,1524,693,831
22023,160,158,2000,0,0,0
22024,160,36,2000,92,48,44
22025,160,126,2000,0,0,0
22026,160,23,2000,0,0,0
22027,160,164,2000,10719,5191,5528
22028,160,165,2000,1177,570,607
22029,160,115,2000,0,0,0
22030,160,145,2000,0,0,0
22031,160,166,2000,856,350,506
22032,160,27,2000,0,0,0
22033,160,94,2000,0,0,0
22034,160,142,2000,0,0,0
22035,160,131,2000,0,0,0
22036,160,152,2000,20155,9913,10242
22037,160,114,2000,0,0,0
22038,160,132,2000,0,0,0
22039,58,51,2000,48,29,19
22040,58,141,2000,31,9,22
22041,58,103,2000,10,3,7
22042,58,11,2000,15,7,8
22043,58,66,2000,55,32,23
22044,58,3,2000,9,4,5
22045,58,29,2000,10,10,0
22046,58,67,2000,58,29,29
22047,58,53,2000,77,27,50
22048,58,105,2000,40,25,15
22049,58,30,2000,230,120,110
22050,58,172,2000,220,123,97
22051,58,54,2000,54,25,29
22052,58,14,2000,31,15,16
22053,58,31,2000,30,14,16
22054,58,39,2000,37,17,20
22055,58,142,2000,379,141,238
22056,58,119,2000,15,3,12
22057,58,120,2000,37,17,20
22058,58,42,2000,25,22,3
22059,58,68,2000,161,98,63
22060,58,15,2000,19,8,11
22061,58,69,2000,578,331,247
22062,58,156,2000,9,2,7
22063,58,56,2000,32,13,19
22064,58,32,2000,15,11,4
22065,58,5,2000,194,51,143
22066,58,6,2000,13,4,9
22067,58,16,2000,48,16,32
22068,58,44,2000,141,88,53
22069,58,17,2000,12,4,8
22070,58,57,2000,968,362,606
22071,58,177,2000,23,19,4
22072,58,18,2000,19,2,17
22073,58,121,2000,27,14,13
22074,58,19,2000,12,1,11
22075,58,46,2000,13,5,8
22076,58,20,2000,44,21,23
22077,58,143,2000,645,248,397
22078,58,47,2000,10,5,5
22079,58,144,2000,124,94,30
22080,58,73,2000,214,99,115
22081,58,162,2000,76,17,59
22082,58,60,2000,43,26,17
22083,58,48,2000,19,7,12
22084,58,9,2000,81,53,28
22085,58,112,2000,12,7,5
22086,58,33,2000,61,38,23
22087,58,61,2000,10,8,2
22088,58,35,2000,224,131,93
22089,58,36,2000,382,276,106
22090,58,23,2000,15,8,7
22091,58,63,2000,302,116,186
22092,58,37,2000,40,23,17
22093,58,64,2000,19,8,11
22094,58,128,2000,10,3,7
22095,58,115,2000,67,35,32
22096,58,65,2000,35,20,15
22097,58,10,2000,13,5,8
22098,58,145,2000,12,2,10
22099,58,49,2000,83,39,44
22100,58,74,2000,50,21,29
22101,58,25,2000,151,29,122
22102,58,93,2000,13,10,3
22103,58,146,2000,239,102,137
22104,58,26,2000,117,38,79
22105,58,38,2000,92,69,23
22106,58,27,2000,9,4,5
22107,58,50,2000,7313,4014,3299
22108,58,171,2000,10,7,3
22109,58,133,2000,23,9,14
22110,161,141,2000,1601,577,1024
22111,161,103,2000,66,27,39
22112,161,67,2000,60,27,33
22113,161,105,2000,157,61,96
22114,161,135,2000,385,144,241
22115,161,136,2000,51,20,31
22116,161,172,2000,156,110,46
22117,161,137,2000,42,15,27
22118,161,151,2000,541,232,309
22119,161,139,2000,84,37,47
22120,161,156,2000,204,119,85
22121,161,157,2000,3042,1710,1332
22122,161,16,2000,84,38,46
22123,161,57,2000,54,25,29
22124,161,19,2000,31,17,14
22125,161,20,2000,116,57,59
22126,161,143,2000,136,61,75
22127,161,160,2000,7483,3696,3787
22128,161,144,2000,337,146,191
22129,161,158,2000,1178,688,490
22130,161,36,2000,60,14,46
22131,161,23,2000,300,125,175
22132,161,164,2000,37730,16695,21035
22133,161,65,2000,84,34,50
22134,161,25,2000,137,68,69
22135,161,166,2000,114,68,46
22136,161,27,2000,68,33,35
22137,161,146,2000,243,115,128
22138,161,142,2000,222,101,121
22139,124,3,2000,313,211,102
22140,124,67,2000,15,3,12
22141,124,10,2000,42,33,9
22142,124,172,2000,8024,7175,849
22143,124,68,2000,993,489,504
22144,124,69,2000,124,63,61
22145,124,173,2000,25,9,16
22146,124,5,2000,3278,593,2685
22147,124,44,2000,6,3,3
22148,124,57,2000,106,49,57
22149,124,177,2000,15,12,3
22150,124,122,2000,563,154,409
22151,124,9,2000,7,4,3
22152,124,36,2000,38,26,12
22153,124,127,2000,58,40,18
22154,124,115,2000,307,187,120
22155,124,65,2000,3,1,2
22156,124,74,2000,13,4,9
22157,124,50,2000,458,262,196
22158,100,141,2000,131,47,84
22159,100,134,2000,49,25,24
22160,100,103,2000,6625,3313,3312
22161,100,66,2000,735,361,374
22162,100,3,2000,15,5,10
22163,100,11,2000,75,37,38
22164,100,67,2000,1083,578,505
22165,100,105,2000,3391,1957,1434
22166,100,95,2000,1597,1048,549
22167,100,30,2000,322,175,147
22168,100,135,2000,6,3,3
22169,100,106,2000,5685,3111,2574
22170,100,172,2000,2665,1302,1363
22171,100,107,2000,6639,3632,3007
22172,100,137,2000,15,3,12
22173,100,96,2000,3166,1896,1270
22174,100,54,2000,82,42,40
22175,100,81,2000,7267,3822,3445
22176,100,31,2000,330,203,127
22177,100,39,2000,355,164,191
22178,100,83,2000,1199,632,567
22179,100,108,2000,1778,928,850
22180,100,97,2000,5786,3095,2691
22181,100,42,2000,125,78,47
22182,100,68,2000,5723,2813,2910
22183,100,69,2000,5632,2490,3142
22184,100,56,2000,297,89,208
22185,100,98,2000,29156,11784,17372
22186,100,85,2000,334,109,225
22187,100,99,2000,4203,2514,1689
22188,100,32,2000,351,213,138
22189,100,5,2000,583,262,321
22190,100,6,2000,249,60,189
22191,100,16,2000,60,20,40
22192,100,44,2000,246,111,135
22193,100,17,2000,1469,636,833
22194,100,57,2000,5558,2088,3470
22195,100,86,2000,121,70,51
22196,100,177,2000,4356,2226,2130
22197,100,18,2000,64,20,44
22198,100,121,2000,26,16,10
22199,100,176,2000,2156,1048,1108
22200,100,20,2000,1698,770,928
22201,100,46,2000,26,15,11
22202,100,47,2000,101,68,33
22203,100,144,2000,232,106,126
22204,100,73,2000,1140,506,634
22205,100,101,2000,3696,2081,1615
22206,100,162,2000,44,11,33
22207,100,48,2000,197,89,108
22208,100,9,2000,87,18,69
22209,100,102,2000,2396,1258,1138
22210,100,111,2000,329,178,151
22211,100,112,2000,5479,2820,2659
22212,100,33,2000,1401,876,525
22213,100,61,2000,401,173,228
22214,100,88,2000,2572,1411,1161
22215,100,35,2000,357,215,142
22216,100,36,2000,1901,1225,676
22217,100,23,2000,172,65,107
22218,100,164,2000,20,8,12
22219,100,63,2000,23,15,8
22220,100,37,2000,34,15,19
22221,100,1,2000,50,20,30
22222,100,64,2000,49,21,28
22223,100,115,2000,110,62,48
22224,100,65,2000,21334,9866,11468
22225,100,49,2000,629,339,290
22226,100,74,2000,2192,992,1200
22227,100,25,2000,472,205,267
22228,100,93,2000,41,16,25
22229,100,26,2000,359,196,163
22230,100,38,2000,322,185,137
22231,100,142,2000,159,57,102
22232,100,50,2000,3976,2044,1932
22233,100,114,2000,1966,986,980
22234,72,68,2000,7134,4178,2956
22235,72,57,2000,4480,1897,2583
22236,59,51,2000,0,0,0
22237,59,66,2000,0,0,0
22238,59,53,2000,0,0,0
22239,59,30,2000,0,0,0
22240,59,54,2000,0,0,0
22241,59,31,2000,0,0,0
22242,59,39,2000,0,0,0
22243,59,68,2000,0,0,0
22244,59,69,2000,0,0,0
22245,59,56,2000,0,0,0
22246,59,32,2000,0,0,0
22247,59,57,2000,0,0,0
22248,59,71,2000,0,0,0
22249,59,73,2000,0,0,0
22250,59,33,2000,0,0,0
22251,59,35,2000,0,0,0
22252,59,36,2000,0,0,0
22253,59,63,2000,0,0,0
22254,59,37,2000,0,0,0
22255,59,64,2000,0,0,0
22256,59,49,2000,0,0,0
22257,59,74,2000,0,0,0
22258,59,26,2000,0,0,0
22259,59,38,2000,0,0,0
22260,59,60,2000,0,0,0
22261,59,50,2000,0,0,0
22262,87,76,2000,104,55,49
22263,87,82,2000,250,134,116
22264,87,83,2000,22,6,16
22265,87,110,2000,218,91,127
22266,87,90,2000,107,61,46
22267,87,92,2000,26,8,18
22268,87,93,2000,39,16,23
22269,87,50,2000,94,45,49
22270,144,141,2000,8877,4318,4559
22271,144,67,2000,927,450,477
22272,144,137,2000,1243,604,639
22273,144,68,2000,14547,7077,7470
22274,144,69,2000,952,463,489
22275,144,157,2000,651,316,335
22276,144,16,2000,1133,551,582
22277,144,57,2000,1253,609,644
22278,144,20,2000,892,433,459
22279,144,143,2000,777,378,399
22280,144,161,2000,1053,512,541
22281,144,164,2000,1193,580,613
22282,144,65,2000,2708,1317,1391
22283,144,25,2000,1353,658,695
22284,144,146,2000,1704,828,876
22285,144,142,2000,1228,597,631
22286,144,50,2000,801,389,412
22287,125,134,2000,22937,10847,12090
22288,125,116,2000,985,463,522
22289,125,153,2000,4001,1794,2207
22290,125,137,2000,3705,1745,1960
22291,125,5,2000,1441,501,940
22292,125,121,2000,14539,7000,7539
22293,125,149,2000,4601,2394,2207
22294,125,123,2000,36755,17021,19734
22295,125,162,2000,3143,1527,1616
22296,125,9,2000,828,289,539
22297,125,61,2000,2669,876,1793
22298,125,127,2000,9939,5003,4936
22299,125,115,2000,11835,5479,6356
22300,125,133,2000,57131,27651,29480
22301,125,131,2000,4355,1940,2415
22302,125,132,2000,3118,1504,1614
22303,150,2,2000,58,35,23
22304,150,141,2000,637,335,302
22305,150,134,2000,49790,20302,29488
22306,150,76,2000,616,368,248
22307,150,103,2000,67,42,25
22308,150,66,2000,801,368,433
22309,150,78,2000,67,50,17
22310,150,13,2000,65,47,18
22311,150,3,2000,44,17,27
22312,150,11,2000,84,2,82
22313,150,67,2000,242,120,122
22314,150,147,2000,865,441,424
22315,150,105,2000,702,408,294
22316,150,30,2000,41,32,9
22317,150,116,2000,511,200,311
22318,150,135,2000,156,28,128
22319,150,106,2000,44,13,31
22320,150,172,2000,4078,1147,2931
22321,150,137,2000,1468,613,855
22322,150,137,2000,4179,2154,2025
22323,150,81,2000,893,528,365
22324,150,31,2000,101,69,32
22325,150,151,2000,206,116,90
22326,150,39,2000,150,50,100
22327,150,120,2000,278,189,89
22328,150,42,2000,104,75,29
22329,150,68,2000,705,387,318
22330,150,155,2000,114,64,50
22331,150,69,2000,11896,6830,5066
22332,150,156,2000,189,79,110
22333,150,157,2000,71,28,43
22334,150,5,2000,886,306,580
22335,150,6,2000,41,17,24
22336,150,44,2000,80,42,38
22337,150,17,2000,143,64,79
22338,150,57,2000,1083,595,488
22339,150,177,2000,150,94,56
22340,150,121,2000,1458,720,738
22341,150,176,2000,133,0,133
22342,150,20,2000,61,24,37
22343,150,149,2000,166,86,80
22344,150,143,2000,48,24,24
22345,150,71,2000,58,32,26
22346,150,123,2000,485,226,259
22347,150,124,2000,141,83,58
22348,150,125,2000,182,79,103
22349,150,73,2000,679,346,333
22350,150,162,2000,1290,500,790
22351,150,48,2000,71,47,24
22352,150,9,2000,219,24,195
22353,150,33,2000,222,145,77
22354,150,61,2000,570,233,337
22355,150,35,2000,41,20,21
22356,150,36,2000,597,247,350
22357,150,126,2000,471,208,263
22358,150,164,2000,41,17,24
22359,150,127,2000,75,47,28
22360,150,165,2000,216,116,100
22361,150,128,2000,123,38,85
22362,150,115,2000,11132,5556,5576
22363,150,133,2000,18964,9315,9649
22364,150,65,2000,452,185,267
22365,150,145,2000,262,145,117
22366,150,148,2000,259,141,118
22367,150,49,2000,133,72,61
22368,150,74,2000,564,324,240
22369,150,26,2000,48,20,28
22370,150,130,2000,633,310,323
22371,150,38,2000,338,47,291
22372,150,142,2000,229,90,139
22373,150,50,2000,2256,1298,958
22374,150,131,2000,1442,730,712
22375,150,152,2000,94,50,44
22376,150,132,2000,3971,1391,2580
22377,8,3,2000,522,348,174
22378,8,4,2000,111196,54567,56629
22379,8,10,2000,87,67,20
22380,8,172,2000,22820,9472,13348
22381,8,5,2000,543594,391353,152241
22382,8,9,2000,2470,1129,1341
22383,73,2,2000,19683,8431,11252
22384,73,51,2000,362,156,206
22385,73,141,2000,3717,1113,2604
22386,73,52,2000,0,0,0
22387,73,134,2000,3445,1261,2184
22388,73,75,2000,14,8,6
22389,73,76,2000,23,13,10
22390,73,103,2000,2020,1116,904
22391,73,11,2000,85,44,41
22392,73,77,2000,727,345,382
22393,73,66,2000,6742,3983,2759
22394,73,12,2000,81,50,31
22395,73,78,2000,48,20,28
22396,73,13,2000,98,53,45
22397,73,3,2000,800,530,270
22398,73,79,2000,74,30,44
22399,73,29,2000,27,11,16
22400,73,67,2000,44982,25659,19323
22401,73,95,2000,0,0,0
22402,73,151,2000,106,39,67
22403,73,4,2000,19,3,16
22404,73,53,2000,458,222,236
22405,73,147,2000,177,90,87
22406,73,105,2000,7770,4640,3130
22407,73,30,2000,1650,1028,622
22408,73,152,2000,181,67,114
22409,73,116,2000,444,209,235
22410,73,153,2000,10923,5520,5403
22411,73,135,2000,859,424,435
22412,73,80,2000,0,0,0
22413,73,136,2000,56,25,31
22414,73,106,2000,2787,1426,1361
22415,73,172,2000,32395,16788,15607
22416,73,107,2000,8883,5128,3755
22417,73,117,2000,0,0,0
22418,73,137,2000,587,252,335
22419,73,96,2000,413,222,191
22420,73,54,2000,129,64,65
22421,73,81,2000,624,372,252
22422,73,14,2000,247,100,147
22423,73,31,2000,4661,3222,1439
22424,73,176,2000,4,0,4
22425,73,137,2000,4492,1863,2629
22426,73,39,2000,3048,1901,1147
22427,73,118,2000,96,48,48
22428,73,82,2000,67,37,30
22429,73,83,2000,5593,4034,1559
22430,73,108,2000,876,528,348
22431,73,142,2000,9082,2082,7000
22432,73,97,2000,267,154,113
22433,73,138,2000,19,10,9
22434,73,119,2000,309,134,175
22435,73,40,2000,165,122,43
22436,73,148,2000,72,38,34
22437,73,120,2000,7281,3162,4119
22438,73,41,2000,0,0,0
22439,73,42,2000,2237,1582,655
22440,73,68,2000,17789,9987,7802
22441,73,139,2000,71,38,33
22442,73,155,2000,223,53,170
22443,73,15,2000,63,30,33
22444,73,69,2000,123252,74409,48843
22445,73,156,2000,10792,5171,5621
22446,73,55,2000,23,4,19
22447,73,56,2000,7052,2453,4599
22448,73,84,2000,29,14,15
22449,73,98,2000,328,171,157
22450,73,157,2000,784,137,647
22451,73,158,2000,148,59,89
22452,73,110,2000,2309,1494,815
22453,73,85,2000,541,273,268
22454,73,99,2000,250,161,89
22455,73,32,2000,5151,3057,2094
22456,73,43,2000,377,210,167
22457,73,5,2000,10649,5033,5616
22458,73,6,2000,19921,8307,11614
22459,73,16,2000,29654,10885,18769
22460,73,44,2000,4252,2288,1964
22461,73,45,2000,0,0,0
22462,73,17,2000,4136,1756,2380
22463,73,57,2000,16607,5235,11372
22464,73,86,2000,784,495,289
22465,73,177,2000,5687,2981,2706
22466,73,18,2000,777,292,485
22467,73,167,2000,8,3,5
22468,73,121,2000,1759,947,812
22469,73,19,2000,1290,529,761
22470,73,168,2000,0,0,0
22471,73,46,2000,255,176,79
22472,73,20,2000,2922,1203,1719
22473,73,149,2000,83,41,42
22474,73,159,2000,1955,586,1369
22475,73,143,2000,399,146,253
22476,73,70,2000,0,0,0
22477,73,47,2000,342,273,69
22478,73,71,2000,796,438,358
22479,73,122,2000,137,81,56
22480,73,123,2000,218,108,110
22481,73,7,2000,0,0,0
22482,73,160,2000,96,44,52
22483,73,58,2000,210,128,82
22484,73,161,2000,325,10,315
22485,73,124,2000,289,177,112
22486,73,100,2000,1312,767,545
22487,73,72,2000,46,27,19
22488,73,59,2000,0,0,0
22489,73,87,2000,0,0,0
22490,73,144,2000,151473,67667,83806
22491,73,125,2000,431,215,216
22492,73,150,2000,136,81,55
22493,73,8,2000,413,204,209
22494,73,101,2000,265,155,110
22495,73,162,2000,3836,1391,2445
22496,73,60,2000,10,6,4
22497,73,48,2000,2355,1434,921
22498,73,21,2000,347,178,169
22499,73,9,2000,10427,3936,6491
22500,73,102,2000,201,94,107
22501,73,111,2000,156,95,61
22502,73,112,2000,1884,1209,675
22503,73,33,2000,16189,11574,4615
22504,73,61,2000,9606,4747,4859
22505,73,22,2000,31,20,11
22506,73,35,2000,4036,2448,1588
22507,73,36,2000,14823,9376,5447
22508,73,126,2000,606,278,328
22509,73,90,2000,41,21,20
22510,73,91,2000,41,18,23
22511,73,92,2000,40,23,17
22512,73,62,2000,0,0,0
22513,73,140,2000,115,58,57
22514,73,23,2000,890,428,462
22515,73,164,2000,604,177,427
22516,73,63,2000,49504,24293,25211
22517,73,127,2000,78,49,29
22518,73,165,2000,1265,268,997
22519,73,37,2000,27,13,14
22520,73,64,2000,26,13,13
22521,73,128,2000,21261,9350,11911
22522,73,115,2000,10553,5682,4871
22523,73,129,2000,0,0,0
22524,73,65,2000,17910,8742,9168
22525,73,10,2000,9156,4117,5039
22526,73,145,2000,3441,865,2576
22527,73,113,2000,183613,98418,85195
22528,73,49,2000,3492,2048,1444
22529,73,74,2000,5618,3294,2324
22530,73,25,2000,4060,1793,2267
22531,73,169,2000,122,108,14
22532,73,166,2000,609,161,448
22533,73,93,2000,450,274,176
22534,73,146,2000,3712,1147,2565
22535,73,26,2000,176615,83990,92625
22536,73,170,2000,0,0,0
22537,73,94,2000,0,0,0
22538,73,130,2000,640,295,345
22539,73,38,2000,92,39,53
22540,73,27,2000,41,11,30
22541,73,50,2000,43294,19745,23549
22542,73,131,2000,1091,552,539
22543,73,114,2000,565,268,297
22544,73,171,2000,9766,4689,5077
22545,73,1,2000,10560,5332,5228
22546,73,28,2000,133,39,94
22547,73,132,2000,820,411,409
22548,73,133,2000,954,497,457
22549,101,2,2000,37,16,21
22550,101,141,2000,68,35,33
22551,101,76,2000,65,33,32
22552,101,103,2000,188,87,101
22553,101,66,2000,38,15,23
22554,101,78,2000,45,22,23
22555,101,67,2000,40,11,29
22556,101,105,2000,107,62,45
22557,101,95,2000,34,16,18
22558,101,30,2000,61,40,21
22559,101,106,2000,111,42,69
22560,101,172,2000,81,25,56
22561,101,107,2000,309,148,161
22562,101,137,2000,29,9,20
22563,101,96,2000,6948,3495,3453
22564,101,81,2000,754,297,457
22565,101,39,2000,44,15,29
22566,101,83,2000,55,27,28
22567,101,108,2000,86,36,50
22568,101,97,2000,2102,941,1161
22569,101,120,2000,49,18,31
22570,101,68,2000,119,49,70
22571,101,69,2000,275,112,163
22572,101,98,2000,1199,575,624
22573,101,85,2000,20,7,13
22574,101,99,2000,10017,5177,4840
22575,101,5,2000,15,6,9
22576,101,44,2000,16,6,10
22577,101,57,2000,155,44,111
22578,101,86,2000,24,9,15
22579,101,177,2000,39,13,26
22580,101,18,2000,17,5,12
22581,101,100,2000,725,410,315
22582,101,73,2000,160,85,75
22583,101,162,2000,15,9,6
22584,101,102,2000,347,165,182
22585,101,112,2000,185,79,106
22586,101,88,2000,46,23,23
22587,101,36,2000,235,144,91
22588,101,164,2000,113,62,51
22589,101,128,2000,23,18,5
22590,101,65,2000,415,181,234
22591,101,49,2000,36,18,18
22592,101,74,2000,73,21,52
22593,101,38,2000,65,40,25
22594,101,50,2000,48,17,31
22595,101,114,2000,21,12,9
22596,101,28,2000,18,12,6
22597,162,135,2000,10943,4882,6061
22598,162,136,2000,11871,5296,6575
22599,162,151,2000,143212,63894,79318
22600,162,156,2000,90479,40367,50112
22601,162,159,2000,8358,3728,4630
22602,162,160,2000,65493,29220,36273
22603,162,165,2000,1658,739,919
22604,162,166,2000,60095,26811,33284
22605,176,3,2000,97,64,33
22606,176,105,2000,1801,927,874
22607,176,10,2000,132,99,33
22608,176,172,2000,19511,9209,10302
22609,176,173,2000,106,41,65
22610,176,5,2000,217,105,112
22611,176,177,2000,166,75,91
22612,176,9,2000,107,51,56
22613,176,112,2000,327,168,159
22614,176,36,2000,72,36,36
22615,176,1,2000,681,291,390
22616,176,50,2000,221,96,125
22617,60,51,2000,69367,40450,28917
22618,60,53,2000,7614,4439,3175
22619,60,30,2000,938,547,391
22620,60,54,2000,1253,731,522
22621,60,31,2000,47,27,20
22622,60,69,2000,38,22,16
22623,60,56,2000,205,119,86
22624,60,32,2000,72,42,30
22625,60,57,2000,34,20,14
22626,60,59,2000,8065,4703,3362
22627,60,33,2000,88,51,37
22628,60,35,2000,21,12,9
22629,60,36,2000,189,111,78
22630,60,63,2000,15656,9130,6526
22631,60,37,2000,33,19,14
22632,60,64,2000,225,131,94
22633,60,26,2000,18717,10915,7802
22634,60,38,2000,57,33,24
22635,60,142,2000,1717,1001,716
22636,48,2,2000,638,287,351
22637,48,51,2000,149,68,81
22638,48,141,2000,731,215,516
22639,48,52,2000,0,0,0
22640,48,134,2000,103,53,50
22641,48,76,2000,0,0,0
22642,48,103,2000,533,289,244
22643,48,11,2000,33,17,16
22644,48,77,2000,0,0,0
22645,48,66,2000,1058,502,556
22646,48,12,2000,63,38,25
22647,48,78,2000,9,5,4
22648,48,13,2000,18,8,10
22649,48,3,2000,485,262,223
22650,48,79,2000,20,8,12
22651,48,29,2000,108,77,31
22652,48,67,2000,886,462,424
22653,48,95,2000,0,0,0
22654,48,151,2000,7,3,4
22655,48,4,2000,15,4,11
22656,48,53,2000,11573,5878,5695
22657,48,147,2000,82,37,45
22658,48,105,2000,1260,774,486
22659,48,30,2000,787,390,397
22660,48,152,2000,11,3,8
22661,48,116,2000,58,27,31
22662,48,153,2000,234,98,136
22663,48,135,2000,197,84,113
22664,48,80,2000,0,0,0
22665,48,136,2000,7,0,7
22666,48,106,2000,5444,2522,2922
22667,48,172,2000,3617,2207,1410
22668,48,173,2000,884,411,473
22669,48,174,2000,28,14,14
22670,48,107,2000,3230,1426,1804
22671,48,117,2000,0,0,0
22672,48,137,2000,266,131,135
22673,48,96,2000,177,89,88
22674,48,54,2000,1425,640,785
22675,48,81,2000,209,128,81
22676,48,14,2000,105,27,78
22677,48,31,2000,506,273,233
22678,48,176,2000,25,15,10
22679,48,137,2000,34,13,21
22680,48,39,2000,21713,11304,10409
22681,48,118,2000,11,8,3
22682,48,82,2000,0,0,0
22683,48,83,2000,236,161,75
22684,48,108,2000,376,182,194
22685,48,142,2000,383,116,267
22686,48,97,2000,108,59,49
22687,48,138,2000,0,0,0
22688,48,119,2000,530,264,266
22689,48,40,2000,302,235,67
22690,48,148,2000,0,0,0
22691,48,120,2000,2567,1041,1526
22692,48,41,2000,902,460,442
22693,48,42,2000,6635,3880,2755
22694,48,68,2000,2934,1373,1561
22695,48,139,2000,0,0,0
22696,48,155,2000,789,263,526
22697,48,15,2000,16,8,8
22698,48,69,2000,11445,6051,5394
22699,48,156,2000,1050,469,581
22700,48,55,2000,0,0,0
22701,48,56,2000,575,142,433
22702,48,84,2000,0,0,0
22703,48,98,2000,285,140,145
22704,48,157,2000,30,15,15
22705,48,158,2000,13,4,9
22706,48,110,2000,78,49,29
22707,48,85,2000,11,3,8
22708,48,99,2000,61,30,31
22709,48,32,2000,1409,616,793
22710,48,43,2000,3780,1947,1833
22711,48,5,2000,5130,2686,2444
22712,48,6,2000,8857,3645,5212
22713,48,16,2000,6941,2596,4345
22714,48,44,2000,498,246,252
22715,48,45,2000,0,0,0
22716,48,17,2000,506,208,298
22717,48,57,2000,1413,504,909
22718,48,86,2000,73,46,27
22719,48,177,2000,926,591,335
22720,48,18,2000,109,41,68
22721,48,167,2000,46,40,6
22722,48,121,2000,827,429,398
22723,48,19,2000,142,63,79
22724,48,168,2000,6,3,3
22725,48,46,2000,326,248,78
22726,48,20,2000,1189,493,696
22727,48,149,2000,0,0,0
22728,48,159,2000,70,36,34
22729,48,143,2000,70,20,50
22730,48,70,2000,6,3,3
22731,48,47,2000,274,221,53
22732,48,71,2000,89,34,55
22733,48,122,2000,371,185,186
22734,48,123,2000,12,7,5
22735,48,7,2000,0,0,0
22736,48,160,2000,17,5,12
22737,48,58,2000,46,20,26
22738,48,161,2000,12,3,9
22739,48,124,2000,138,69,69
22740,48,100,2000,380,230,150
22741,48,72,2000,0,0,0
22742,48,59,2000,0,0,0
22743,48,87,2000,0,0,0
22744,48,144,2000,3719,1388,2331
22745,48,125,2000,60,43,17
22746,48,150,2000,39,22,17
22747,48,8,2000,164,74,90
22748,48,73,2000,4108,2018,2090
22749,48,101,2000,98,49,49
22750,48,162,2000,414,145,269
22751,48,60,2000,537,248,289
22752,48,21,2000,28,13,15
22753,48,9,2000,13283,6189,7094
22754,48,102,2000,27,18,9
22755,48,111,2000,74,41,33
22756,48,112,2000,548,293,255
22757,48,33,2000,5738,3763,1975
22758,48,61,2000,708,317,391
22759,48,88,2000,13,6,7
22760,48,22,2000,12,4,8
22761,48,35,2000,1082,651,431
22762,48,36,2000,3114,2147,967
22763,48,126,2000,148,81,67
22764,48,90,2000,0,0,0
22765,48,91,2000,0,0,0
22766,48,92,2000,0,0,0
22767,48,62,2000,0,0,0
22768,48,140,2000,0,0,0
22769,48,23,2000,203,96,107
22770,48,164,2000,71,26,45
22771,48,63,2000,0,0,0
22772,48,127,2000,0,0,0
22773,48,165,2000,195,74,121
22774,48,37,2000,141,86,55
22775,48,64,2000,59,34,25
22776,48,128,2000,6445,2842,3603
22777,48,115,2000,744,373,371
22778,48,129,2000,0,0,0
22779,48,65,2000,1610,700,910
22780,48,10,2000,7295,3329,3966
22781,48,145,2000,341,116,225
22782,48,113,2000,17,10,7
22783,48,49,2000,33401,17743,15658
22784,48,74,2000,1501,781,720
22785,48,25,2000,582,249,333
22786,48,169,2000,10,7,3
22787,48,166,2000,63,24,39
22788,48,93,2000,265,139,126
22789,48,146,2000,530,101,429
22790,48,26,2000,7300,3185,4115
22791,48,170,2000,9,4,5
22792,48,94,2000,0,0,0
22793,48,130,2000,459,213,246
22794,48,38,2000,314,239,75
22795,48,27,2000,82,41,41
22796,48,50,2000,14347,6282,8065
22797,48,131,2000,507,241,266
22798,48,114,2000,163,82,81
22799,48,171,2000,30,18,12
22800,48,1,2000,11177,5422,5755
22801,48,28,2000,35,17,18
22802,48,132,2000,184,95,89
22803,48,133,2000,148,69,79
22804,21,13,2000,400,195,205
22805,21,3,2000,92034,6586,85448
22806,21,10,2000,11085,6133,4952
22807,21,68,2000,940,296,644
22808,21,5,2000,333881,60718,273163
22809,21,16,2000,2223,927,1296
22810,21,18,2000,10484,3463,7021
22811,21,19,2000,241,78,163
22812,21,73,2000,730,241,489
22813,21,9,2000,66498,9380,57118
22814,21,22,2000,106,56,50
22815,21,23,2000,808,210,598
22816,21,129,2000,0,0,0
22817,21,145,2000,9917,3575,6342
22818,21,27,2000,10139,3966,6173
22819,21,142,2000,28536,9978,18558
22820,21,50,2000,4658,1427,3231
22821,9,2,2000,2069977,963267,1106710
22822,9,10,2000,569,261,308
22823,9,172,2000,363,153,210
22824,9,5,2000,2101039,963773,1137266
22825,9,6,2000,2940,1320,1620
22826,9,16,2000,586,276,310
22827,102,103,2000,796,376,420
22828,102,66,2000,53,20,33
22829,102,3,2000,13,0,13
22830,102,79,2000,46,29,17
22831,102,67,2000,22,6,16
22832,102,105,2000,802,489,313
22833,102,95,2000,86,40,46
22834,102,30,2000,66,22,44
22835,102,106,2000,1060,522,538
22836,102,172,2000,11300,5176,6124
22837,102,107,2000,21473,10908,10565
22838,102,96,2000,4654,2546,2108
22839,102,54,2000,46,4,42
22840,102,81,2000,1676,738,938
22841,102,31,2000,26,13,13
22842,102,39,2000,40,13,27
22843,102,82,2000,24,15,9
22844,102,83,2000,5859,4182,1677
22845,102,108,2000,1896,807,1089
22846,102,97,2000,2032,996,1036
22847,102,42,2000,11,4,7
22848,102,68,2000,322,143,179
22849,102,15,2000,0,0,0
22850,102,69,2000,426,163,263
22851,102,56,2000,229,67,162
22852,102,84,2000,2,2,0
22853,102,98,2000,600,293,307
22854,102,110,2000,33,8,25
22855,102,85,2000,300,152,148
22856,102,99,2000,838,450,388
22857,102,173,2000,371,170,201
22858,102,32,2000,20,11,9
22859,102,5,2000,2112,866,1246
22860,102,6,2000,62,13,49
22861,102,44,2000,24,8,16
22862,102,17,2000,560,195,365
22863,102,57,2000,578,215,363
22864,102,86,2000,553,320,233
22865,102,177,2000,335,127,208
22866,102,18,2000,84,26,58
22867,102,20,2000,344,130,214
22868,102,143,2000,22,8,14
22869,102,47,2000,28,8,20
22870,102,100,2000,2341,1263,1078
22871,102,144,2000,46,17,29
22872,102,73,2000,108,40,68
22873,102,101,2000,4923,2802,2121
22874,102,162,2000,13,2,11
22875,102,48,2000,6,2,4
22876,102,9,2000,51,20,31
22877,102,111,2000,35,22,13
22878,102,112,2000,2697,1142,1555
22879,102,33,2000,80,26,54
22880,102,61,2000,137,40,97
22881,102,88,2000,335,125,210
22882,102,35,2000,71,29,42
22883,102,36,2000,409,237,172
22884,102,23,2000,35,8,27
22885,102,63,2000,33,8,25
22886,102,37,2000,6,2,4
22887,102,1,2000,8,4,4
22888,102,115,2000,24,11,13
22889,102,65,2000,2512,951,1561
22890,102,49,2000,51,17,34
22891,102,74,2000,166,60,106
22892,102,25,2000,164,58,106
22893,102,93,2000,46,20,26
22894,102,26,2000,40,15,25
22895,102,38,2000,128,51,77
22896,102,142,2000,42,24,18
22897,102,50,2000,329,116,213
22898,102,114,2000,264,112,152
22899,111,103,2000,64404,31921,32483
22900,111,105,2000,83208,39542,43666
22901,111,106,2000,2382,981,1401
22902,111,172,2000,882,388,494
22903,111,68,2000,695,274,421
22904,111,69,2000,1874,790,1084
22905,111,57,2000,990,381,609
22906,111,177,2000,2240,1068,1172
22907,111,100,2000,1813,900,913
22908,111,33,2000,986,462,524
22909,111,65,2000,998,420,578
22910,111,50,2000,198,90,108
22911,111,114,2000,3303,1420,1883
22912,112,141,2000,14,5,9
22913,112,134,2000,11,8,3
22914,112,103,2000,8282,4232,4050
22915,112,66,2000,144,66,78
22916,112,67,2000,448,215,233
22917,112,105,2000,3545,1985,1560
22918,112,30,2000,50,23,27
22919,112,106,2000,5239,2815,2424
22920,112,172,2000,2981,1347,1634
22921,112,107,2000,4331,2329,2002
22922,112,96,2000,246,128,118
22923,112,54,2000,67,15,52
22924,112,81,2000,660,269,391
22925,112,31,2000,66,30,36
22926,112,39,2000,177,89,88
22927,112,83,2000,132,68,64
22928,112,108,2000,2911,1676,1235
22929,112,97,2000,79,42,37
22930,112,40,2000,12,6,6
22931,112,42,2000,52,27,25
22932,112,68,2000,1685,781,904
22933,112,109,2000,25,14,11
22934,112,69,2000,2134,1068,1066
22935,112,56,2000,43,12,31
22936,112,98,2000,119,61,58
22937,112,85,2000,36,22,14
22938,112,99,2000,121,75,46
22939,112,32,2000,47,24,23
22940,112,43,2000,11,2,9
22941,112,5,2000,151,59,92
22942,112,6,2000,42,13,29
22943,112,16,2000,14,3,11
22944,112,44,2000,154,77,77
22945,112,17,2000,370,146,224
22946,112,57,2000,2448,1097,1351
22947,112,177,2000,2446,1225,1221
22948,112,18,2000,29,8,21
22949,112,176,2000,64,29,35
22950,112,20,2000,51,21,30
22951,112,71,2000,11,5,6
22952,112,58,2000,16,0,16
22953,112,100,2000,1088,579,509
22954,112,144,2000,29,12,17
22955,112,73,2000,495,229,266
22956,112,101,2000,117,76,41
22957,112,48,2000,77,36,41
22958,112,9,2000,53,12,41
22959,112,102,2000,252,129,123
22960,112,111,2000,398,219,179
22961,112,33,2000,145,72,73
22962,112,61,2000,94,34,60
22963,112,88,2000,100,54,46
22964,112,35,2000,134,73,61
22965,112,36,2000,459,293,166
22966,112,92,2000,17,12,5
22967,112,23,2000,24,11,13
22968,112,64,2000,21,10,11
22969,112,115,2000,85,32,53
22970,112,65,2000,3702,1757,1945
22971,112,49,2000,206,97,109
22972,112,74,2000,569,263,306
22973,112,26,2000,39,14,25
22974,112,38,2000,176,118,58
22975,112,142,2000,15,3,12
22976,112,50,2000,1209,578,631
22977,112,114,2000,447,194,253
22978,33,2,2000,160,18,142
22979,33,51,2000,60,24,36
22980,33,141,2000,470,119,351
22981,33,134,2000,28,0,28
22982,33,103,2000,183,86,97
22983,33,11,2000,864,365,499
22984,33,66,2000,4477,2329,2148
22985,33,12,2000,260,145,115
22986,33,3,2000,44,2,42
22987,33,29,2000,108478,64604,43874
22988,33,67,2000,2904,1510,1394
22989,33,53,2000,3383,1911,1472
22990,33,105,2000,219,133,86
22991,33,30,2000,1766,744,1022
22992,33,135,2000,10,1,9
22993,33,106,2000,24,9,15
22994,33,172,2000,674,361,313
22995,33,107,2000,59,21,38
22996,33,137,2000,50,10,40
22997,33,96,2000,21,5,16
22998,33,54,2000,835,456,379
22999,33,81,2000,191,65,126
23000,33,14,2000,46,14,32
23001,33,31,2000,6438,3803,2635
23002,33,39,2000,729,428,301
23003,33,83,2000,3,1,2
23004,33,108,2000,31,7,24
23005,33,142,2000,211,59,152
23006,33,119,2000,2,0,2
23007,33,40,2000,293,183,110
23008,33,120,2000,50,13,37
23009,33,42,2000,199,110,89
23010,33,68,2000,35964,19903,16061
23011,33,15,2000,336,180,156
23012,33,69,2000,105540,60462,45078
23013,33,156,2000,48,14,34
23014,33,56,2000,2900,1217,1683
23015,33,157,2000,12,4,8
23016,33,110,2000,13,2,11
23017,33,32,2000,1395,809,586
23018,33,43,2000,42,14,28
23019,33,5,2000,318,99,219
23020,33,6,2000,144,39,105
23021,33,16,2000,410,58,352
23022,33,44,2000,74,21,53
23023,33,17,2000,396,122,274
23024,33,57,2000,4457,2160,2297
23025,33,177,2000,238,123,115
23026,33,18,2000,163,22,141
23027,33,167,2000,3496,1906,1590
23028,33,121,2000,55,25,30
23029,33,19,2000,142,55,87
23030,33,168,2000,78,45,33
23031,33,46,2000,2317,1408,909
23032,33,20,2000,341,67,274
23033,33,143,2000,316,126,190
23034,33,47,2000,82835,49969,32866
23035,33,71,2000,130,73,57
23036,33,160,2000,26,0,26
23037,33,100,2000,120,60,60
23038,33,72,2000,2,1,1
23039,33,59,2000,201,82,119
23040,33,144,2000,162,44,118
23041,33,125,2000,13,1,12
23042,33,8,2000,9,0,9
23043,33,73,2000,1001,388,613
23044,33,162,2000,205,31,174
23045,33,60,2000,212,75,137
23046,33,48,2000,326,151,175
23047,33,9,2000,62,11,51
23048,33,102,2000,25,10,15
23049,33,112,2000,105,26,79
23050,33,61,2000,62,25,37
23051,33,22,2000,6,2,4
23052,33,35,2000,3475,2017,1458
23053,33,36,2000,56310,36088,20222
23054,33,23,2000,25,10,15
23055,33,164,2000,25,1,24
23056,33,63,2000,3470,1862,1608
23057,33,37,2000,1572,924,648
23058,33,64,2000,134,79,55
23059,33,115,2000,275,135,140
23060,33,65,2000,1153,539,614
23061,33,10,2000,26,8,18
23062,33,145,2000,64,11,53
23063,33,49,2000,729,354,375
23064,33,74,2000,525,281,244
23065,33,25,2000,574,79,495
23066,33,169,2000,62,41,21
23067,33,146,2000,137,29,108
23068,33,26,2000,469,171,298
23069,33,170,2000,46,37,9
23070,33,130,2000,45,21,24
23071,33,38,2000,321013,194278,126735
23072,33,27,2000,86,43,43
23073,33,50,2000,2731,1201,1530
23074,33,131,2000,52,12,40
23075,33,114,2000,10,6,4
23076,33,171,2000,364,233,131
23077,33,1,2000,1713,654,1059
23078,33,28,2000,96,7,89
23079,33,132,2000,38,13,25
23080,33,133,2000,26,11,15
23081,61,51,2000,40,15,25
23082,61,141,2000,187,69,118
23083,61,52,2000,417,218,199
23084,61,134,2000,173193,91378,81815
23085,61,103,2000,1032,559,473
23086,61,11,2000,54,24,30
23087,61,66,2000,388,206,182
23088,61,12,2000,10,5,5
23089,61,3,2000,261,17,244
23090,61,29,2000,131,50,81
23091,61,67,2000,2862,1508,1354
23092,61,151,2000,25,4,21
23093,61,53,2000,44,23,21
23094,61,105,2000,49599,25260,24339
23095,61,30,2000,624,211,413
23096,61,153,2000,44701,21941,22760
23097,61,135,2000,57,25,32
23098,61,106,2000,188,97,91
23099,61,172,2000,2291,1103,1188
23100,61,173,2000,91,55,36
23101,61,174,2000,2865,1579,1286
23102,61,107,2000,362,247,115
23103,61,137,2000,1812,957,855
23104,61,54,2000,92,34,58
23105,61,81,2000,396,223,173
23106,61,14,2000,19,10,9
23107,61,31,2000,129,76,53
23108,61,176,2000,5,3,2
23109,61,137,2000,1607,828,779
23110,61,39,2000,368,187,181
23111,61,83,2000,36,26,10
23112,61,108,2000,222,111,111
23113,61,142,2000,101,46,55
23114,61,97,2000,23,12,11
23115,61,138,2000,55,37,18
23116,61,40,2000,223,126,97
23117,61,148,2000,164,90,74
23118,61,120,2000,12,10,2
23119,61,42,2000,310,181,129
23120,61,68,2000,94718,50536,44182
23121,61,139,2000,71,38,33
23122,61,155,2000,24,1,23
23123,61,15,2000,140,16,124
23124,61,69,2000,24141,12342,11799
23125,61,156,2000,53,12,41
23126,61,56,2000,124,61,63
23127,61,98,2000,25,18,7
23128,61,157,2000,295,54,241
23129,61,158,2000,21309,8568,12741
23130,61,32,2000,215,141,74
23131,61,43,2000,33,17,16
23132,61,5,2000,6600,3057,3543
23133,61,6,2000,179,79,100
23134,61,16,2000,54,22,32
23135,61,44,2000,529,284,245
23136,61,17,2000,96,39,57
23137,61,57,2000,1946,808,1138
23138,61,86,2000,26,14,12
23139,61,177,2000,278,150,128
23140,61,18,2000,11,1,10
23141,61,167,2000,92,31,61
23142,61,121,2000,150,87,63
23143,61,46,2000,70,23,47
23144,61,20,2000,58,26,32
23145,61,159,2000,30,5,25
23146,61,143,2000,10,2,8
23147,61,70,2000,4,1,3
23148,61,47,2000,131,30,101
23149,61,71,2000,3293,1673,1620
23150,61,122,2000,35,13,22
23151,61,123,2000,189,116,73
23152,61,160,2000,43,6,37
23153,61,58,2000,22,8,14
23154,61,161,2000,30,6,24
23155,61,100,2000,212,136,76
23156,61,59,2000,105,12,93
23157,61,144,2000,1346,516,830
23158,61,125,2000,75573,39917,35656
23159,61,8,2000,32,6,26
23160,61,73,2000,3231,1626,1605
23161,61,162,2000,145,46,99
23162,61,60,2000,11,6,5
23163,61,48,2000,281,136,145
23164,61,9,2000,852,92,760
23165,61,102,2000,119,66,53
23166,61,111,2000,23,14,9
23167,61,112,2000,202,127,75
23168,61,33,2000,355,187,168
23169,61,35,2000,2787,752,2035
23170,61,36,2000,2317,939,1378
23171,61,140,2000,12417,6693,5724
23172,61,164,2000,627,165,462
23173,61,63,2000,158,19,139
23174,61,165,2000,43,4,39
23175,61,37,2000,29,17,12
23176,61,64,2000,30,17,13
23177,61,115,2000,11131,5833,5298
23178,61,65,2000,13884,8318,5566
23179,61,10,2000,12,5,7
23180,61,49,2000,736,403,333
23181,61,74,2000,12821,6348,6473
23182,61,25,2000,34,15,19
23183,61,166,2000,29,6,23
23184,61,146,2000,52,19,33
23185,61,26,2000,105,32,73
23186,61,130,2000,58,35,23
23187,61,38,2000,10882,2051,8831
23188,61,50,2000,10009,5035,4974
23189,61,131,2000,165,104,61
23190,61,114,2000,134,66,68
23191,61,171,2000,18,2,16
23192,61,1,2000,20,11,9
23193,61,133,2000,1344,744,600
23194,88,103,2000,1259,661,598
23195,88,105,2000,207,108,99
23196,88,106,2000,837,439,398
23197,88,172,2000,1315,691,624
23198,88,107,2000,3813,2004,1809
23199,88,96,2000,577,303,274
23200,88,81,2000,19054,10012,9042
23201,88,82,2000,2591,1362,1229
23202,88,83,2000,61563,32349,29214
23203,88,108,2000,780,410,370
23204,88,142,2000,77,40,37
23205,88,97,2000,492,259,233
23206,88,68,2000,311,163,148
23207,88,69,2000,1097,576,521
23208,88,98,2000,546,287,259
23209,88,110,2000,110,58,52
23210,88,85,2000,327,172,155
23211,88,99,2000,460,241,219
23212,88,5,2000,108,57,51
23213,88,17,2000,97,51,46
23214,88,57,2000,416,218,198
23215,88,86,2000,94,49,45
23216,88,177,2000,182,96,86
23217,88,18,2000,196,103,93
23218,88,20,2000,39,20,19
23219,88,100,2000,2703,1420,1283
23220,88,73,2000,59,31,28
23221,88,101,2000,509,267,242
23222,88,102,2000,1454,764,690
23223,88,112,2000,1132,595,537
23224,88,33,2000,40,21,19
23225,88,61,2000,76,40,36
23226,88,65,2000,3806,1999,1807
23227,88,93,2000,378,199,179
23228,88,26,2000,47,24,23
23229,88,50,2000,377,198,179
23230,88,1,2000,138,72,66
23231,22,2,2000,388,92,296
23232,22,13,2000,116,61,55
23233,22,3,2000,43402,6079,37323
23234,22,10,2000,980,282,698
23235,22,136,2000,6597,2757,3840
23236,22,120,2000,917,217,700
23237,22,119,2000,646,153,493
23238,22,68,2000,272,94,178
23239,22,5,2000,2769,658,2111
23240,22,18,2000,13750,6782,6968
23241,22,19,2000,6926,2027,4899
23242,22,20,2000,3162,760,2402
23243,22,144,2000,1315,312,1003
23244,22,8,2000,464,110,354
23245,22,73,2000,412,97,315
23246,22,162,2000,211,76,135
23247,22,9,2000,338,80,258
23248,22,23,2000,18792,5166,13626
23249,22,128,2000,233,66,167
23250,22,129,2000,615,146,469
23251,22,145,2000,3213,763,2450
23252,22,25,2000,531,126,405
23253,22,27,2000,38184,10288,27896
23254,22,146,2000,280,66,214
23255,22,26,2000,2335,554,1781
23256,22,142,2000,253,60,193
23257,22,50,2000,2070,626,1444
23258,22,28,2000,10626,2524,8102
23259,35,2,2000,0,0,0
23260,35,51,2000,675,360,315
23261,35,141,2000,7,1,6
23262,35,52,2000,0,0,0
23263,35,134,2000,0,0,0
23264,35,75,2000,0,0,0
23265,35,76,2000,0,0,0
23266,35,103,2000,8,4,4
23267,35,11,2000,1,0,1
23268,35,66,2000,536,252,284
23269,35,12,2000,0,0,0
23270,35,78,2000,0,0,0
23271,35,13,2000,0,0,0
23272,35,3,2000,7,1,6
23273,35,79,2000,0,0,0
23274,35,29,2000,45,23,22
23275,35,67,2000,235,102,133
23276,35,95,2000,0,0,0
23277,35,151,2000,0,0,0
23278,35,4,2000,0,0,0
23279,35,53,2000,122,63,59
23280,35,147,2000,0,0,0
23281,35,105,2000,4,1,3
23282,35,30,2000,19404,11128,8276
23283,35,152,2000,0,0,0
23284,35,116,2000,0,0,0
23285,35,153,2000,0,0,0
23286,35,135,2000,0,0,0
23287,35,80,2000,0,0,0
23288,35,136,2000,0,0,0
23289,35,106,2000,0,0,0
23290,35,172,2000,2100,891,1209
23291,35,107,2000,0,0,0
23292,35,117,2000,0,0,0
23293,35,137,2000,0,0,0
23294,35,96,2000,0,0,0
23295,35,54,2000,1543,762,781
23296,35,81,2000,1,0,1
23297,35,14,2000,48,27,21
23298,35,31,2000,546,338,208
23299,35,176,2000,0,0,0
23300,35,137,2000,0,0,0
23301,35,39,2000,53,23,30
23302,35,118,2000,0,0,0
23303,35,82,2000,0,0,0
23304,35,83,2000,0,0,0
23305,35,108,2000,0,0,0
23306,35,142,2000,20,7,13
23307,35,97,2000,0,0,0
23308,35,138,2000,0,0,0
23309,35,119,2000,0,0,0
23310,35,40,2000,0,0,0
23311,35,148,2000,0,0,0
23312,35,120,2000,0,0,0
23313,35,41,2000,0,0,0
23314,35,42,2000,102,66,36
23315,35,68,2000,942,384,558
23316,35,139,2000,0,0,0
23317,35,155,2000,0,0,0
23318,35,15,2000,0,0,0
23319,35,69,2000,2299,1112,1187
23320,35,156,2000,0,0,0
23321,35,55,2000,0,0,0
23322,35,56,2000,4321,2065,2256
23323,35,84,2000,0,0,0
23324,35,98,2000,0,0,0
23325,35,157,2000,1,0,1
23326,35,158,2000,0,0,0
23327,35,110,2000,0,0,0
23328,35,85,2000,0,0,0
23329,35,99,2000,0,0,0
23330,35,32,2000,5624,3536,2088
23331,35,43,2000,0,0,0
23332,35,5,2000,0,0,0
23333,35,6,2000,899,142,757
23334,35,16,2000,998,269,729
23335,35,44,2000,69,26,43
23336,35,45,2000,0,0,0
23337,35,17,2000,785,181,604
23338,35,57,2000,2469,557,1912
23339,35,86,2000,0,0,0
23340,35,177,2000,39,19,20
23341,35,18,2000,809,158,651
23342,35,167,2000,0,0,0
23343,35,121,2000,0,0,0
23344,35,19,2000,0,0,0
23345,35,168,2000,0,0,0
23346,35,46,2000,0,0,0
23347,35,20,2000,999,183,816
23348,35,159,2000,0,0,0
23349,35,143,2000,0,0,0
23350,35,70,2000,0,0,0
23351,35,47,2000,0,0,0
23352,35,71,2000,35,12,23
23353,35,122,2000,0,0,0
23354,35,123,2000,0,0,0
23355,35,7,2000,0,0,0
23356,35,160,2000,0,0,0
23357,35,58,2000,0,0,0
23358,35,161,2000,0,0,0
23359,35,124,2000,0,0,0
23360,35,100,2000,9,6,3
23361,35,72,2000,0,0,0
23362,35,59,2000,0,0,0
23363,35,144,2000,8,4,4
23364,35,125,2000,0,0,0
23365,35,150,2000,0,0,0
23366,35,8,2000,0,0,0
23367,35,73,2000,279,95,184
23368,35,101,2000,0,0,0
23369,35,162,2000,1,0,1
23370,35,60,2000,518,250,268
23371,35,48,2000,2,1,1
23372,35,21,2000,0,0,0
23373,35,9,2000,1,0,1
23374,35,102,2000,0,0,0
23375,35,111,2000,0,0,0
23376,35,112,2000,0,0,0
23377,35,33,2000,419,250,169
23378,35,61,2000,113,53,60
23379,35,22,2000,0,0,0
23380,35,36,2000,7654,5119,2535
23381,35,126,2000,0,0,0
23382,35,91,2000,0,0,0
23383,35,92,2000,0,0,0
23384,35,62,2000,0,0,0
23385,35,140,2000,0,0,0
23386,35,23,2000,6,1,5
23387,35,164,2000,0,0,0
23388,35,63,2000,1987,1045,942
23389,35,165,2000,0,0,0
23390,35,37,2000,277,160,117
23391,35,64,2000,0,0,0
23392,35,128,2000,0,0,0
23393,35,115,2000,0,0,0
23394,35,65,2000,213,97,116
23395,35,10,2000,1,0,1
23396,35,145,2000,0,0,0
23397,35,113,2000,0,0,0
23398,35,49,2000,89,38,51
23399,35,74,2000,63,34,29
23400,35,25,2000,7217,2980,4237
23401,35,169,2000,0,0,0
23402,35,166,2000,0,0,0
23403,35,93,2000,0,0,0
23404,35,146,2000,4,1,3
23405,35,26,2000,2797,503,2294
23406,35,170,2000,0,0,0
23407,35,130,2000,0,0,0
23408,35,38,2000,13688,8196,5492
23409,35,27,2000,4,0,4
23410,35,50,2000,439,157,282
23411,35,131,2000,0,0,0
23412,35,114,2000,0,0,0
23413,35,171,2000,0,0,0
23414,35,1,2000,8,2,6
23415,35,28,2000,0,0,0
23416,35,132,2000,0,0,0
23417,35,133,2000,0,0,0
23418,36,2,2000,11486,1590,9896
23419,36,51,2000,915,383,532
23420,36,141,2000,1033,357,676
23421,36,134,2000,404,135,269
23422,36,12,2000,841759,355269,486490
23423,36,103,2000,543,240,303
23424,36,66,2000,3894,1931,1963
23425,36,3,2000,753,89,664
23426,36,11,2000,478856,200912,277944
23427,36,67,2000,824,377,447
23428,36,53,2000,648,194,454
23429,36,147,2000,189,88,101
23430,36,105,2000,590,290,300
23431,36,30,2000,8749,3165,5584
23432,36,116,2000,153,64,89
23433,36,29,2000,930977,509837,421140
23434,36,135,2000,488,106,382
23435,36,153,2000,47,20,27
23436,36,10,2000,829,299,530
23437,36,136,2000,112,28,84
23438,36,106,2000,662,331,331
23439,36,172,2000,60177,25177,35000
23440,36,107,2000,249,74,175
23441,36,117,2000,13,4,9
23442,36,137,2000,341,85,256
23443,36,96,2000,33,15,18
23444,36,54,2000,250,61,189
23445,36,81,2000,2246,850,1396
23446,36,14,2000,437,189,248
23447,36,31,2000,13987,6861,7126
23448,36,151,2000,320,155,165
23449,36,39,2000,2556,1286,1270
23450,36,108,2000,280,106,174
23451,36,138,2000,37,22,15
23452,36,120,2000,293,66,227
23453,36,40,2000,67055,34585,32470
23454,36,42,2000,1994,1090,904
23455,36,68,2000,1436,670,766
23456,36,15,2000,625743,284484,341259
23457,36,69,2000,149414,74092,75322
23458,36,156,2000,231,82,149
23459,36,56,2000,1882,844,1038
23460,36,157,2000,351,129,222
23461,36,173,2000,34,14,20
23462,36,32,2000,18565,9086,9479
23463,36,43,2000,56,28,28
23464,36,5,2000,6072,994,5078
23465,36,6,2000,2461,854,1607
23466,36,16,2000,959,221,738
23467,36,44,2000,156,55,101
23468,36,17,2000,2345,869,1476
23469,36,57,2000,894,364,530
23470,36,177,2000,679,339,340
23471,36,167,2000,2571681,1349590,1222091
23472,36,18,2000,999,194,805
23473,36,121,2000,355,150,205
23474,36,176,2000,8456,3421,5035
23475,36,19,2000,170,41,129
23476,36,168,2000,461140,235666,225474
23477,36,20,2000,1225,120,1105
23478,36,46,2000,101991,52213,49778
23479,36,143,2000,339,145,194
23480,36,47,2000,85756,42665,43091
23481,36,71,2000,87,39,48
23482,36,122,2000,130,55,75
23483,36,123,2000,7,1,6
23484,36,7,2000,109,39,70
23485,36,160,2000,132,30,102
23486,36,58,2000,636,338,298
23487,36,124,2000,213,71,142
23488,36,100,2000,162,71,91
23489,36,72,2000,238,138,100
23490,36,59,2000,545,266,279
23491,36,144,2000,1220,310,910
23492,36,125,2000,96,38,58
23493,36,21,2000,40,8,32
23494,36,150,2000,82,27,55
23495,36,8,2000,395,98,297
23496,36,73,2000,368,175,193
23497,36,101,2000,60,23,37
23498,36,162,2000,876,272,604
23499,36,48,2000,1210,619,591
23500,36,9,2000,1002,131,871
23501,36,102,2000,61,19,42
23502,36,111,2000,126,71,55
23503,36,112,2000,595,189,406
23504,36,33,2000,33418,17126,16292
23505,36,61,2000,117,50,67
23506,36,158,2000,264,86,178
23507,36,22,2000,97,37,60
23508,36,35,2000,4477,2428,2049
23509,36,126,2000,154,62,92
23510,36,75,2000,286,129,157
23511,36,62,2000,41,25,16
23512,36,23,2000,229,65,164
23513,36,164,2000,100,44,56
23514,36,37,2000,1036,506,530
23515,36,1,2000,23695,6970,16725
23516,36,64,2000,113,41,72
23517,36,128,2000,109,42,67
23518,36,115,2000,229,102,127
23519,36,133,2000,243,106,137
23520,36,65,2000,831,394,437
23521,36,145,2000,361,56,305
23522,36,49,2000,324,147,177
23523,36,74,2000,415,204,211
23524,36,25,2000,3332,502,2830
23525,36,169,2000,381090,160539,220551
23526,36,27,2000,230,83,147
23527,36,146,2000,426,112,314
23528,36,26,2000,8962,2206,6756
23529,36,170,2000,174352,88084,86268
23530,36,130,2000,84,32,52
23531,36,38,2000,3541839,1833145,1708694
23532,36,60,2000,234,48,186
23533,36,142,2000,1425,646,779
23534,36,50,2000,800,333,467
23535,36,131,2000,211,71,140
23536,36,152,2000,592,320,272
23537,36,114,2000,500,251,249
23538,36,171,2000,913322,450223,463099
23539,36,28,2000,574,64,510
23540,36,132,2000,245,62,183
23541,126,116,2000,56107,25967,30140
23542,126,137,2000,163420,83820,79600
23543,126,121,2000,2218,930,1288
23544,126,130,2000,79241,38178,41063
23545,126,131,2000,36766,18313,18453
23546,90,76,2000,319,166,153
23547,90,78,2000,11,5,6
23548,90,79,2000,79,44,35
23549,90,82,2000,158,73,85
23550,90,84,2000,46,20,26
23551,90,110,2000,612,290,322
23552,90,86,2000,116,60,56
23553,90,87,2000,339,169,170
23554,90,91,2000,82,28,54
23555,90,92,2000,136,67,69
23556,90,93,2000,210,91,119
23557,91,76,2000,90,44,46
23558,91,66,2000,11,5,6
23559,91,78,2000,10,3,7
23560,91,79,2000,600,292,308
23561,91,67,2000,10,4,6
23562,91,105,2000,9,3,6
23563,91,95,2000,1,0,1
23564,91,80,2000,4,1,3
23565,91,172,2000,38,19,19
23566,91,81,2000,18,10,8
23567,91,82,2000,177,85,92
23568,91,83,2000,37,22,15
23569,91,120,2000,4,3,1
23570,91,68,2000,57,18,39
23571,91,109,2000,235,148,87
23572,91,69,2000,57,35,22
23573,91,156,2000,18,7,11
23574,91,84,2000,124,49,75
23575,91,98,2000,4,1,3
23576,91,110,2000,1522,875,647
23577,91,85,2000,28,13,15
23578,91,5,2000,90,35,55
23579,91,44,2000,19,9,10
23580,91,57,2000,13,7,6
23581,91,86,2000,144,85,59
23582,91,177,2000,20,16,4
23583,91,20,2000,8,5,3
23584,91,100,2000,8,7,1
23585,91,87,2000,25,13,12
23586,91,73,2000,16,5,11
23587,91,77,2000,14,9,5
23588,91,162,2000,10,7,3
23589,91,9,2000,14,7,7
23590,91,102,2000,22,10,12
23591,91,88,2000,13,3,10
23592,91,90,2000,34,19,15
23593,91,75,2000,29,16,13
23594,91,92,2000,336,188,148
23595,91,115,2000,8,3,5
23596,91,133,2000,1,0,1
23597,91,113,2000,33,19,14
23598,91,74,2000,10,4,6
23599,91,25,2000,22,5,17
23600,91,93,2000,602,313,289
23601,91,50,2000,751,394,357
23602,92,76,2000,55,25,30
23603,92,79,2000,328,142,186
23604,92,82,2000,81,47,34
23605,92,84,2000,408,239,169
23606,92,110,2000,226,128,98
23607,92,86,2000,119,60,59
23608,92,90,2000,37,27,10
23609,92,91,2000,224,133,91
23610,92,93,2000,907,460,447
23611,92,50,2000,748,365,383
23612,62,57,2000,3540,1515,2025
23613,62,51,2000,31,26,5
23614,62,33,2000,22,20,2
23615,62,35,2000,100,82,18
23616,62,38,2000,48,47,1
23617,62,36,2000,26,25,1
23618,62,68,2000,25,15,10
23619,62,103,2000,81,38,43
23620,62,105,2000,23,22,1
23621,140,134,2000,654,387,267
23622,140,153,2000,2488,1276,1212
23623,140,138,2000,268,168,100
23624,140,139,2000,436,127,309
23625,140,125,2000,213,34,179
23626,140,61,2000,218,105,113
23627,23,2,2000,175068,58061,117007
23628,23,3,2000,504790,127235,377555
23629,23,10,2000,211212,70049,141163
23630,23,120,2000,64252,21309,42943
23631,23,5,2000,978992,314945,664047
23632,23,16,2000,10177,4707,5470
23633,23,18,2000,95064,31528,63536
23634,23,20,2000,60237,19977,40260
23635,23,8,2000,187079,43431,143648
23636,23,9,2000,586225,180813,405412
23637,23,145,2000,188246,62432,125814
23638,23,25,2000,322050,138851,183199
23639,23,142,2000,376493,124865,251628
23640,23,28,2000,301194,104886,196308
23641,164,141,2000,3275,2217,1058
23642,164,105,2000,506,277,229
23643,164,135,2000,792,517,275
23644,164,137,2000,104,58,46
23645,164,151,2000,2820,1459,1361
23646,164,68,2000,10825,5522,5303
23647,164,155,2000,4029,2394,1635
23648,164,69,2000,682,360,322
23649,164,156,2000,1395,331,1064
23650,164,157,2000,40236,15551,24685
23651,164,20,2000,862,323,539
23652,164,159,2000,436,244,192
23653,164,160,2000,26917,12479,14438
23654,164,161,2000,59956,27084,32872
23655,164,144,2000,3219,1742,1477
23656,164,162,2000,663,185,478
23657,164,158,2000,23437,11727,11710
23658,164,126,2000,351,196,155
23659,164,23,2000,1183,619,564
23660,164,165,2000,11638,5591,6047
23661,164,166,2000,1308,464,844
23662,164,26,2000,0,0,0
23663,63,51,2000,495,399,96
23664,63,141,2000,56,21,35
23665,63,103,2000,52,35,17
23666,63,66,2000,7425,3773,3652
23667,63,11,2000,167,131,36
23668,63,67,2000,184,79,105
23669,63,53,2000,380524,202360,178164
23670,63,105,2000,72,44,28
23671,63,30,2000,1203,872,331
23672,63,29,2000,142,123,19
23673,63,172,2000,1870,844,1026
23674,63,54,2000,325449,176086,149363
23675,63,81,2000,30,15,15
23676,63,14,2000,183,83,100
23677,63,31,2000,545,377,168
23678,63,39,2000,155,78,77
23679,63,42,2000,35,20,15
23680,63,68,2000,2287,1183,1104
23681,63,15,2000,51,36,15
23682,63,69,2000,6826,3372,3454
23683,63,156,2000,30,11,19
23684,63,56,2000,970,485,485
23685,63,32,2000,1909,1270,639
23686,63,5,2000,312,178,134
23687,63,6,2000,68,7,61
23688,63,16,2000,187,64,123
23689,63,44,2000,55,26,29
23690,63,17,2000,115,56,59
23691,63,57,2000,1224,654,570
23692,63,177,2000,40,23,17
23693,63,167,2000,103,82,21
23694,63,18,2000,105,23,82
23695,63,19,2000,70,28,42
23696,63,20,2000,48,21,27
23697,63,143,2000,396,166,230
23698,63,47,2000,29,22,7
23699,63,71,2000,96,37,59
23700,63,58,2000,56,27,29
23701,63,100,2000,27,16,11
23702,63,59,2000,88070,51888,36182
23703,63,144,2000,34,22,12
23704,63,73,2000,797,376,421
23705,63,48,2000,58,26,32
23706,63,112,2000,52,33,19
23707,63,33,2000,704,610,94
23708,63,61,2000,40,16,24
23709,63,35,2000,3828,3209,619
23710,63,36,2000,3123,2274,849
23711,63,37,2000,505,364,141
23712,63,64,2000,11597,6468,5129
23713,63,115,2000,90,56,34
23714,63,133,2000,29,17,12
23715,63,65,2000,167,74,93
23716,63,49,2000,1264,622,642
23717,63,74,2000,3030,1452,1578
23718,63,25,2000,129,25,104
23719,63,27,2000,25,13,12
23720,63,146,2000,41,11,30
23721,63,26,2000,411,133,278
23722,63,170,2000,30,24,6
23723,63,38,2000,1352,1144,208
23724,63,60,2000,52051,31314,20737
23725,63,142,2000,81,27,54
23726,63,50,2000,686,320,366
23727,63,171,2000,84,77,7
23728,63,132,2000,60,32,28
23729,127,3,2000,17,5,12
23730,127,67,2000,20,3,17
23731,127,10,2000,467,153,314
23732,127,172,2000,103,14,89
23733,127,81,2000,33,14,19
23734,127,68,2000,154,64,90
23735,127,69,2000,57,27,30
23736,127,5,2000,2026,412,1614
23737,127,57,2000,37,14,23
23738,127,121,2000,331,229,102
23739,127,122,2000,525,485,40
23740,127,7,2000,1,1,0
23741,127,124,2000,509,185,324
23742,127,8,2000,39,30,9
23743,127,162,2000,40,15,25
23744,127,9,2000,11,7,4
23745,127,36,2000,11,6,5
23746,127,128,2000,15,4,11
23747,127,115,2000,366,70,296
23748,127,65,2000,10,7,3
23749,127,130,2000,6,5,1
23750,127,50,2000,173,70,103
23751,165,153,2000,3,2,1
23752,165,136,2000,1,0,1
23753,165,172,2000,266,7,259
23754,165,137,2000,0,0,0
23755,165,151,2000,248,160,88
23756,165,138,2000,1,0,1
23757,165,119,2000,0,0,0
23758,165,155,2000,4984,2400,2584
23759,165,69,2000,127,61,66
23760,165,156,2000,1242,428,814
23761,165,157,2000,70385,30725,39660
23762,165,5,2000,385,161,224
23763,165,16,2000,0,0,0
23764,165,177,2000,5,4,1
23765,165,121,2000,0,0,0
23766,165,176,2000,5,1,4
23767,165,20,2000,2083,1045,1038
23768,165,159,2000,10813,5522,5291
23769,165,160,2000,1857,877,980
23770,165,161,2000,134,34,100
23771,165,162,2000,2012,763,1249
23772,165,9,2000,0,0,0
23773,165,158,2000,22,8,14
23774,165,36,2000,71,50,21
23775,165,126,2000,0,0,0
23776,165,164,2000,700,248,452
23777,165,1,2000,1,0,1
23778,165,115,2000,227,188,39
23779,165,145,2000,1,0,1
23780,165,166,2000,39,14,25
23781,165,50,2000,580,266,314
23782,165,152,2000,33,13,20
23783,165,132,2000,0,0,0
23784,37,2,2000,315,39,276
23785,37,51,2000,60,9,51
23786,37,141,2000,66,11,55
23787,37,52,2000,0,0,0
23788,37,134,2000,16,1,15
23789,37,103,2000,54,31,23
23790,37,11,2000,94,47,47
23791,37,77,2000,0,0,0
23792,37,66,2000,2070,930,1140
23793,37,12,2000,23,15,8
23794,37,13,2000,0,0,0
23795,37,3,2000,0,0,0
23796,37,79,2000,0,0,0
23797,37,29,2000,140,107,33
23798,37,67,2000,529,215,314
23799,37,95,2000,0,0,0
23800,37,151,2000,0,0,0
23801,37,53,2000,257,83,174
23802,37,147,2000,0,0,0
23803,37,105,2000,66,43,23
23804,37,30,2000,1437,521,916
23805,37,152,2000,0,0,0
23806,37,116,2000,0,0,0
23807,37,135,2000,0,0,0
23808,37,80,2000,0,0,0
23809,37,136,2000,91,58,33
23810,37,106,2000,17,7,10
23811,37,172,2000,681,356,325
23812,37,107,2000,34,9,25
23813,37,137,2000,14,5,9
23814,37,96,2000,0,0,0
23815,37,54,2000,527,199,328
23816,37,81,2000,90,26,64
23817,37,14,2000,69,31,38
23818,37,31,2000,58709,35798,22911
23819,37,176,2000,0,0,0
23820,37,137,2000,0,0,0
23821,37,39,2000,158,59,99
23822,37,82,2000,0,0,0
23823,37,83,2000,0,0,0
23824,37,108,2000,22,9,13
23825,37,142,2000,118,5,113
23826,37,97,2000,0,0,0
23827,37,40,2000,33,25,8
23828,37,148,2000,0,0,0
23829,37,120,2000,19,5,14
23830,37,41,2000,0,0,0
23831,37,42,2000,98,48,50
23832,37,68,2000,1952,1030,922
23833,37,155,2000,0,0,0
23834,37,15,2000,51,21,30
23835,37,69,2000,3067,1129,1938
23836,37,156,2000,12,2,10
23837,37,56,2000,262,99,163
23838,37,84,2000,0,0,0
23839,37,98,2000,0,0,0
23840,37,157,2000,0,0,0
23841,37,158,2000,0,0,0
23842,37,85,2000,0,0,0
23843,37,99,2000,0,0,0
23844,37,32,2000,11565,6717,4848
23845,37,43,2000,30,17,13
23846,37,5,2000,97,29,68
23847,37,6,2000,93,29,64
23848,37,16,2000,49,8,41
23849,37,44,2000,530,268,262
23850,37,45,2000,0,0,0
23851,37,17,2000,118,40,78
23852,37,57,2000,1764,493,1271
23853,37,86,2000,0,0,0
23854,37,177,2000,88,56,32
23855,37,18,2000,36,6,30
23856,37,167,2000,158,91,67
23857,37,121,2000,16,9,7
23858,37,19,2000,47,14,33
23859,37,168,2000,15,8,7
23860,37,46,2000,88,56,32
23861,37,20,2000,68,9,59
23862,37,149,2000,0,0,0
23863,37,159,2000,0,0,0
23864,37,143,2000,35,8,27
23865,37,70,2000,0,0,0
23866,37,47,2000,87,58,29
23867,37,71,2000,32,17,15
23868,37,122,2000,0,0,0
23869,37,123,2000,0,0,0
23870,37,7,2000,0,0,0
23871,37,58,2000,14,5,9
23872,37,124,2000,0,0,0
23873,37,100,2000,53,18,35
23874,37,72,2000,0,0,0
23875,37,59,2000,24,9,15
23876,37,144,2000,33,5,28
23877,37,125,2000,0,0,0
23878,37,150,2000,0,0,0
23879,37,8,2000,0,0,0
23880,37,73,2000,360,116,244
23881,37,101,2000,0,0,0
23882,37,162,2000,69,4,65
23883,37,60,2000,473,165,308
23884,37,48,2000,447,268,179
23885,37,21,2000,0,0,0
23886,37,9,2000,93,31,62
23887,37,102,2000,0,0,0
23888,37,111,2000,0,0,0
23889,37,112,2000,35,12,23
23890,37,33,2000,4425,2694,1731
23891,37,61,2000,104,36,68
23892,37,22,2000,0,0,0
23893,37,35,2000,5353,2274,3079
23894,37,36,2000,1819,1316,503
23895,37,126,2000,0,0,0
23896,37,90,2000,0,0,0
23897,37,91,2000,0,0,0
23898,37,62,2000,0,0,0
23899,37,140,2000,0,0,0
23900,37,23,2000,22,0,22
23901,37,164,2000,0,0,0
23902,37,63,2000,1230,503,727
23903,37,127,2000,0,0,0
23904,37,165,2000,0,0,0
23905,37,64,2000,203,68,135
23906,37,128,2000,0,0,0
23907,37,115,2000,70,23,47
23908,37,65,2000,537,264,273
23909,37,10,2000,0,0,0
23910,37,145,2000,0,0,0
23911,37,49,2000,167,75,92
23912,37,74,2000,407,186,221
23913,37,25,2000,148,30,118
23914,37,169,2000,0,0,0
23915,37,166,2000,0,0,0
23916,37,93,2000,0,0,0
23917,37,146,2000,94,7,87
23918,37,26,2000,201,36,165
23919,37,170,2000,0,0,0
23920,37,130,2000,0,0,0
23921,37,38,2000,6561,4492,2069
23922,37,27,2000,43,17,26
23923,37,50,2000,3211,1549,1662
23924,37,131,2000,0,0,0
23925,37,114,2000,0,0,0
23926,37,171,2000,29,18,11
23927,37,1,2000,1381,609,772
23928,37,28,2000,22,3,19
23929,37,132,2000,0,0,0
23930,37,133,2000,0,0,0
23931,64,2,2000,0,0,0
23932,64,51,2000,76,31,45
23933,64,141,2000,25,7,18
23934,64,134,2000,0,0,0
23935,64,103,2000,163,80,83
23936,64,11,2000,0,0,0
23937,64,77,2000,0,0,0
23938,64,66,2000,5745,3235,2510
23939,64,12,2000,0,0,0
23940,64,78,2000,0,0,0
23941,64,3,2000,3,1,2
23942,64,79,2000,0,0,0
23943,64,29,2000,31,21,10
23944,64,67,2000,317,166,151
23945,64,95,2000,0,0,0
23946,64,151,2000,0,0,0
23947,64,53,2000,77361,34589,42772
23948,64,147,2000,0,0,0
23949,64,105,2000,20,13,7
23950,64,30,2000,183,48,135
23951,64,152,2000,1,0,1
23952,64,116,2000,0,0,0
23953,64,153,2000,0,0,0
23954,64,135,2000,3,1,2
23955,64,136,2000,0,0,0
23956,64,106,2000,16,10,6
23957,64,172,2000,201,79,122
23958,64,107,2000,4,2,2
23959,64,117,2000,0,0,0
23960,64,137,2000,2,0,2
23961,64,96,2000,1,1,0
23962,64,54,2000,59921,29875,30046
23963,64,81,2000,3,2,1
23964,64,14,2000,4,2,2
23965,64,31,2000,460,321,139
23966,64,176,2000,0,0,0
23967,64,137,2000,1,0,1
23968,64,39,2000,32,17,15
23969,64,82,2000,0,0,0
23970,64,83,2000,1,1,0
23971,64,108,2000,16,2,14
23972,64,142,2000,51,19,32
23973,64,97,2000,0,0,0
23974,64,119,2000,0,0,0
23975,64,40,2000,3,0,3
23976,64,120,2000,13,9,4
23977,64,42,2000,11,7,4
23978,64,68,2000,1698,918,780
23979,64,139,2000,2,0,2
23980,64,155,2000,1,0,1
23981,64,15,2000,11,3,8
23982,64,69,2000,12368,6343,6025
23983,64,156,2000,13,6,7
23984,64,56,2000,57,27,30
23985,64,98,2000,0,0,0
23986,64,157,2000,6,0,6
23987,64,158,2000,1,0,1
23988,64,110,2000,0,0,0
23989,64,85,2000,0,0,0
23990,64,99,2000,1,1,0
23991,64,32,2000,398,255,143
23992,64,43,2000,10,5,5
23993,64,5,2000,19,8,11
23994,64,6,2000,30,15,15
23995,64,16,2000,46,12,34
23996,64,44,2000,5,4,1
23997,64,17,2000,19,3,16
23998,64,57,2000,4809,2635,2174
23999,64,86,2000,2,0,2
24000,64,177,2000,30,16,14
24001,64,18,2000,53,16,37
24002,64,167,2000,1,1,0
24003,64,121,2000,19,12,7
24004,64,19,2000,2,0,2
24005,64,168,2000,0,0,0
24006,64,46,2000,8,7,1
24007,64,20,2000,25,6,19
24008,64,159,2000,0,0,0
24009,64,143,2000,38,19,19
24010,64,70,2000,14,8,6
24011,64,47,2000,2,1,1
24012,64,71,2000,28,17,11
24013,64,122,2000,1,1,0
24014,64,123,2000,2,2,0
24015,64,7,2000,0,0,0
24016,64,160,2000,2,0,2
24017,64,58,2000,1,1,0
24018,64,161,2000,1,0,1
24019,64,124,2000,0,0,0
24020,64,100,2000,12,6,6
24021,64,59,2000,0,0,0
24022,64,87,2000,0,0,0
24023,64,144,2000,9,2,7
24024,64,125,2000,0,0,0
24025,64,150,2000,0,0,0
24026,64,8,2000,5,1,4
24027,64,73,2000,327,161,166
24028,64,101,2000,0,0,0
24029,64,162,2000,8,4,4
24030,64,60,2000,8231,2418,5813
24031,64,48,2000,9,7,2
24032,64,21,2000,1,1,0
24033,64,9,2000,13,6,7
24034,64,102,2000,0,0,0
24035,64,111,2000,0,0,0
24036,64,112,2000,12,4,8
24037,64,33,2000,254,194,60
24038,64,61,2000,13,9,4
24039,64,22,2000,0,0,0
24040,64,35,2000,135,94,41
24041,64,36,2000,664,473,191
24042,64,126,2000,0,0,0
24043,64,62,2000,0,0,0
24044,64,140,2000,0,0,0
24045,64,23,2000,3,0,3
24046,64,164,2000,2,1,1
24047,64,63,2000,29945,13240,16705
24048,64,165,2000,0,0,0
24049,64,37,2000,65,12,53
24050,64,128,2000,1,0,1
24051,64,115,2000,27,18,9
24052,64,65,2000,30,20,10
24053,64,10,2000,7,2,5
24054,64,145,2000,14,5,9
24055,64,113,2000,0,0,0
24056,64,49,2000,399,203,196
24057,64,74,2000,1330,655,675
24058,64,25,2000,27,4,23
24059,64,169,2000,0,0,0
24060,64,166,2000,0,0,0
24061,64,93,2000,0,0,0
24062,64,146,2000,9,2,7
24063,64,26,2000,26,12,14
24064,64,170,2000,0,0,0
24065,64,130,2000,2,0,2
24066,64,38,2000,438,273,165
24067,64,27,2000,2,1,1
24068,64,50,2000,201,98,103
24069,64,131,2000,3,1,2
24070,64,114,2000,5,2,3
24071,64,171,2000,4,4,0
24072,64,1,2000,0,0,0
24073,64,28,2000,6,1,5
24074,64,132,2000,6,2,4
24075,64,133,2000,4,1,3
24076,128,120,2000,555,262,293
24077,128,119,2000,0,0,0
24078,128,28,2000,0,0,0
24079,115,2,2000,30,10,20
24080,115,51,2000,69,38,31
24081,115,141,2000,188,46,142
24082,115,134,2000,15785,6270,9515
24083,115,103,2000,996,506,490
24084,115,66,2000,2265,946,1319
24085,115,13,2000,70,58,12
24086,115,3,2000,1064,238,826
24087,115,79,2000,13,2,11
24088,115,29,2000,101,50,51
24089,115,67,2000,3340,1522,1818
24090,115,151,2000,82,26,56
24091,115,53,2000,79,40,39
24092,115,147,2000,17593,6314,11279
24093,115,105,2000,1233,634,599
24094,115,30,2000,1653,762,891
24095,115,116,2000,1543,524,1019
24096,115,135,2000,992,274,718
24097,115,106,2000,281,130,151
24098,115,172,2000,9841,4207,5634
24099,115,107,2000,249,154,95
24100,115,117,2000,83,12,71
24101,115,137,2000,7885,2926,4959
24102,115,54,2000,428,196,232
24103,115,81,2000,645,262,383
24104,115,14,2000,2065,980,1085
24105,115,31,2000,838,372,466
24106,115,176,2000,58,44,14
24107,115,137,2000,8332,3443,4889
24108,115,39,2000,1062,488,574
24109,115,142,2000,1942,868,1074
24110,115,119,2000,225,88,137
24111,115,40,2000,61,12,49
24112,115,120,2000,1242,486,756
24113,115,42,2000,273,188,85
24114,115,68,2000,3182,1518,1664
24115,115,139,2000,131,54,77
24116,115,69,2000,23826,11663,12163
24117,115,156,2000,2797,886,1911
24118,115,55,2000,23,6,17
24119,115,56,2000,3794,1662,2132
24120,115,98,2000,38,12,26
24121,115,157,2000,33,12,21
24122,115,158,2000,13,8,5
24123,115,110,2000,24,12,12
24124,115,173,2000,679,326,353
24125,115,43,2000,14,2,12
24126,115,5,2000,16920,7688,9232
24127,115,6,2000,295,138,157
24128,115,16,2000,68,14,54
24129,115,44,2000,5085,2734,2351
24130,115,17,2000,1877,858,1019
24131,115,57,2000,9798,4375,5423
24132,115,86,2000,82,46,36
24133,115,177,2000,735,384,351
24134,115,18,2000,24,10,14
24135,115,121,2000,6894,3641,3253
24136,115,19,2000,38,10,28
24137,115,168,2000,0,0,0
24138,115,46,2000,176,56,120
24139,115,20,2000,389,174,215
24140,115,149,2000,113578,49754,63824
24141,115,159,2000,254,124,130
24142,115,143,2000,69,12,57
24143,115,47,2000,169,92,77
24144,115,71,2000,12,8,4
24145,115,122,2000,181,100,81
24146,115,123,2000,26025,5051,20974
24147,115,7,2000,24,8,16
24148,115,160,2000,45,20,25
24149,115,58,2000,144,94,50
24150,115,124,2000,3573,1670,1903
24151,115,100,2000,120,62,58
24152,115,72,2000,11,2,9
24153,115,144,2000,456,156,300
24154,115,125,2000,237813,64815,172998
24155,115,150,2000,44274,21979,22295
24156,115,8,2000,53,20,33
24157,115,73,2000,8450,3725,4725
24158,115,101,2000,46,28,18
24159,115,162,2000,6932,1212,5720
24160,115,48,2000,468,268,200
24161,115,21,2000,14,6,8
24162,115,9,2000,4181,842,3339
24163,115,102,2000,25,12,13
24164,115,111,2000,50,24,26
24165,115,112,2000,86,36,50
24166,115,33,2000,4141,1972,2169
24167,115,61,2000,19048,8678,10370
24168,115,35,2000,680,344,336
24169,115,36,2000,1427,710,717
24170,115,126,2000,1311,608,703
24171,115,90,2000,11,4,7
24172,115,23,2000,260,116,144
24173,115,164,2000,1157,96,1061
24174,115,63,2000,1600,752,848
24175,115,127,2000,280,162,118
24176,115,165,2000,166,40,126
24177,115,37,2000,177,46,131
24178,115,128,2000,6302,2970,3332
24179,115,65,2000,613,286,327
24180,115,10,2000,415,190,225
24181,115,145,2000,1205,502,703
24182,115,148,2000,31743,13776,17967
24183,115,49,2000,102,42,60
24184,115,74,2000,826,428,398
24185,115,25,2000,49,24,25
24186,115,60,2000,51,12,39
24187,115,93,2000,11,6,5
24188,115,146,2000,48,22,26
24189,115,26,2000,475,160,315
24190,115,130,2000,1991,768,1223
24191,115,38,2000,1600,842,758
24192,115,27,2000,76,36,40
24193,115,50,2000,125874,63616,62258
24194,115,131,2000,3911,1284,2627
24195,115,114,2000,48,12,36
24196,115,1,2000,68,38,30
24197,115,28,2000,35,16,19
24198,115,132,2000,23416,11787,11629
24199,115,133,2000,128983,55278,73705
24200,129,136,2000,0,0,0
24201,129,137,2000,0,0,0
24202,129,142,2000,0,0,0
24203,129,119,2000,0,0,0
24204,129,120,2000,0,0,0
24205,129,5,2000,0,0,0
24206,129,121,2000,0,0,0
24207,129,143,2000,0,0,0
24208,129,160,2000,0,0,0
24209,129,162,2000,0,0,0
24210,129,145,2000,0,0,0
24211,129,130,2000,0,0,0
24212,65,2,2000,455,129,326
24213,65,51,2000,712,329,383
24214,65,141,2000,19360,6702,12658
24215,65,52,2000,3717,1917,1800
24216,65,134,2000,2524,1115,1409
24217,65,103,2000,79339,40012,39327
24218,65,11,2000,1315,603,712
24219,65,66,2000,5548,2914,2634
24220,65,12,2000,655,331,324
24221,65,78,2000,116,51,65
24222,65,13,2000,72,24,48
24223,65,3,2000,693,142,551
24224,65,79,2000,72,36,36
24225,65,29,2000,300,185,115
24226,65,67,2000,32533,16563,15970
24227,65,95,2000,66,32,34
24228,65,151,2000,91,33,58
24229,65,53,2000,1466,705,761
24230,65,105,2000,28179,16867,11312
24231,65,30,2000,3678,1710,1968
24232,65,152,2000,347,133,214
24233,65,116,2000,103,38,65
24234,65,153,2000,2441,1422,1019
24235,65,135,2000,1239,518,721
24236,65,136,2000,141,43,98
24237,65,106,2000,22607,12022,10585
24238,65,172,2000,2138,986,1152
24239,65,107,2000,40145,25349,14796
24240,65,137,2000,623,181,442
24241,65,96,2000,1249,677,572
24242,65,54,2000,630,291,339
24243,65,81,2000,45738,25468,20270
24244,65,14,2000,254,119,135
24245,65,31,2000,1645,1003,642
24246,65,176,2000,334,151,183
24247,65,137,2000,1688,649,1039
24248,65,39,2000,7156,3738,3418
24249,65,118,2000,41,12,29
24250,65,82,2000,634,451,183
24251,65,83,2000,36953,26600,10353
24252,65,108,2000,24472,13426,11046
24253,65,142,2000,2041,634,1407
24254,65,97,2000,2307,1484,823
24255,65,138,2000,12201,6942,5259
24256,65,119,2000,128,47,81
24257,65,40,2000,124,75,49
24258,65,120,2000,305,128,177
24259,65,42,2000,6598,3665,2933
24260,65,68,2000,174641,91253,83388
24261,65,139,2000,415,202,213
24262,65,155,2000,5866,1648,4218
24263,65,15,2000,523,242,281
24264,65,69,2000,160472,80864,79608
24265,65,156,2000,1354,335,1019
24266,65,56,2000,1321,521,800
24267,65,84,2000,1095,514,581
24268,65,98,2000,1977,1249,728
24269,65,157,2000,4551,2103,2448
24270,65,158,2000,1574,274,1300
24271,65,110,2000,168,96,72
24272,65,85,2000,704,313,391
24273,65,99,2000,2515,1692,823
24274,65,32,2000,1285,735,550
24275,65,43,2000,414,229,185
24276,65,5,2000,8210,3772,4438
24277,65,6,2000,3477,1305,2172
24278,65,16,2000,1274,444,830
24279,65,44,2000,4329,2279,2050
24280,65,17,2000,1280,433,847
24281,65,57,2000,26797,9930,16867
24282,65,86,2000,378,211,167
24283,65,177,2000,3286,1674,1612
24284,65,18,2000,1689,359,1330
24285,65,167,2000,43,30,13
24286,65,121,2000,507,277,230
24287,65,19,2000,767,284,483
24288,65,168,2000,324,190,134
24289,65,46,2000,190,101,89
24290,65,20,2000,2320,603,1717
24291,65,159,2000,1495,327,1168
24292,65,143,2000,1428,483,945
24293,65,70,2000,133,80,53
24294,65,47,2000,217,114,103
24295,65,71,2000,1245,635,610
24296,65,122,2000,734,471,263
24297,65,123,2000,72,34,38
24298,65,160,2000,1373,146,1227
24299,65,58,2000,195,107,88
24300,65,161,2000,2103,399,1704
24301,65,124,2000,359,159,200
24302,65,100,2000,18686,10549,8137
24303,65,72,2000,154,73,81
24304,65,59,2000,0,0,0
24305,65,144,2000,266706,104937,161769
24306,65,125,2000,1854,948,906
24307,65,150,2000,151,86,65
24308,65,8,2000,119,58,61
24309,65,73,2000,27629,14163,13466
24310,65,101,2000,2013,1128,885
24311,65,162,2000,3876,924,2952
24312,65,60,2000,159,68,91
24313,65,48,2000,6665,3531,3134
24314,65,21,2000,41,18,23
24315,65,9,2000,5531,1125,4406
24316,65,102,2000,2185,1201,984
24317,65,111,2000,1744,1020,724
24318,65,112,2000,42184,24588,17596
24319,65,33,2000,9707,4838,4869
24320,65,61,2000,65690,32738,32952
24321,65,22,2000,99,40,59
24322,65,35,2000,8489,3868,4621
24323,65,36,2000,8300,4697,3603
24324,65,126,2000,444,143,301
24325,65,91,2000,81,43,38
24326,65,62,2000,18,8,10
24327,65,140,2000,272,135,137
24328,65,23,2000,316,115,201
24329,65,164,2000,7783,1479,6304
24330,65,63,2000,0,0,0
24331,65,127,2000,79,53,26
24332,65,165,2000,739,163,576
24333,65,37,2000,406,212,194
24334,65,64,2000,217,126,91
24335,65,128,2000,349,100,249
24336,65,115,2000,1483,721,762
24337,65,10,2000,838,346,492
24338,65,145,2000,665,180,485
24339,65,113,2000,222,133,89
24340,65,49,2000,11761,6509,5252
24341,65,74,2000,58838,28935,29903
24342,65,25,2000,3531,875,2656
24343,65,169,2000,41,22,19
24344,65,166,2000,119,32,87
24345,65,93,2000,253,149,104
24346,65,146,2000,1172,387,785
24347,65,26,2000,981,324,657
24348,65,170,2000,27,22,5
24349,65,130,2000,214,106,108
24350,65,38,2000,2115,1160,955
24351,65,27,2000,266,122,144
24352,65,50,2000,118972,61236,57736
24353,65,131,2000,0,0,0
24354,65,114,2000,19920,9925,9995
24355,65,171,2000,499,276,223
24356,65,1,2000,665,344,321
24357,65,28,2000,56,12,44
24358,65,132,2000,247,131,116
24359,65,133,2000,424,202,222
24360,10,2,2000,31,9,22
24361,10,13,2000,97,29,68
24362,10,3,2000,164,28,136
24363,10,4,2000,56,15,41
24364,10,172,2000,588,54,534
24365,10,14,2000,61,18,43
24366,10,42,2000,14,6,8
24367,10,68,2000,107,38,69
24368,10,69,2000,147,44,103
24369,10,56,2000,22,6,16
24370,10,85,2000,8,3,5
24371,10,5,2000,31618,15352,16266
24372,10,6,2000,25,6,19
24373,10,16,2000,9,2,7
24374,10,17,2000,12,2,10
24375,10,57,2000,1273,390,883
24376,10,177,2000,207,68,139
24377,10,18,2000,67,22,45
24378,10,19,2000,430,142,288
24379,10,20,2000,181,59,122
24380,10,143,2000,9,2,7
24381,10,7,2000,370,130,240
24382,10,21,2000,81,27,54
24383,10,8,2000,84,18,66
24384,10,48,2000,28,8,20
24385,10,9,2000,324,120,204
24386,10,61,2000,2,1,1
24387,10,22,2000,67,19,48
24388,10,36,2000,36,13,23
24389,10,23,2000,321,102,219
24390,10,127,2000,5,1,4
24391,10,115,2000,64,24,40
24392,10,65,2000,8,3,5
24393,10,49,2000,51,17,34
24394,10,74,2000,73,22,51
24395,10,25,2000,17,5,12
24396,10,27,2000,413,130,283
24397,10,26,2000,10,3,7
24398,10,142,2000,31,6,25
24399,10,50,2000,317,104,213
24400,145,136,2000,72615,35248,37367
24401,145,172,2000,1746,845,901
24402,145,137,2000,12378,5989,6389
24403,145,120,2000,123478,60635,62843
24404,145,119,2000,435158,220165,214993
24405,145,5,2000,2351,1137,1214
24406,145,121,2000,6367,3080,3287
24407,145,143,2000,2492,1209,1283
24408,145,160,2000,1101,533,568
24409,145,162,2000,24143,11681,12462
24410,145,128,2000,43,24,19
24411,145,129,2000,0,0,0
24412,145,130,2000,47612,23344,24268
24413,145,142,2000,22327,10802,11525
24414,113,105,2000,3204,1469,1735
24415,113,172,2000,3135,1438,1697
24416,113,110,2000,7802,3578,4224
24417,113,73,2000,2002,918,1084
24418,49,2,2000,4287,1909,2378
24419,49,51,2000,374,172,202
24420,49,141,2000,1681,571,1110
24421,49,52,2000,1,1,0
24422,49,134,2000,433,239,194
24423,49,76,2000,6,2,4
24424,49,103,2000,2435,1228,1207
24425,49,11,2000,341,180,161
24426,49,66,2000,6021,2659,3362
24427,49,12,2000,189,135,54
24428,49,78,2000,16,3,13
24429,49,13,2000,54,21,33
24430,49,3,2000,2937,1360,1577
24431,49,79,2000,101,29,72
24432,49,29,2000,449,298,151
24433,49,67,2000,1201,589,612
24434,49,95,2000,5,0,5
24435,49,151,2000,22,9,13
24436,49,4,2000,10,2,8
24437,49,53,2000,51526,25946,25580
24438,49,147,2000,49,32,17
24439,49,105,2000,3496,2180,1316
24440,49,30,2000,3508,1834,1674
24441,49,152,2000,34,12,22
24442,49,116,2000,83,39,44
24443,49,153,2000,294,161,133
24444,49,135,2000,108,36,72
24445,49,136,2000,28,6,22
24446,49,106,2000,26842,13425,13417
24447,49,172,2000,8150,4830,3320
24448,49,173,2000,561,324,237
24449,49,107,2000,7317,3425,3892
24450,49,117,2000,9,4,5
24451,49,137,2000,160,75,85
24452,49,96,2000,207,110,97
24453,49,54,2000,5229,2544,2685
24454,49,81,2000,1489,616,873
24455,49,14,2000,453,168,285
24456,49,31,2000,321,211,110
24457,49,176,2000,56,17,39
24458,49,137,2000,999,443,556
24459,49,39,2000,38190,18407,19783
24460,49,118,2000,57,34,23
24461,49,82,2000,46,22,24
24462,49,83,2000,245,122,123
24463,49,108,2000,950,464,486
24464,49,142,2000,2085,751,1334
24465,49,97,2000,2332,1117,1215
24466,49,138,2000,11,8,3
24467,49,119,2000,3054,1453,1601
24468,49,40,2000,10253,5836,4417
24469,49,148,2000,16,10,6
24470,49,120,2000,11907,5553,6354
24471,49,42,2000,195447,113961,81486
24472,49,68,2000,5602,2333,3269
24473,49,139,2000,4,0,4
24474,49,155,2000,2501,1019,1482
24475,49,15,2000,132,78,54
24476,49,69,2000,38155,21190,16965
24477,49,156,2000,981,408,573
24478,49,55,2000,0,0,0
24479,49,56,2000,10851,4363,6488
24480,49,84,2000,40,6,34
24481,49,98,2000,658,311,347
24482,49,157,2000,112,44,68
24483,49,158,2000,78,30,48
24484,49,110,2000,106,66,40
24485,49,85,2000,107,47,60
24486,49,99,2000,210,106,104
24487,49,32,2000,14127,6935,7192
24488,49,43,2000,3530,1743,1787
24489,49,5,2000,11110,6674,4436
24490,49,6,2000,51101,23401,27700
24491,49,16,2000,49372,21546,27826
24492,49,44,2000,1108,433,675
24493,49,17,2000,1517,592,925
24494,49,57,2000,6337,2055,4282
24495,49,86,2000,195,81,114
24496,49,177,2000,2283,1348,935
24497,49,18,2000,1068,466,602
24498,49,167,2000,173,119,54
24499,49,121,2000,1267,710,557
24500,49,19,2000,809,380,429
24501,49,168,2000,46,36,10
24502,49,46,2000,2305,1375,930
24503,49,20,2000,20038,8992,11046
24504,49,149,2000,21,15,6
24505,49,159,2000,558,292,266
24506,49,143,2000,374,136,238
24507,49,70,2000,2,2,0
24508,49,47,2000,785,466,319
24509,49,71,2000,120,64,56
24510,49,122,2000,73,50,23
24511,49,123,2000,40,19,21
24512,49,7,2000,7,4,3
24513,49,160,2000,51,10,41
24514,49,58,2000,87,41,46
24515,49,161,2000,20,2,18
24516,49,124,2000,133,87,46
24517,49,100,2000,1079,584,495
24518,49,72,2000,15,3,12
24519,49,59,2000,0,0,0
24520,49,144,2000,4492,1827,2665
24521,49,125,2000,196,125,71
24522,49,150,2000,48,22,26
24523,49,8,2000,154,72,82
24524,49,73,2000,4532,1918,2614
24525,49,101,2000,404,238,166
24526,49,162,2000,701,200,501
24527,49,60,2000,2362,1130,1232
24528,49,48,2000,42464,25037,17427
24529,49,21,2000,7,5,2
24530,49,9,2000,3100,1371,1729
24531,49,102,2000,201,99,102
24532,49,111,2000,130,69,61
24533,49,112,2000,4531,2376,2155
24534,49,33,2000,40123,26309,13814
24535,49,61,2000,2514,1142,1372
24536,49,22,2000,23,13,10
24537,49,35,2000,11776,6417,5359
24538,49,36,2000,6523,4331,2192
24539,49,126,2000,113,55,58
24540,49,90,2000,2,1,1
24541,49,91,2000,29,9,20
24542,49,92,2000,12,2,10
24543,49,62,2000,6,2,4
24544,49,140,2000,7,2,5
24545,49,23,2000,836,407,429
24546,49,164,2000,230,94,136
24547,49,63,2000,0,0,0
24548,49,127,2000,47,34,13
24549,49,165,2000,217,98,119
24550,49,37,2000,243,159,84
24551,49,64,2000,683,315,368
24552,49,128,2000,13082,6204,6878
24553,49,115,2000,1016,445,571
24554,49,129,2000,0,0,0
24555,49,65,2000,5079,2088,2991
24556,49,10,2000,5854,3304,2550
24557,49,145,2000,710,314,396
24558,49,113,2000,21,11,10
24559,49,74,2000,2389,1101,1288
24560,49,25,2000,14162,7171,6991
24561,49,169,2000,65,42,23
24562,49,166,2000,232,91,141
24563,49,93,2000,234,133,101
24564,49,146,2000,2728,842,1886
24565,49,26,2000,31894,15196,16698
24566,49,170,2000,56,39,17
24567,49,130,2000,2393,1207,1186
24568,49,38,2000,1459,1018,441
24569,49,27,2000,351,175,176
24570,49,50,2000,14602,5285,9317
24571,49,131,2000,846,435,411
24572,49,114,2000,2227,1073,1154
24573,49,171,2000,155,100,55
24574,49,1,2000,10898,5738,5160
24575,49,28,2000,173,75,98
24576,49,132,2000,245,129,116
24577,49,133,2000,254,131,123
24578,74,2,2000,2740,974,1766
24579,74,51,2000,1304,658,646
24580,74,141,2000,6648,2453,4195
24581,74,52,2000,32,11,21
24582,74,134,2000,4709,2108,2601
24583,74,76,2000,80,34,46
24584,74,103,2000,6009,2835,3174
24585,74,11,2000,459,238,221
24586,74,66,2000,44509,24886,19623
24587,74,12,2000,333,169,164
24588,74,78,2000,84,37,47
24589,74,13,2000,224,102,122
24590,74,3,2000,1385,375,1010
24591,74,79,2000,52,20,32
24592,74,29,2000,761,508,253
24593,74,67,2000,10749,5126,5623
24594,74,95,2000,47,22,25
24595,74,151,2000,380,130,250
24596,74,4,2000,56,24,32
24597,74,53,2000,38666,18063,20603
24598,74,147,2000,44,20,24
24599,74,105,2000,24450,15621,8829
24600,74,30,2000,3708,2280,1428
24601,74,152,2000,431,174,257
24602,74,116,2000,408,214,194
24603,74,153,2000,1496,682,814
24604,74,135,2000,4879,2823,2056
24605,74,136,2000,216,101,115
24606,74,106,2000,5238,2499,2739
24607,74,172,2000,11538,6371,5167
24608,74,107,2000,7917,4427,3490
24609,74,117,2000,21,8,13
24610,74,137,2000,955,416,539
24611,74,96,2000,600,323,277
24612,74,54,2000,14894,7433,7461
24613,74,81,2000,2142,1107,1035
24614,74,14,2000,265,102,163
24615,74,31,2000,9460,5037,4423
24616,74,176,2000,361,218,143
24617,74,137,2000,4393,1990,2403
24618,74,39,2000,4020,2097,1923
24619,74,118,2000,68,33,35
24620,74,82,2000,197,123,74
24621,74,83,2000,7223,4689,2534
24622,74,108,2000,3213,1777,1436
24623,74,142,2000,4368,1462,2906
24624,74,97,2000,490,262,228
24625,74,138,2000,24,11,13
24626,74,119,2000,4483,1553,2930
24627,74,40,2000,346,227,119
24628,74,148,2000,74,44,30
24629,74,120,2000,3297,1629,1668
24630,74,42,2000,3716,2410,1306
24631,74,68,2000,100144,47993,52151
24632,74,139,2000,180,103,77
24633,74,155,2000,473,52,421
24634,74,15,2000,448,235,213
24635,74,69,2000,241379,110937,130442
24636,74,156,2000,1909,879,1030
24637,74,56,2000,5770,2413,3357
24638,74,84,2000,33,17,16
24639,74,98,2000,686,359,327
24640,74,157,2000,778,208,570
24641,74,158,2000,205,59,146
24642,74,110,2000,99,60,39
24643,74,85,2000,1252,746,506
24644,74,99,2000,382,231,151
24645,74,32,2000,11132,5507,5625
24646,74,43,2000,215,100,115
24647,74,5,2000,12645,5477,7168
24648,74,6,2000,6078,2506,3572
24649,74,16,2000,4932,1565,3367
24650,74,44,2000,2341,1084,1257
24651,74,17,2000,2537,1039,1498
24652,74,57,2000,176442,71215,105227
24653,74,86,2000,554,279,275
24654,74,177,2000,4993,3120,1873
24655,74,18,2000,456,168,288
24656,74,167,2000,1368,741,627
24657,74,121,2000,2310,1218,1092
24658,74,19,2000,300,121,179
24659,74,168,2000,300,181,119
24660,74,46,2000,1006,684,322
24661,74,20,2000,4222,1356,2866
24662,74,149,2000,54,28,26
24663,74,159,2000,303,123,180
24664,74,143,2000,734,279,455
24665,74,70,2000,1715,953,762
24666,74,47,2000,715,466,249
24667,74,71,2000,1619,791,828
24668,74,122,2000,1202,671,531
24669,74,123,2000,77,32,45
24670,74,7,2000,46,12,34
24671,74,160,2000,283,111,172
24672,74,58,2000,202,102,100
24673,74,161,2000,84,27,57
24674,74,124,2000,1982,1293,689
24675,74,100,2000,4306,2420,1886
24676,74,72,2000,181,83,98
24677,74,59,2000,1989,908,1081
24678,74,144,2000,11902,6136,5766
24679,74,125,2000,912,441,471
24680,74,150,2000,189,82,107
24681,74,8,2000,654,248,406
24682,74,73,2000,16239,7721,8518
24683,74,101,2000,419,236,183
24684,74,162,2000,2326,637,1689
24685,74,60,2000,39114,17037,22077
24686,74,48,2000,1625,817,808
24687,74,21,2000,56,22,34
24688,74,9,2000,2946,968,1978
24689,74,102,2000,348,186,162
24690,74,111,2000,669,361,308
24691,74,112,2000,6523,3869,2654
24692,74,33,2000,16247,8825,7422
24693,74,61,2000,130398,53980,76418
24694,74,22,2000,48,18,30
24695,74,35,2000,9315,5421,3894
24696,74,36,2000,12253,7330,4923
24697,74,126,2000,731,363,368
24698,74,90,2000,0,0,0
24699,74,91,2000,42,17,25
24700,74,92,2000,0,0,0
24701,74,62,2000,0,0,0
24702,74,140,2000,40,20,20
24703,74,23,2000,635,271,364
24704,74,164,2000,1559,570,989
24705,74,63,2000,82923,36346,46577
24706,74,127,2000,165,109,56
24707,74,165,2000,238,89,149
24708,74,37,2000,5750,3431,2319
24709,74,64,2000,2561,1385,1176
24710,74,128,2000,3167,1213,1954
24711,74,115,2000,5200,2529,2671
24712,74,129,2000,0,0,0
24713,74,65,2000,40529,18488,22041
24714,74,10,2000,21648,9215,12433
24715,74,145,2000,686,265,421
24716,74,113,2000,76,42,34
24717,74,49,2000,6953,3481,3472
24718,74,25,2000,2134,780,1354
24719,74,169,2000,121,68,53
24720,74,166,2000,1230,495,735
24721,74,93,2000,231,122,109
24722,74,146,2000,7454,2287,5167
24723,74,26,2000,57493,24225,33268
24724,74,170,2000,49,32,17
24725,74,130,2000,537,278,259
24726,74,38,2000,4638,3194,1444
24727,74,27,2000,262,108,154
24728,74,50,2000,31112,13222,17890
24729,74,131,2000,622,303,319
24730,74,114,2000,1175,573,602
24731,74,171,2000,451,259,192
24732,74,1,2000,8220,4160,4060
24733,74,28,2000,289,119,170
24734,74,132,2000,269,130,139
24735,74,133,2000,738,358,380
24736,25,2,2000,172,85,87
24737,25,16,2000,1829,905,924
24738,25,128,2000,443,219,224
24739,25,145,2000,91,45,46
24740,169,2,2000,17118,9273,7845
24741,169,141,2000,138,75,63
24742,169,12,2000,180,110,70
24743,169,66,2000,69,37,32
24744,169,11,2000,207,125,82
24745,169,29,2000,720,422,298
24746,169,172,2000,52,20,32
24747,169,39,2000,139,56,83
24748,169,15,2000,703,338,365
24749,169,69,2000,143,64,79
24750,169,5,2000,654,254,400
24751,169,6,2000,1267,605,662
24752,169,16,2000,68,32,36
24753,169,167,2000,889,463,426
24754,169,176,2000,166,68,98
24755,169,168,2000,11944,5863,6081
24756,169,21,2000,40,21,19
24757,169,73,2000,55,35,20
24758,169,9,2000,125,62,63
24759,169,33,2000,41,21,20
24760,169,36,2000,252099,143429,108670
24761,169,74,2000,57,26,31
24762,169,26,2000,822,386,436
24763,169,170,2000,473,246,227
24764,169,38,2000,1279,553,726
24765,169,50,2000,333,103,230
24766,169,171,2000,7984,4181,3803
24767,169,132,2000,27,13,14
24768,131,134,2000,1018,411,607
24769,131,147,2000,116,37,79
24770,131,116,2000,628609,308640,319969
24771,131,117,2000,487,194,293
24772,131,137,2000,23123,11685,11438
24773,131,137,2000,112286,55150,57136
24774,131,69,2000,810,344,466
24775,131,5,2000,6642,2857,3785
24776,131,57,2000,482,204,278
24777,131,121,2000,30272,17301,12971
24778,131,149,2000,113,37,76
24779,131,123,2000,7098,3250,3848
24780,131,124,2000,161,61,100
24781,131,125,2000,46739,22865,23874
24782,131,150,2000,526,207,319
24783,131,9,2000,545,227,318
24784,131,126,2000,49366,23858,25508
24785,131,127,2000,305,121,184
24786,131,128,2000,3655,1739,1916
24787,131,115,2000,582,229,353
24788,131,148,2000,74,24,50
24789,131,130,2000,12286,5905,6381
24790,131,50,2000,912,390,522
24791,131,132,2000,13584,7356,6228
24792,131,133,2000,693,278,415
24793,166,67,2000,32,10,22
24794,166,135,2000,423,161,262
24795,166,153,2000,23,10,13
24796,166,136,2000,433,147,286
24797,166,172,2000,313,60,253
24798,166,137,2000,155,63,92
24799,166,137,2000,351,187,164
24800,166,151,2000,36908,17071,19837
24801,166,138,2000,63,24,39
24802,166,68,2000,1277,607,670
24803,166,139,2000,545,254,291
24804,166,155,2000,646,296,350
24805,166,69,2000,101,58,43
24806,166,156,2000,26455,14738,11717
24807,166,157,2000,1970,937,1033
24808,166,159,2000,102,52,50
24809,166,160,2000,2699,1169,1530
24810,166,161,2000,85,50,35
24811,166,162,2000,16087,7523,8564
24812,166,158,2000,77,45,32
24813,166,126,2000,1452,799,653
24814,166,140,2000,23,12,11
24815,166,164,2000,612,283,329
24816,166,165,2000,62,33,29
24817,166,152,2000,8781,3549,5232
24818,93,79,2000,1573,778,795
24819,93,172,2000,461,221,240
24820,93,81,2000,40,18,22
24821,93,69,2000,135,70,65
24822,93,84,2000,11148,6154,4994
24823,93,110,2000,5264,3122,2142
24824,93,5,2000,620,275,345
24825,93,86,2000,798,406,392
24826,93,162,2000,267,102,165
24827,93,91,2000,976,497,479
24828,93,92,2000,8384,4664,3720
24829,93,50,2000,2090,1001,1089
24830,146,141,2000,10041,4932,5109
24831,146,135,2000,0,0,0
24832,146,68,2000,4789,2354,2435
24833,146,69,2000,1038,510,528
24834,146,16,2000,11,5,6
24835,146,57,2000,1620,796,824
24836,146,143,2000,1804,886,918
24837,146,160,2000,230,113,117
24838,146,161,2000,433,219,214
24839,146,144,2000,6607,3248,3359
24840,146,162,2000,133,65,68
24841,146,164,2000,373,184,189
24842,146,25,2000,437,214,223
24843,146,142,2000,698,343,355
24844,26,2,2000,9020,3871,5149
24845,26,51,2000,3086,1523,1563
24846,26,141,2000,603,165,438
24847,26,12,2000,15638,7545,8093
24848,26,103,2000,131,65,66
24849,26,66,2000,13354,6705,6649
24850,26,3,2000,307,25,282
24851,26,11,2000,740,463,277
24852,26,67,2000,8152,4278,3874
24853,26,53,2000,2839,1398,1441
24854,26,105,2000,320,196,124
24855,26,30,2000,447912,234432,213480
24856,26,29,2000,280,213,67
24857,26,10,2000,36,6,30
24858,26,106,2000,41,27,14
24859,26,172,2000,1634,824,810
24860,26,107,2000,44,29,15
24861,26,137,2000,28,8,20
24862,26,96,2000,51,24,27
24863,26,54,2000,207,117,90
24864,26,81,2000,40,19,21
24865,26,14,2000,9679,5192,4487
24866,26,31,2000,1056,526,530
24867,26,39,2000,3135,1620,1515
24868,26,120,2000,56,34,22
24869,26,40,2000,105,66,39
24870,26,42,2000,1557,835,722
24871,26,68,2000,14882,7578,7304
24872,26,15,2000,6065,3488,2577
24873,26,69,2000,254815,130561,124254
24874,26,156,2000,134,16,118
24875,26,56,2000,55164,29947,25217
24876,26,173,2000,54,28,26
24877,26,32,2000,485,282,203
24878,26,43,2000,40,21,19
24879,26,5,2000,485,181,304
24880,26,6,2000,13427,5153,8274
24881,26,16,2000,8922,3614,5308
24882,26,44,2000,501,254,247
24883,26,17,2000,2533,1218,1315
24884,26,57,2000,2648,1158,1490
24885,26,177,2000,1865,1024,841
24886,26,167,2000,4654,2564,2090
24887,26,18,2000,836,301,535
24888,26,121,2000,162,58,104
24889,26,176,2000,28,13,15
24890,26,19,2000,266,93,173
24891,26,168,2000,1632,708,924
24892,26,20,2000,1054,528,526
24893,26,46,2000,61,40,21
24894,26,143,2000,2861,1229,1632
24895,26,47,2000,243,147,96
24896,26,71,2000,42,23,19
24897,26,58,2000,40,26,14
24898,26,100,2000,143,74,69
24899,26,144,2000,437,175,262
24900,26,21,2000,24,14,10
24901,26,73,2000,20329,10264,10065
24902,26,162,2000,272,37,235
24903,26,48,2000,3310,1686,1624
24904,26,9,2000,1060,424,636
24905,26,112,2000,50,30,20
24906,26,33,2000,3181,1672,1509
24907,26,61,2000,209,108,101
24908,26,22,2000,30,11,19
24909,26,35,2000,19316,11473,7843
24910,26,36,2000,18497,11228,7269
24911,26,23,2000,4094,1934,2160
24912,26,164,2000,63,24,39
24913,26,37,2000,293,155,138
24914,26,1,2000,29,17,12
24915,26,64,2000,136,72,64
24916,26,128,2000,34,6,28
24917,26,115,2000,275,132,143
24918,26,65,2000,1126,590,536
24919,26,145,2000,212,52,160
24920,26,148,2000,71,46,25
24921,26,49,2000,4969,2652,2317
24922,26,74,2000,9659,5044,4615
24923,26,25,2000,4995,2607,2388
24924,26,169,2000,248,60,188
24925,26,27,2000,41,15,26
24926,26,146,2000,475,185,290
24927,26,170,2000,1894,528,1366
24928,26,38,2000,3893,2716,1177
24929,26,60,2000,134372,69704,64668
24930,26,142,2000,717,295,422
24931,26,50,2000,17619,9385,8234
24932,26,131,2000,207,22,185
24933,26,114,2000,41,19,22
24934,26,171,2000,7375,3810,3565
24935,26,28,2000,64,26,38
24936,170,2,2000,1784,1015,769
24937,170,12,2000,7809,4041,3768
24938,170,11,2000,7452,3804,3648
24939,170,29,2000,2158,763,1395
24940,170,69,2000,1037,608,429
24941,170,6,2000,1786,906,880
24942,170,167,2000,20579,10599,9980
24943,170,36,2000,79212,43133,36079
24944,170,169,2000,15478,8807,6671
24945,170,38,2000,8394,4121,4273
24946,170,171,2000,71162,37418,33744
24947,94,78,2000,459,210,249
24948,94,83,2000,692,303,389
24949,94,85,2000,5127,2563,2564
24950,94,50,2000,386,175,211
24951,130,141,2000,0,0,0
24952,130,3,2000,131,108,23
24953,130,67,2000,40,20,20
24954,130,116,2000,14278,5847,8431
24955,130,172,2000,374,134,240
24956,130,137,2000,84966,45294,39672
24957,130,81,2000,17,2,15
24958,130,39,2000,160,80,80
24959,130,120,2000,291,143,148
24960,130,119,2000,39,19,20
24961,130,68,2000,228,86,142
24962,130,155,2000,0,0,0
24963,130,69,2000,214,102,112
24964,130,156,2000,0,0,0
24965,130,56,2000,37,20,17
24966,130,32,2000,9,9,0
24967,130,5,2000,3591,1297,2294
24968,130,57,2000,370,34,336
24969,130,177,2000,187,65,122
24970,130,121,2000,37371,20770,16601
24971,130,176,2000,136,32,104
24972,130,143,2000,1,0,1
24973,130,123,2000,7,2,5
24974,130,161,2000,0,0,0
24975,130,125,2000,27,13,14
24976,130,73,2000,196,99,97
24977,130,162,2000,4,1,3
24978,130,48,2000,8,0,8
24979,130,9,2000,594,135,459
24980,130,36,2000,279,160,119
24981,130,126,2000,70387,34676,35711
24982,130,164,2000,1,0,1
24983,130,128,2000,1384,684,700
24984,130,133,2000,3,0,3
24985,130,65,2000,55,37,18
24986,130,129,2000,0,0,0
24987,130,145,2000,341554,170126,171428
24988,130,49,2000,26,0,26
24989,130,166,2000,4,0,4
24990,130,142,2000,1,0,1
24991,130,50,2000,1096,498,598
24992,130,131,2000,22351,11093,11258
24993,130,132,2000,7,3,4
24994,38,2,2000,2416,542,1874
24995,38,12,2000,94083,41804,52279
24996,38,11,2000,54082,22835,31247
24997,38,30,2000,1983,644,1339
24998,38,29,2000,280687,165929,114758
24999,38,172,2000,7502,2707,4795
25000,38,40,2000,11687,5852,5835
25001,38,15,2000,73621,33759,39862
25002,38,69,2000,1239,574,665
25003,38,5,2000,4364,857,3507
25004,38,6,2000,2443,455,1988
25005,38,17,2000,4291,2094,2197
25006,38,167,2000,254065,140107,113958
25007,38,18,2000,4247,97,4150
25008,38,168,2000,30557,16581,13976
25009,38,20,2000,2019,112,1907
25010,38,46,2000,22289,11158,11131
25011,38,47,2000,27916,13976,13940
25012,38,144,2000,1988,563,1425
25013,38,33,2000,3520,1909,1611
25014,38,36,2000,3745842,2213844,1531998
25015,38,1,2000,14166,6039,8127
25016,38,25,2000,4255,167,4088
25017,38,169,2000,33574,16963,16611
25018,38,26,2000,1550,221,1329
25019,38,170,2000,25840,13792,12048
25020,38,171,2000,251285,126867,124418
25021,27,2,2000,2668,757,1911
25022,27,13,2000,795,509,286
25023,27,3,2000,297620,49767,247853
25024,27,10,2000,45340,22575,22765
25025,27,136,2000,1739,494,1245
25026,27,120,2000,4433,1258,3175
25027,27,119,2000,6295,1786,4509
25028,27,68,2000,1868,773,1095
25029,27,5,2000,915878,230187,685691
25030,27,18,2000,47494,16594,30900
25031,27,19,2000,21687,6221,15466
25032,27,20,2000,9024,2560,6464
25033,27,144,2000,3188,904,2284
25034,27,8,2000,2832,803,2029
25035,27,73,2000,1450,627,823
25036,27,162,2000,2319,658,1661
25037,27,9,2000,305782,73779,232003
25038,27,22,2000,210,148,62
25039,27,23,2000,1604,546,1058
25040,27,128,2000,4221,1198,3023
25041,27,129,2000,6723,2316,4407
25042,27,145,2000,54597,18812,35785
25043,27,25,2000,22036,6252,15784
25044,27,146,2000,1922,545,1377
25045,27,26,2000,16050,4542,11508
25046,27,142,2000,261934,84299,177635
25047,27,50,2000,14201,5127,9074
25048,27,28,2000,72861,20692,52169
25049,50,2,2000,14382,4957,9425
25050,50,51,2000,2227,810,1417
25051,50,141,2000,10318,3044,7274
25052,50,52,2000,26,11,15
25053,50,134,2000,5717,2899,2818
25054,50,75,2000,666,353,313
25055,50,76,2000,3764,2067,1697
25056,50,103,2000,6561,3765,2796
25057,50,11,2000,572,307,265
25058,50,77,2000,772,444,328
25059,50,66,2000,18851,13136,5715
25060,50,12,2000,544,284,260
25061,50,78,2000,1735,917,818
25062,50,13,2000,4047,2004,2043
25063,50,3,2000,149241,73119,76122
25064,50,79,2000,20891,10753,10138
25065,50,29,2000,1108,621,487
25066,50,67,2000,20943,12390,8553
25067,50,95,2000,1191,835,356
25068,50,151,2000,226,109,117
25069,50,4,2000,86,30,56
25070,50,53,2000,6470,3510,2960
25071,50,147,2000,1975,951,1024
25072,50,105,2000,14710,8797,5913
25073,50,30,2000,5178,2851,2327
25074,50,152,2000,94,39,55
25075,50,116,2000,1953,1061,892
25076,50,153,2000,319,175,144
25077,50,135,2000,3125,1584,1541
25078,50,80,2000,1043,601,442
25079,50,136,2000,180,47,133
25080,50,106,2000,4966,2762,2204
25081,50,172,2000,144073,74058,70015
25082,50,173,2000,74718,36741,37977
25083,50,107,2000,11920,7118,4802
25084,50,117,2000,60,33,27
25085,50,137,2000,3162,1640,1522
25086,50,96,2000,355,202,153
25087,50,54,2000,6757,3846,2911
25088,50,81,2000,1044,578,466
25089,50,14,2000,75098,37071,38027
25090,50,31,2000,11819,8087,3732
25091,50,176,2000,11,1,10
25092,50,137,2000,8280,4074,4206
25093,50,39,2000,18023,11150,6873
25094,50,118,2000,232,123,109
25095,50,82,2000,6517,3413,3104
25096,50,83,2000,504,262,242
25097,50,108,2000,2936,1638,1298
25098,50,142,2000,23885,10993,12892
25099,50,97,2000,569,350,219
25100,50,138,2000,53,30,23
25101,50,119,2000,6334,3354,2980
25102,50,40,2000,1943,1019,924
25103,50,148,2000,828,431,397
25104,50,120,2000,7524,3915,3609
25105,50,41,2000,266,159,107
25106,50,42,2000,10943,8035,2908
25107,50,68,2000,91911,54699,37212
25108,50,139,2000,126,68,58
25109,50,155,2000,3796,1726,2070
25110,50,15,2000,537,278,259
25111,50,69,2000,257322,150162,107160
25112,50,156,2000,54254,28119,26135
25113,50,55,2000,7500,3772,3728
25114,50,56,2000,34008,15380,18628
25115,50,84,2000,9460,5063,4397
25116,50,98,2000,481,289,192
25117,50,157,2000,255,112,143
25118,50,158,2000,373,182,191
25119,50,110,2000,20182,11627,8555
25120,50,85,2000,154,100,54
25121,50,99,2000,412,250,162
25122,50,32,2000,12721,6442,6279
25123,50,43,2000,1492,843,649
25124,50,5,2000,452144,234351,217793
25125,50,6,2000,41087,17540,23547
25126,50,16,2000,31162,11847,19315
25127,50,44,2000,515544,289356,226188
25128,50,45,2000,6642,3338,3304
25129,50,17,2000,11503,5544,5959
25130,50,57,2000,103689,51526,52163
25131,50,86,2000,141559,76378,65181
25132,50,177,2000,36294,21811,14483
25133,50,18,2000,3001,1152,1849
25134,50,167,2000,848,554,294
25135,50,121,2000,125340,62330,63010
25136,50,19,2000,5682,2622,3060
25137,50,168,2000,129,87,42
25138,50,46,2000,4132,1780,2352
25139,50,20,2000,10106,4344,5762
25140,50,149,2000,320,191,129
25141,50,159,2000,1524,663,861
25142,50,143,2000,8836,3766,5070
25143,50,70,2000,27,21,6
25144,50,47,2000,4214,2131,2083
25145,50,71,2000,1177,611,566
25146,50,122,2000,765,497,268
25147,50,123,2000,11934,5981,5953
25148,50,7,2000,190,98,92
25149,50,160,2000,117,52,65
25150,50,58,2000,29178,15252,13926
25151,50,161,2000,29,11,18
25152,50,124,2000,26180,12841,13339
25153,50,100,2000,4882,2715,2167
25154,50,72,2000,215,102,113
25155,50,59,2000,705,347,358
25156,50,87,2000,8935,5167,3768
25157,50,144,2000,11941,5446,6495
25158,50,125,2000,3244,1714,1530
25159,50,150,2000,1195,608,587
25160,50,8,2000,5741,1863,3878
25161,50,73,2000,39100,21739,17361
25162,50,101,2000,221,146,75
25163,50,162,2000,85449,42999,42450
25164,50,60,2000,1241,781,460
25165,50,48,2000,13348,7942,5406
25166,50,21,2000,1954,764,1190
25167,50,9,2000,310526,152138,158388
25168,50,102,2000,476,281,195
25169,50,111,2000,486,264,222
25170,50,112,2000,3933,2475,1458
25171,50,33,2000,58696,31046,27650
25172,50,61,2000,35344,18391,16953
25173,50,22,2000,1026,478,548
25174,50,35,2000,7379,3948,3431
25175,50,36,2000,15125,9458,5667
25176,50,126,2000,2294,1275,1019
25177,50,90,2000,6302,3362,2940
25178,50,91,2000,7993,4430,3563
25179,50,92,2000,6855,3592,3263
25180,50,140,2000,87,63,24
25181,50,23,2000,8497,3905,4592
25182,50,164,2000,699,310,389
25183,50,63,2000,5651,3011,2640
25184,50,127,2000,2808,1705,1103
25185,50,165,2000,16485,8889,7596
25186,50,37,2000,5097,4158,939
25187,50,64,2000,1192,748,444
25188,50,128,2000,42089,22840,19249
25189,50,115,2000,136720,71843,64877
25190,50,65,2000,52676,30898,21778
25191,50,10,2000,65693,28710,36983
25192,50,145,2000,10319,4608,5711
25193,50,113,2000,255,147,108
25194,50,49,2000,21773,14272,7501
25195,50,74,2000,15488,9552,5936
25196,50,25,2000,4028,1628,2400
25197,50,169,2000,97,52,45
25198,50,166,2000,530,210,320
25199,50,93,2000,20581,12640,7941
25200,50,146,2000,2967,1054,1913
25201,50,26,2000,52296,23364,28932
25202,50,170,2000,91,61,30
25203,50,94,2000,126,67,59
25204,50,130,2000,53378,26350,27028
25205,50,38,2000,11512,4891,6621
25206,50,27,2000,5226,2266,2960
25207,50,131,2000,31553,15442,16111
25208,50,114,2000,935,519,416
25209,50,171,2000,506,283,223
25210,50,1,2000,22566,12008,10558
25211,50,28,2000,12085,5108,6977
25212,50,132,2000,20818,11066,9752
25213,50,133,2000,47888,25932,21956
25214,114,103,2000,21691,12102,9589
25215,114,105,2000,11507,6823,4684
25216,114,106,2000,1455,756,699
25217,114,68,2000,816,423,393
25218,114,69,2000,1563,845,718
25219,114,57,2000,13403,6053,7350
25220,114,100,2000,602,333,269
25221,114,111,2000,1160,785,375
25222,114,112,2000,104,33,71
25223,114,33,2000,1318,737,581
25224,114,61,2000,633,304,329
25225,114,35,2000,690,360,330
25226,114,65,2000,24303,13170,11133
25227,114,50,2000,513,295,218
25228,171,12,2000,22744,11543,11201
25229,171,11,2000,7498,3904,3594
25230,171,29,2000,28456,15458,12998
25231,171,69,2000,9353,5282,4071
25232,171,167,2000,20868,12140,8728
25233,171,168,2000,5110,2968,2142
25234,171,36,2000,1067247,613078,454169
25235,171,169,2000,32002,18209,13793
25236,171,170,2000,796,346,450
25237,171,38,2000,131027,73860,57167
25238,1,3,2000,1244,525,719
25239,1,10,2000,278,119,159
25240,1,172,2000,2573,1092,1481
25241,1,68,2000,127,37,90
25242,1,5,2000,933,381,552
25243,1,177,2000,471,161,310
25244,1,176,2000,648,274,374
25245,1,8,2000,774,354,420
25246,1,9,2000,166,70,96
25247,1,50,2000,3613,1617,1996
25248,28,120,2000,1703,713,990
25249,28,119,2000,2766,1159,1607
25250,28,6,2000,0,0,0
25251,28,16,2000,5389,2491,2898
25252,28,1,2000,9,3,6
25253,28,128,2000,69757,29814,39943
25254,28,129,2000,0,0,0
25255,28,145,2000,20102,9306,10796
25256,28,25,2000,2411,1116,1295
25257,28,142,2000,9206,4263,4943
25258,132,134,2000,238248,117525,120723
25259,132,147,2000,111,69,42
25260,132,116,2000,1796,914,882
25261,132,135,2000,18,3,15
25262,132,172,2000,166,46,120
25263,132,137,2000,4330,1920,2410
25264,132,137,2000,58237,28266,29971
25265,132,68,2000,55,20,35
25266,132,69,2000,157,69,88
25267,132,156,2000,166,49,117
25268,132,5,2000,3468,1703,1765
25269,132,177,2000,129,41,88
25270,132,121,2000,249,90,159
25271,132,123,2000,6937,2664,4273
25272,132,160,2000,194,47,147
25273,132,125,2000,545,280,265
25274,132,150,2000,101,46,55
25275,132,162,2000,138,40,98
25276,132,126,2000,5662,3794,1868
25277,132,164,2000,166,23,143
25278,132,115,2000,1535,745,790
25279,132,133,2000,9056,4610,4446
25280,132,130,2000,370,143,227
25281,132,142,2000,83,35,48
25282,132,50,2000,1036,467,569
25283,132,131,2000,4322,2101,2221
25284,133,147,2000,4012,1724,2288
25285,133,123,2000,92989,39958,53031
25286,133,125,2000,197838,85019,112819
25287,133,115,2000,17024,7315,9709
25288,133,50,2000,23747,10204,13543
25289,133,132,2000,26337,11317,15020
25290,2,9,2005,37163,16188,20975
25291,2,169,2005,28460,12396,16064
25292,2,171,2005,1422,619,803
25293,51,56,2005,39315,20447,18868
25294,51,57,2005,11069,5119,5950
25295,51,26,2005,2441,767,1674
25296,51,60,2005,664,338,326
25297,141,68,2005,439,240,199
25298,141,69,2005,615,393,222
25299,141,16,2005,5992,3009,2983
25300,141,57,2005,585,346,239
25301,141,18,2005,1785,811,974
25302,141,19,2005,946,314,632
25303,141,20,2005,968,570,398
25304,141,143,2005,1838,837,1001
25305,141,36,2005,634,356,278
25306,141,23,2005,3103,1149,1954
25307,141,128,2005,9147,3954,5193
25308,141,145,2005,1262,570,692
25309,141,25,2005,2429,1103,1326
25310,141,50,2005,632,353,279
25311,141,28,2005,1870,760,1110
25312,52,103,2005,494,233,261
25313,52,67,2005,255,120,135
25314,52,106,2005,148,70,78
25315,52,39,2005,140,67,73
25316,52,68,2005,4875,2301,2574
25317,52,69,2005,401,189,212
25318,52,57,2005,349,164,185
25319,52,144,2005,549,259,290
25320,52,73,2005,260,123,137
25321,52,61,2005,10722,5056,5666
25322,52,65,2005,28450,13432,15018
25323,52,49,2005,55,26,29
25324,52,74,2005,86,41,45
25325,52,50,2005,1085,512,573
25326,52,114,2005,105,50,55
25327,134,153,2005,6209,3160,3049
25328,134,136,2005,22,13,9
25329,134,137,2005,715,423,292
25330,134,137,2005,24738,12913,11825
25331,134,157,2005,228,132,96
25332,134,125,2005,169,86,83
25333,134,150,2005,601,314,287
25334,134,61,2005,6772,3386,3386
25335,134,126,2005,536,309,227
25336,134,140,2005,5417,2881,2536
25337,134,115,2005,4241,2212,2029
25338,134,132,2005,209,133,76
25339,75,83,2005,560,201,359
25340,75,110,2005,328,136,192
25341,75,86,2005,398,172,226
25342,75,87,2005,245,73,172
25343,75,90,2005,774,272,502
25344,75,50,2005,358,237,121
25345,76,78,2005,2,1,1
25346,76,79,2005,266,110,156
25347,76,95,2005,12,6,6
25348,76,172,2005,118,61,57
25349,76,81,2005,18,10,8
25350,76,82,2005,4180,2336,1844
25351,76,83,2005,1572,979,593
25352,76,120,2005,80,43,37
25353,76,68,2005,37,20,17
25354,76,109,2005,5,2,3
25355,76,69,2005,73,38,35
25356,76,156,2005,27,14,13
25357,76,84,2005,170,75,95
25358,76,110,2005,5702,3150,2552
25359,76,85,2005,29,15,14
25360,76,99,2005,7,3,4
25361,76,5,2005,70,36,34
25362,76,57,2005,64,32,32
25363,76,86,2005,3515,2339,1176
25364,76,177,2005,18,10,8
25365,76,20,2005,49,25,24
25366,76,100,2005,5,2,3
25367,76,87,2005,1003,498,505
25368,76,73,2005,14,8,6
25369,76,77,2005,5,2,3
25370,76,162,2005,36,20,16
25371,76,9,2005,0,0,0
25372,76,88,2005,47,24,23
25373,76,90,2005,420,224,196
25374,76,75,2005,35,18,17
25375,76,91,2005,596,338,258
25376,76,92,2005,809,326,483
25377,76,115,2005,40,22,18
25378,76,65,2005,11,6,5
25379,76,113,2005,40,22,18
25380,76,25,2005,215,111,104
25381,76,93,2005,634,328,306
25382,76,94,2005,6,3,3
25383,76,142,2005,9,5,4
25384,76,50,2005,876,446,430
25385,103,2,2005,16,13,3
25386,103,51,2005,104,43,61
25387,103,141,2005,163,64,99
25388,103,52,2005,2,0,2
25389,103,134,2005,16,10,6
25390,103,66,2005,1584,883,701
25391,103,13,2005,20,8,12
25392,103,11,2005,870,433,437
25393,103,79,2005,13,12,1
25394,103,67,2005,831,433,398
25395,103,105,2005,37609,21697,15912
25396,103,95,2005,10,9,1
25397,103,30,2005,457,252,205
25398,103,29,2005,471,262,209
25399,103,153,2005,38,23,15
25400,103,10,2005,5,0,5
25401,103,106,2005,195338,102521,92817
25402,103,172,2005,9956,4580,5376
25403,103,107,2005,2673,1379,1294
25404,103,137,2005,66,32,34
25405,103,96,2005,191,89,102
25406,103,54,2005,1526,776,750
25407,103,81,2005,1712,819,893
25408,103,14,2005,74,40,34
25409,103,31,2005,2774,1717,1057
25410,103,39,2005,380,201,179
25411,103,82,2005,8,8,0
25412,103,83,2005,1059,799,260
25413,103,108,2005,1479,763,716
25414,103,97,2005,116,59,57
25415,103,120,2005,51,29,22
25416,103,40,2005,77,50,27
25417,103,42,2005,110,77,33
25418,103,68,2005,6535,3280,3255
25419,103,69,2005,8841,4785,4056
25420,103,55,2005,23,15,8
25421,103,56,2005,1576,817,759
25422,103,84,2005,18,18,0
25423,103,98,2005,150,79,71
25424,103,157,2005,2,2,0
25425,103,85,2005,65,20,45
25426,103,99,2005,104,55,49
25427,103,173,2005,8,0,8
25428,103,32,2005,1263,704,559
25429,103,43,2005,14,13,1
25430,103,5,2005,152,84,68
25431,103,6,2005,214,103,111
25432,103,16,2005,58,34,24
25433,103,44,2005,102,48,54
25434,103,17,2005,863,433,430
25435,103,57,2005,171407,93252,78155
25436,103,86,2005,19,0,19
25437,103,177,2005,4206,2154,2052
25438,103,18,2005,114,41,73
25439,103,121,2005,5,4,1
25440,103,176,2005,23,0,23
25441,103,20,2005,1180,601,579
25442,103,46,2005,192,124,68
25443,103,143,2005,80,31,49
25444,103,70,2005,121,43,78
25445,103,47,2005,607,380,227
25446,103,71,2005,151,109,42
25447,103,122,2005,12,10,2
25448,103,58,2005,4,4,0
25449,103,100,2005,2244,1115,1129
25450,103,72,2005,17,16,1
25451,103,144,2005,329,192,137
25452,103,125,2005,18,18,0
25453,103,150,2005,4,0,4
25454,103,73,2005,599,273,326
25455,103,77,2005,2,2,0
25456,103,101,2005,142,71,71
25457,103,162,2005,67,47,20
25458,103,48,2005,92,22,70
25459,103,9,2005,9,0,9
25460,103,102,2005,250,111,139
25461,103,111,2005,451818,252367,199451
25462,103,112,2005,127351,71075,56276
25463,103,33,2005,9841,5635,4206
25464,103,61,2005,6674,3330,3344
25465,103,88,2005,118,67,51
25466,103,35,2005,1667,920,747
25467,103,36,2005,2916,1588,1328
25468,103,62,2005,27,5,22
25469,103,23,2005,125,47,78
25470,103,1,2005,9,4,5
25471,103,64,2005,1254,645,609
25472,103,128,2005,4,0,4
25473,103,115,2005,196,104,92
25474,103,133,2005,4,4,0
25475,103,65,2005,107675,60806,46869
25476,103,145,2005,14,0,14
25477,103,113,2005,9,9,0
25478,103,49,2005,317,159,158
25479,103,74,2005,1228,600,628
25480,103,25,2005,1704,815,889
25481,103,93,2005,54,19,35
25482,103,146,2005,71,24,47
25483,103,26,2005,983,501,482
25484,103,130,2005,2,2,0
25485,103,38,2005,5929,3122,2807
25486,103,60,2005,2305,1280,1025
25487,103,142,2005,369,166,203
25488,103,50,2005,1460,757,703
25489,103,131,2005,2,0,2
25490,103,152,2005,19,16,3
25491,103,114,2005,114446,59281,55165
25492,103,132,2005,2,0,2
25493,11,12,2005,376231,220504,155727
25494,11,29,2005,493,315,178
25495,11,15,2005,30947,19672,11275
25496,11,69,2005,508,265,243
25497,11,56,2005,1373,789,584
25498,11,6,2005,7413,3941,3472
25499,11,16,2005,283,166,117
25500,11,167,2005,605,425,180
25501,11,20,2005,868,481,387
25502,11,36,2005,13472,9439,4033
25503,11,25,2005,2477,1343,1134
25504,11,26,2005,1503,1013,490
25505,11,170,2005,631,408,223
25506,11,38,2005,1991,1527,464
25507,11,171,2005,884,603,281
25508,77,172,2005,855,411,444
25509,77,107,2005,8243,5116,3127
25510,77,82,2005,115,78,37
25511,77,83,2005,3903,2621,1282
25512,77,84,2005,263,200,63
25513,77,110,2005,289,144,145
25514,77,85,2005,1288,842,446
25515,77,5,2005,238,81,157
25516,77,86,2005,719,488,231
25517,77,73,2005,4056,1964,2092
25518,77,101,2005,90,48,42
25519,77,112,2005,1019,485,534
25520,77,61,2005,174,82,92
25521,77,92,2005,120,87,33
25522,77,113,2005,1285,671,614
25523,77,26,2005,11,3,8
25524,66,2,2005,6614,2153,4461
25525,66,51,2005,2414,1205,1209
25526,66,141,2005,990,235,755
25527,66,52,2005,1,0,1
25528,66,134,2005,261,118,143
25529,66,76,2005,5,5,0
25530,66,103,2005,1168,576,592
25531,66,11,2005,2341,1147,1194
25532,66,77,2005,0,0,0
25533,66,12,2005,825,396,429
25534,66,78,2005,17,7,10
25535,66,13,2005,15,7,8
25536,66,3,2005,2100,694,1406
25537,66,79,2005,15,7,8
25538,66,29,2005,1278,939,339
25539,66,67,2005,1976,1023,953
25540,66,95,2005,31,15,16
25541,66,151,2005,61,19,42
25542,66,4,2005,19,7,12
25543,66,53,2005,123348,60505,62843
25544,66,147,2005,19,11,8
25545,66,105,2005,3979,2561,1418
25546,66,30,2005,12072,6758,5314
25547,66,152,2005,93,40,53
25548,66,116,2005,74,30,44
25549,66,153,2005,31,18,13
25550,66,135,2005,501,185,316
25551,66,80,2005,0,0,0
25552,66,136,2005,9,3,6
25553,66,106,2005,965,509,456
25554,66,172,2005,13545,7460,6085
25555,66,173,2005,215,109,106
25556,66,174,2005,12,7,5
25557,66,107,2005,1204,720,484
25558,66,117,2005,0,0,0
25559,66,137,2005,351,154,197
25560,66,96,2005,137,85,52
25561,66,54,2005,44242,23113,21129
25562,66,81,2005,675,467,208
25563,66,14,2005,248,116,132
25564,66,31,2005,42199,25818,16381
25565,66,176,2005,2158,1340,818
25566,66,137,2005,537,239,298
25567,66,39,2005,1089,614,475
25568,66,118,2005,5,1,4
25569,66,82,2005,38,28,10
25570,66,83,2005,2398,1693,705
25571,66,108,2005,506,282,224
25572,66,142,2005,11425,4159,7266
25573,66,97,2005,52,30,22
25574,66,138,2005,7,3,4
25575,66,119,2005,80,44,36
25576,66,40,2005,286,210,76
25577,66,148,2005,18,11,7
25578,66,120,2005,979,570,409
25579,66,41,2005,0,0,0
25580,66,42,2005,1226,883,343
25581,66,68,2005,6879,3743,3136
25582,66,139,2005,19,6,13
25583,66,155,2005,483,49,434
25584,66,15,2005,2544,1215,1329
25585,66,69,2005,157809,88608,69201
25586,66,156,2005,1898,799,1099
25587,66,55,2005,0,0,0
25588,66,56,2005,3071,1100,1971
25589,66,84,2005,11,6,5
25590,66,98,2005,286,139,147
25591,66,157,2005,232,48,184
25592,66,158,2005,52,5,47
25593,66,110,2005,14,11,3
25594,66,85,2005,48,27,21
25595,66,99,2005,75,44,31
25596,66,32,2005,27834,16209,11625
25597,66,43,2005,144,79,65
25598,66,5,2005,10416,4306,6110
25599,66,6,2005,11889,5136,6753
25600,66,16,2005,4238,1587,2651
25601,66,44,2005,756,334,422
25602,66,17,2005,1967,855,1112
25603,66,57,2005,24180,12758,11422
25604,66,86,2005,159,91,68
25605,66,177,2005,2278,1596,682
25606,66,18,2005,574,174,400
25607,66,167,2005,846,524,322
25608,66,121,2005,753,507,246
25609,66,19,2005,194,69,125
25610,66,168,2005,497,327,170
25611,66,46,2005,619,425,194
25612,66,20,2005,1413,562,851
25613,66,149,2005,3,3,0
25614,66,159,2005,210,33,177
25615,66,143,2005,353,142,211
25616,66,70,2005,289,176,113
25617,66,47,2005,697,459,238
25618,66,71,2005,585,271,314
25619,66,122,2005,57,41,16
25620,66,123,2005,29,13,16
25621,66,7,2005,6,1,5
25622,66,160,2005,76,20,56
25623,66,58,2005,84,47,37
25624,66,161,2005,25,1,24
25625,66,124,2005,88,46,42
25626,66,100,2005,1159,669,490
25627,66,72,2005,19,10,9
25628,66,59,2005,16759,8466,8293
25629,66,144,2005,1478,665,813
25630,66,125,2005,51,28,23
25631,66,150,2005,140,84,56
25632,66,8,2005,450,161,289
25633,66,73,2005,6503,3309,3194
25634,66,101,2005,159,95,64
25635,66,162,2005,6510,1987,4523
25636,66,60,2005,16821,7550,9271
25637,66,48,2005,742,450,292
25638,66,21,2005,24,11,13
25639,66,9,2005,3694,1271,2423
25640,66,102,2005,47,29,18
25641,66,111,2005,175,100,75
25642,66,112,2005,1295,859,436
25643,66,33,2005,49078,27065,22013
25644,66,61,2005,1322,543,779
25645,66,88,2005,4,2,2
25646,66,22,2005,19,7,12
25647,66,35,2005,45357,26105,19252
25648,66,36,2005,23765,13252,10513
25649,66,126,2005,162,73,89
25650,66,90,2005,1,1,0
25651,66,91,2005,10,3,7
25652,66,92,2005,7,3,4
25653,66,62,2005,0,0,0
25654,66,140,2005,1,0,1
25655,66,23,2005,367,150,217
25656,66,164,2005,256,83,173
25657,66,63,2005,149761,75912,73849
25658,66,127,2005,33,19,14
25659,66,165,2005,205,47,158
25660,66,37,2005,20847,13331,7516
25661,66,64,2005,15523,9007,6516
25662,66,128,2005,932,366,566
25663,66,115,2005,2143,1190,953
25664,66,65,2005,3163,1703,1460
25665,66,10,2005,752,340,412
25666,66,145,2005,488,128,360
25667,66,113,2005,15,6,9
25668,66,49,2005,2724,1581,1143
25669,66,74,2005,12125,6508,5617
25670,66,25,2005,2547,944,1603
25671,66,169,2005,218,122,96
25672,66,166,2005,167,62,105
25673,66,93,2005,53,32,21
25674,66,146,2005,2832,848,1984
25675,66,26,2005,133248,61636,71612
25676,66,170,2005,108,70,38
25677,66,130,2005,210,99,111
25678,66,38,2005,6315,4428,1887
25679,66,27,2005,134,71,63
25680,66,50,2005,8450,3906,4544
25681,66,131,2005,121,58,63
25682,66,114,2005,216,117,99
25683,66,171,2005,579,319,260
25684,66,1,2005,2566,1357,1209
25685,66,28,2005,72,29,43
25686,66,132,2005,87,50,37
25687,66,133,2005,229,116,113
25688,12,2,2005,213,65,148
25689,12,11,2005,170050,88757,81293
25690,12,29,2005,525,422,103
25691,12,40,2005,556,309,247
25692,12,15,2005,58561,32071,26490
25693,12,69,2005,327,193,134
25694,12,6,2005,1752,680,1072
25695,12,167,2005,4147,2559,1588
25696,12,168,2005,2927,1600,1327
25697,12,36,2005,32933,23513,9420
25698,12,169,2005,285,179,106
25699,12,26,2005,2429,659,1770
25700,12,170,2005,1975,1169,806
25701,12,38,2005,3225,2494,731
25702,12,171,2005,19501,10700,8801
25703,78,76,2005,11,6,5
25704,78,103,2005,56,21,35
25705,78,66,2005,30,14,16
25706,78,79,2005,164,61,103
25707,78,67,2005,24,9,15
25708,78,147,2005,7,3,4
25709,78,105,2005,80,42,38
25710,78,95,2005,27,18,9
25711,78,30,2005,10,3,7
25712,78,80,2005,15,6,9
25713,78,10,2005,23,10,13
25714,78,106,2005,20,11,9
25715,78,172,2005,126,51,75
25716,78,107,2005,106,43,63
25717,78,96,2005,58,35,23
25718,78,81,2005,240,159,81
25719,78,39,2005,26,12,14
25720,78,82,2005,58,27,31
25721,78,83,2005,177,74,103
25722,78,108,2005,28,12,16
25723,78,97,2005,36,5,31
25724,78,40,2005,8,5,3
25725,78,68,2005,137,54,83
25726,78,69,2005,244,118,126
25727,78,156,2005,55,19,36
25728,78,56,2005,70,24,46
25729,78,84,2005,28,15,13
25730,78,98,2005,21,12,9
25731,78,110,2005,957,526,431
25732,78,85,2005,23047,9823,13224
25733,78,99,2005,27,8,19
25734,78,173,2005,25,11,14
25735,78,5,2005,391,169,222
25736,78,44,2005,62,26,36
25737,78,57,2005,120,43,77
25738,78,86,2005,5349,3634,1715
25739,78,177,2005,36,27,9
25740,78,121,2005,12,7,5
25741,78,100,2005,103,37,66
25742,78,73,2005,40,18,22
25743,78,101,2005,8,4,4
25744,78,162,2005,121,49,72
25745,78,48,2005,11,5,6
25746,78,9,2005,6,3,3
25747,78,102,2005,31,20,11
25748,78,112,2005,165,91,74
25749,78,33,2005,14,10,4
25750,78,61,2005,12,4,8
25751,78,35,2005,60,2,58
25752,78,36,2005,39,27,12
25753,78,90,2005,22,13,9
25754,78,91,2005,65,33,32
25755,78,92,2005,30,10,20
25756,78,115,2005,92,38,54
25757,78,133,2005,7,4,3
25758,78,65,2005,76,17,59
25759,78,148,2005,6,3,3
25760,78,49,2005,30,16,14
25761,78,74,2005,220,132,88
25762,78,93,2005,341,179,162
25763,78,94,2005,957,555,402
25764,78,130,2005,6,4,2
25765,78,38,2005,9,7,2
25766,78,142,2005,18,8,10
25767,78,50,2005,1772,755,1017
25768,78,114,2005,9,5,4
25769,13,2,2005,392,125,267
25770,13,3,2005,49900,7414,42486
25771,13,10,2005,6038,2965,3073
25772,13,136,2005,256,81,175
25773,13,120,2005,565,181,384
25774,13,119,2005,926,297,629
25775,13,68,2005,693,273,420
25776,13,5,2005,157081,39351,117730
25777,13,18,2005,7772,2862,4910
25778,13,19,2005,3223,1043,2180
25779,13,20,2005,1808,582,1226
25780,13,144,2005,439,141,298
25781,13,8,2005,1066,344,722
25782,13,73,2005,169,72,97
25783,13,162,2005,631,204,427
25784,13,9,2005,46931,11319,35612
25785,13,22,2005,99,66,33
25786,13,23,2005,291,96,195
25787,13,128,2005,512,163,349
25788,13,129,2005,829,305,524
25789,13,145,2005,6869,2532,4337
25790,13,25,2005,2743,878,1865
25791,13,27,2005,3429,1713,1716
25792,13,146,2005,281,90,191
25793,13,26,2005,1984,635,1349
25794,13,142,2005,41784,14532,27252
25795,13,50,2005,1602,593,1009
25796,13,28,2005,10111,3242,6869
25797,3,13,2005,24592,11312,13280
25798,3,105,2005,12165,5595,6570
25799,3,172,2005,145405,66886,78519
25800,3,5,2005,27687,12736,14951
25801,3,177,2005,11317,5205,6112
25802,3,8,2005,24995,11497,13498
25803,3,48,2005,11669,5367,6302
25804,3,1,2005,22153,10190,11963
25805,3,50,2005,27337,12575,14762
25806,79,76,2005,225,141,84
25807,79,78,2005,55,30,25
25808,79,95,2005,15,8,7
25809,79,172,2005,30,13,17
25810,79,81,2005,42,21,21
25811,79,82,2005,426,285,141
25812,79,84,2005,518,332,186
25813,79,110,2005,4640,2551,2089
25814,79,85,2005,24,16,8
25815,79,5,2005,480,238,242
25816,79,86,2005,839,552,287
25817,79,90,2005,78,43,35
25818,79,91,2005,2991,1823,1168
25819,79,92,2005,3648,2113,1535
25820,79,113,2005,33,25,8
25821,79,93,2005,1740,1065,675
25822,79,50,2005,2955,1612,1343
25823,29,2,2005,281,89,192
25824,29,141,2005,53,9,44
25825,29,12,2005,13806,5846,7960
25826,29,103,2005,103,66,37
25827,29,66,2005,59,42,17
25828,29,11,2005,5862,2348,3514
25829,29,67,2005,37,15,22
25830,29,105,2005,93,68,25
25831,29,30,2005,61,29,32
25832,29,81,2005,45,3,42
25833,29,31,2005,95,66,29
25834,29,39,2005,198,81,117
25835,29,120,2005,24,1,23
25836,29,40,2005,3232,2133,1099
25837,29,42,2005,2104,1128,976
25838,29,15,2005,8705,3680,5025
25839,29,69,2005,65,30,35
25840,29,56,2005,109,73,36
25841,29,32,2005,341,213,128
25842,29,5,2005,48,9,39
25843,29,6,2005,49,10,39
25844,29,44,2005,23,16,7
25845,29,17,2005,386,207,179
25846,29,57,2005,23,3,20
25847,29,167,2005,71580,37066,34514
25848,29,18,2005,29,1,28
25849,29,176,2005,60,42,18
25850,29,168,2005,5355,2765,2590
25851,29,20,2005,64,0,64
25852,29,46,2005,10450,7375,3075
25853,29,47,2005,17326,12751,4575
25854,29,48,2005,61,26,35
25855,29,9,2005,47,0,47
25856,29,33,2005,476,257,219
25857,29,35,2005,22,13,9
25858,29,36,2005,698192,386035,312157
25859,29,63,2005,36,13,23
25860,29,37,2005,26,17,9
25861,29,1,2005,366,193,173
25862,29,65,2005,36,18,18
25863,29,49,2005,338,162,176
25864,29,74,2005,28,16,12
25865,29,25,2005,83,0,83
25866,29,169,2005,5811,2840,2971
25867,29,27,2005,22,12,10
25868,29,26,2005,24,1,23
25869,29,170,2005,5592,2863,2729
25870,29,38,2005,230971,119237,111734
25871,29,50,2005,460,289,171
25872,29,114,2005,27,23,4
25873,29,171,2005,15108,7805,7303
25874,29,28,2005,32,6,26
25875,67,2,2005,2479,957,1522
25876,67,51,2005,3277,1584,1693
25877,67,141,2005,18450,7845,10605
25878,67,52,2005,0,0,0
25879,67,134,2005,3201,1561,1640
25880,67,76,2005,0,0,0
25881,67,103,2005,1674,868,806
25882,67,11,2005,332,173,159
25883,67,66,2005,2935,1518,1417
25884,67,12,2005,71,39,32
25885,67,78,2005,26,13,13
25886,67,13,2005,55,0,55
25887,67,3,2005,1608,643,965
25888,67,79,2005,28,20,8
25889,67,29,2005,231,149,82
25890,67,95,2005,0,0,0
25891,67,151,2005,629,228,401
25892,67,4,2005,236,75,161
25893,67,53,2005,215,104,111
25894,67,147,2005,30,21,9
25895,67,105,2005,4948,3199,1749
25896,67,30,2005,4505,2355,2150
25897,67,152,2005,664,268,396
25898,67,116,2005,4238,2201,2037
25899,67,153,2005,540,343,197
25900,67,135,2005,4528,2247,2281
25901,67,80,2005,0,0,0
25902,67,136,2005,304,116,188
25903,67,106,2005,4499,2278,2221
25904,67,172,2005,12247,6426,5821
25905,67,107,2005,4197,2591,1606
25906,67,117,2005,0,0,0
25907,67,137,2005,5235,2583,2652
25908,67,96,2005,181,97,84
25909,67,54,2005,92,50,42
25910,67,81,2005,1206,800,406
25911,67,14,2005,184,95,89
25912,67,31,2005,188,117,71
25913,67,176,2005,1086,637,449
25914,67,137,2005,60825,30915,29910
25915,67,39,2005,2712,1425,1287
25916,67,118,2005,311,151,160
25917,67,82,2005,119,63,56
25918,67,83,2005,1725,1081,644
25919,67,108,2005,2754,1693,1061
25920,67,142,2005,2223,687,1536
25921,67,97,2005,360,211,149
25922,67,138,2005,19,6,13
25923,67,119,2005,4,2,2
25924,67,40,2005,246,166,80
25925,67,148,2005,0,0,0
25926,67,120,2005,1522,732,790
25927,67,42,2005,2672,1639,1033
25928,67,68,2005,144642,75797,68845
25929,67,139,2005,451,221,230
25930,67,155,2005,290,105,185
25931,67,15,2005,128,65,63
25932,67,69,2005,74729,37325,37404
25933,67,156,2005,4979,2442,2537
25934,67,55,2005,0,0,0
25935,67,56,2005,14891,7166,7725
25936,67,84,2005,0,0,0
25937,67,98,2005,538,294,244
25938,67,157,2005,1920,762,1158
25939,67,158,2005,171,99,72
25940,67,110,2005,102,79,23
25941,67,85,2005,1549,740,809
25942,67,99,2005,131,90,41
25943,67,32,2005,3821,2084,1737
25944,67,43,2005,144,76,68
25945,67,5,2005,10615,4175,6440
25946,67,6,2005,4428,1986,2442
25947,67,16,2005,1799,703,1096
25948,67,44,2005,2692,1437,1255
25949,67,17,2005,3574,1585,1989
25950,67,57,2005,125883,57981,67902
25951,67,86,2005,304,185,119
25952,67,177,2005,4238,2268,1970
25953,67,18,2005,564,195,369
25954,67,167,2005,352,209,143
25955,67,121,2005,773,464,309
25956,67,19,2005,116,38,78
25957,67,168,2005,94,52,42
25958,67,46,2005,296,213,83
25959,67,20,2005,3630,1415,2215
25960,67,149,2005,10,7,3
25961,67,159,2005,522,174,348
25962,67,143,2005,302,116,186
25963,67,70,2005,6,4,2
25964,67,47,2005,419,273,146
25965,67,71,2005,11559,4958,6601
25966,67,122,2005,1385,1045,340
25967,67,123,2005,55,25,30
25968,67,7,2005,2,0,2
25969,67,160,2005,417,196,221
25970,67,58,2005,166,85,81
25971,67,161,2005,675,137,538
25972,67,124,2005,3184,2238,946
25973,67,100,2005,1471,894,577
25974,67,72,2005,108,62,46
25975,67,59,2005,0,0,0
25976,67,144,2005,174115,84253,89862
25977,67,125,2005,269,180,89
25978,67,150,2005,41,33,8
25979,67,8,2005,760,303,457
25980,67,73,2005,100812,47097,53715
25981,67,101,2005,203,143,60
25982,67,162,2005,2742,1354,1388
25983,67,60,2005,314,151,163
25984,67,48,2005,1284,650,634
25985,67,21,2005,10,4,6
25986,67,9,2005,6746,2469,4277
25987,67,102,2005,136,90,46
25988,67,111,2005,250,172,78
25989,67,112,2005,2637,1748,889
25990,67,33,2005,23940,12483,11457
25991,67,61,2005,22166,10898,11268
25992,67,22,2005,0,0,0
25993,67,35,2005,10736,5530,5206
25994,67,36,2005,5513,3043,2470
25995,67,126,2005,9853,5222,4631
25996,67,90,2005,0,0,0
25997,67,91,2005,0,0,0
25998,67,92,2005,0,0,0
25999,67,62,2005,16,4,12
26000,67,140,2005,44,26,18
26001,67,23,2005,220,100,120
26002,67,164,2005,2333,912,1421
26003,67,63,2005,1889,1030,859
26004,67,127,2005,66,46,20
26005,67,165,2005,899,316,583
26006,67,37,2005,313,173,140
26007,67,64,2005,48,27,21
26008,67,128,2005,1313,614,699
26009,67,115,2005,3104,1678,1426
26010,67,65,2005,34009,16962,17047
26011,67,10,2005,488,234,254
26012,67,145,2005,341,132,209
26013,67,113,2005,453,282,171
26014,67,49,2005,3674,1948,1726
26015,67,74,2005,4513,2249,2264
26016,67,25,2005,2854,1157,1697
26017,67,169,2005,15,7,8
26018,67,166,2005,1937,801,1136
26019,67,93,2005,0,0,0
26020,67,146,2005,9468,3515,5953
26021,67,26,2005,95863,48842,47021
26022,67,170,2005,2,1,1
26023,67,130,2005,305,143,162
26024,67,38,2005,422,276,146
26025,67,27,2005,0,0,0
26026,67,50,2005,23245,10453,12792
26027,67,131,2005,311,144,167
26028,67,114,2005,442,216,226
26029,67,171,2005,180,103,77
26030,67,1,2005,6840,4266,2574
26031,67,28,2005,101,35,66
26032,67,132,2005,288,144,144
26033,67,133,2005,284,146,138
26034,95,172,2005,1378,618,760
26035,95,97,2005,7059,3421,3638
26036,95,69,2005,53,20,33
26037,95,98,2005,18022,9259,8763
26038,95,85,2005,42,20,22
26039,95,99,2005,6375,3156,3219
26040,95,173,2005,56,27,29
26041,95,5,2005,292,131,161
26042,95,86,2005,412,161,251
26043,95,20,2005,42,12,30
26044,95,100,2005,2764,1297,1467
26045,95,162,2005,35,6,29
26046,95,50,2005,318,123,195
26047,151,136,2005,514,212,302
26048,151,137,2005,1802,879,923
26049,151,68,2005,909,451,458
26050,151,156,2005,7844,4337,3507
26051,151,160,2005,1464,615,849
26052,151,162,2005,49531,23117,26414
26053,151,166,2005,77597,50906,26691
26054,151,152,2005,8487,3638,4849
26055,4,3,2005,41,13,28
26056,4,10,2005,26,12,14
26057,4,172,2005,714,338,376
26058,4,39,2005,30,10,20
26059,4,68,2005,24,12,12
26060,4,69,2005,21,9,12
26061,4,5,2005,35256,6041,29215
26062,4,57,2005,10,3,7
26063,4,177,2005,100,36,64
26064,4,8,2005,565,196,369
26065,4,73,2005,16,5,11
26066,4,9,2005,17,0,17
26067,4,49,2005,18,8,10
26068,4,74,2005,19,4,15
26069,4,50,2005,28,16,12
26070,53,66,2005,188,101,87
26071,53,54,2005,17930,9257,8673
26072,53,68,2005,152,82,70
26073,53,69,2005,530,284,246
26074,53,32,2005,156,107,49
26075,53,57,2005,128,75,53
26076,53,59,2005,3921,2019,1902
26077,53,35,2005,323,256,67
26078,53,36,2005,141,108,33
26079,53,63,2005,14345,7406,6939
26080,53,37,2005,3961,2010,1951
26081,53,64,2005,2072,1272,800
26082,53,60,2005,2671,1409,1262
26083,147,134,2005,1990,991,999
26084,147,10,2005,1028,496,532
26085,147,172,2005,2720,438,2282
26086,147,137,2005,1901,946,955
26087,147,39,2005,200,96,104
26088,147,69,2005,653,299,354
26089,147,5,2005,3936,1698,2238
26090,147,44,2005,364,167,197
26091,147,57,2005,317,113,204
26092,147,121,2005,395,191,204
26093,147,149,2005,1827,847,980
26094,147,122,2005,359,150,209
26095,147,123,2005,1487,592,895
26096,147,124,2005,1055,417,638
26097,147,125,2005,665,287,378
26098,147,150,2005,1208,584,624
26099,147,73,2005,370,151,219
26100,147,162,2005,422,198,224
26101,147,48,2005,227,99,128
26102,147,9,2005,374,166,208
26103,147,61,2005,270,105,165
26104,147,127,2005,147,63,84
26105,147,115,2005,9376,3361,6015
26106,147,133,2005,33411,12999,20412
26107,147,148,2005,391,140,251
26108,147,49,2005,254,99,155
26109,147,130,2005,901,402,499
26110,147,50,2005,1060,621,439
26111,147,131,2005,1664,809,855
26112,147,132,2005,7193,3323,3870
26113,105,2,2005,28,10,18
26114,105,141,2005,91,45,46
26115,105,52,2005,5,0,5
26116,105,134,2005,6418,2977,3441
26117,105,103,2005,28410,12102,16308
26118,105,66,2005,2789,1516,1273
26119,105,78,2005,7,5,2
26120,105,13,2005,13,0,13
26121,105,3,2005,22,0,22
26122,105,11,2005,26,4,22
26123,105,79,2005,13,10,3
26124,105,67,2005,1556,515,1041
26125,105,53,2005,34,18,16
26126,105,95,2005,2,2,0
26127,105,30,2005,261,125,136
26128,105,116,2005,10,0,10
26129,105,29,2005,4,0,4
26130,105,135,2005,69,29,40
26131,105,153,2005,592,329,263
26132,105,106,2005,16352,6572,9780
26133,105,172,2005,14884,6785,8099
26134,105,107,2005,5520,2641,2879
26135,105,137,2005,39,4,35
26136,105,137,2005,48,13,35
26137,105,96,2005,313,142,171
26138,105,54,2005,283,174,109
26139,105,81,2005,1715,709,1006
26140,105,31,2005,806,379,427
26141,105,151,2005,13,4,9
26142,105,39,2005,474,150,324
26143,105,82,2005,10,5,5
26144,105,83,2005,207,155,52
26145,105,108,2005,1463,679,784
26146,105,97,2005,356,106,250
26147,105,138,2005,27,20,7
26148,105,120,2005,5,5,0
26149,105,40,2005,90,64,26
26150,105,42,2005,341,166,175
26151,105,68,2005,9004,3512,5492
26152,105,109,2005,667,278,389
26153,105,139,2005,15,0,15
26154,105,15,2005,31,21,10
26155,105,69,2005,17981,8119,9862
26156,105,156,2005,30,9,21
26157,105,56,2005,2150,875,1275
26158,105,84,2005,13,2,11
26159,105,98,2005,225,90,135
26160,105,157,2005,28,12,16
26161,105,110,2005,1756,889,867
26162,105,85,2005,35,22,13
26163,105,99,2005,131,41,90
26164,105,32,2005,2204,1196,1008
26165,105,43,2005,239,79,160
26166,105,5,2005,824,314,510
26167,105,6,2005,265,125,140
26168,105,16,2005,253,91,162
26169,105,44,2005,196,42,154
26170,105,17,2005,1903,755,1148
26171,105,57,2005,46336,20133,26203
26172,105,86,2005,98,21,77
26173,105,177,2005,60300,29350,30950
26174,105,167,2005,12,12,0
26175,105,18,2005,522,145,377
26176,105,121,2005,22,21,1
26177,105,176,2005,71,28,43
26178,105,19,2005,10,10,0
26179,105,20,2005,14281,5387,8894
26180,105,46,2005,70,55,15
26181,105,159,2005,0,0,0
26182,105,143,2005,0,0,0
26183,105,70,2005,0,0,0
26184,105,47,2005,0,0,0
26185,105,71,2005,0,0,0
26186,105,122,2005,0,0,0
26187,105,123,2005,0,0,0
26188,105,7,2005,0,0,0
26189,105,160,2005,0,0,0
26190,105,58,2005,0,0,0
26191,105,100,2005,1973,898,1075
26192,105,72,2005,0,0,0
26193,105,59,2005,0,0,0
26194,105,144,2005,0,0,0
26195,105,125,2005,1385,663,722
26196,105,21,2005,0,0,0
26197,105,150,2005,0,0,0
26198,105,8,2005,0,0,0
26199,105,73,2005,3426,1125,2301
26200,105,101,2005,436,172,264
26201,105,162,2005,0,0,0
26202,105,48,2005,359,94,265
26203,105,9,2005,215,87,128
26204,105,102,2005,541,208,333
26205,105,111,2005,34146,18279,15867
26206,105,112,2005,12958,5033,7925
26207,105,33,2005,5504,3037,2467
26208,105,61,2005,176510,85541,90969
26209,105,158,2005,468,157,311
26210,105,35,2005,2631,1438,1193
26211,105,36,2005,3974,2398,1576
26212,105,126,2005,0,0,0
26213,105,90,2005,0,0,0
26214,105,91,2005,0,0,0
26215,105,92,2005,0,0,0
26216,105,62,2005,0,0,0
26217,105,140,2005,0,0,0
26218,105,23,2005,0,0,0
26219,105,164,2005,0,0,0
26220,105,63,2005,0,0,0
26221,105,127,2005,0,0,0
26222,105,165,2005,0,0,0
26223,105,37,2005,0,0,0
26224,105,1,2005,0,0,0
26225,105,64,2005,0,0,0
26226,105,115,2005,0,0,0
26227,105,133,2005,0,0,0
26228,105,65,2005,37357,17061,20296
26229,105,113,2005,253,96,157
26230,105,49,2005,677,237,440
26231,105,74,2005,2976,1001,1975
26232,105,25,2005,2688,1163,1525
26233,105,169,2005,0,0,0
26234,105,166,2005,0,0,0
26235,105,93,2005,0,0,0
26236,105,27,2005,0,0,0
26237,105,146,2005,0,0,0
26238,105,26,2005,530,272,258
26239,105,170,2005,0,0,0
26240,105,130,2005,0,0,0
26241,105,38,2005,0,0,0
26242,105,60,2005,0,0,0
26243,105,142,2005,3268,1605,1663
26244,105,50,2005,4506,1716,2790
26245,105,131,2005,0,0,0
26246,105,152,2005,12,7,5
26247,105,114,2005,24495,11790,12705
26248,105,171,2005,0,0,0
26249,30,2,2005,2320,553,1767
26250,30,51,2005,785,377,408
26251,30,141,2005,266,124,142
26252,30,52,2005,1,0,1
26253,30,134,2005,5,3,2
26254,30,75,2005,29,11,18
26255,30,76,2005,4,1,3
26256,30,103,2005,81,45,36
26257,30,11,2005,1246,656,590
26258,30,77,2005,4,1,3
26259,30,66,2005,142,59,83
26260,30,12,2005,1454,804,650
26261,30,78,2005,3,3,0
26262,30,13,2005,6,3,3
26263,30,3,2005,429,211,218
26264,30,79,2005,3,3,0
26265,30,29,2005,443,356,87
26266,30,67,2005,280,114,166
26267,30,95,2005,2,2,0
26268,30,151,2005,22,10,12
26269,30,4,2005,20,9,11
26270,30,53,2005,77,28,49
26271,30,147,2005,20,8,12
26272,30,105,2005,63,37,26
26273,30,152,2005,9,3,6
26274,30,116,2005,12,6,6
26275,30,153,2005,6,2,4
26276,30,135,2005,6,0,6
26277,30,80,2005,2,1,1
26278,30,136,2005,4,1,3
26279,30,106,2005,15,6,9
26280,30,172,2005,657,309,348
26281,30,107,2005,16,6,10
26282,30,137,2005,9,4,5
26283,30,96,2005,4,0,4
26284,30,54,2005,60,29,31
26285,30,81,2005,185,73,112
26286,30,14,2005,187,79,108
26287,30,31,2005,657,397,260
26288,30,176,2005,18,9,9
26289,30,137,2005,11,2,9
26290,30,39,2005,44,13,31
26291,30,118,2005,3,0,3
26292,30,82,2005,1,0,1
26293,30,83,2005,16,10,6
26294,30,108,2005,9,6,3
26295,30,142,2005,96,22,74
26296,30,97,2005,5,2,3
26297,30,119,2005,3,1,2
26298,30,40,2005,41,30,11
26299,30,148,2005,3,3,0
26300,30,120,2005,41,6,35
26301,30,42,2005,40,19,21
26302,30,68,2005,392,160,232
26303,30,139,2005,9,6,3
26304,30,155,2005,8,4,4
26305,30,15,2005,213,125,88
26306,30,69,2005,1457,688,769
26307,30,156,2005,8,5,3
26308,30,55,2005,6,5,1
26309,30,56,2005,3584,1791,1793
26310,30,98,2005,5,4,1
26311,30,157,2005,8,2,6
26312,30,158,2005,4,2,2
26313,30,110,2005,3,1,2
26314,30,85,2005,4,1,3
26315,30,99,2005,2,1,1
26316,30,32,2005,242,150,92
26317,30,43,2005,104,47,57
26318,30,5,2005,137,34,103
26319,30,6,2005,199,46,153
26320,30,16,2005,1325,296,1029
26321,30,44,2005,8,4,4
26322,30,45,2005,0,0,0
26323,30,17,2005,240,96,144
26324,30,57,2005,754,268,486
26325,30,86,2005,5,3,2
26326,30,177,2005,84,42,42
26327,30,18,2005,127,19,108
26328,30,167,2005,672,476,196
26329,30,121,2005,9,5,4
26330,30,19,2005,71,18,53
26331,30,168,2005,60,38,22
26332,30,46,2005,87,67,20
26333,30,20,2005,473,110,363
26334,30,159,2005,4,2,2
26335,30,143,2005,140,67,73
26336,30,70,2005,3,1,2
26337,30,47,2005,75,66,9
26338,30,71,2005,6,3,3
26339,30,122,2005,2,0,2
26340,30,123,2005,0,0,0
26341,30,7,2005,2,1,1
26342,30,160,2005,1,1,0
26343,30,58,2005,25,12,13
26344,30,161,2005,3,0,3
26345,30,124,2005,1,1,0
26346,30,100,2005,18,10,8
26347,30,72,2005,3,2,1
26348,30,59,2005,20,9,11
26349,30,144,2005,57,24,33
26350,30,125,2005,20,8,12
26351,30,150,2005,3,1,2
26352,30,8,2005,4,0,4
26353,30,73,2005,204,71,133
26354,30,101,2005,23,3,20
26355,30,162,2005,57,9,48
26356,30,60,2005,1850,873,977
26357,30,48,2005,66,29,37
26358,30,21,2005,2,0,2
26359,30,9,2005,33,5,28
26360,30,102,2005,5,0,5
26361,30,111,2005,2,0,2
26362,30,112,2005,16,6,10
26363,30,33,2005,895,628,267
26364,30,61,2005,68,31,37
26365,30,22,2005,6,2,4
26366,30,35,2005,4103,2488,1615
26367,30,36,2005,14064,10971,3093
26368,30,126,2005,2,1,1
26369,30,62,2005,3,3,0
26370,30,23,2005,23,10,13
26371,30,164,2005,7,3,4
26372,30,63,2005,1606,864,742
26373,30,127,2005,0,0,0
26374,30,165,2005,1,0,1
26375,30,37,2005,209,158,51
26376,30,64,2005,26,13,13
26377,30,128,2005,3,0,3
26378,30,115,2005,92,50,42
26379,30,65,2005,1057,495,562
26380,30,10,2005,7,2,5
26381,30,145,2005,28,5,23
26382,30,113,2005,1,0,1
26383,30,49,2005,85,36,49
26384,30,74,2005,114,49,65
26385,30,25,2005,942,172,770
26386,30,169,2005,82,46,36
26387,30,166,2005,0,0,0
26388,30,93,2005,0,0,0
26389,30,146,2005,58,15,43
26390,30,26,2005,2822,810,2012
26391,30,170,2005,179,118,61
26392,30,94,2005,3,0,3
26393,30,130,2005,4,1,3
26394,30,38,2005,4311,3364,947
26395,30,27,2005,41,18,23
26396,30,50,2005,2062,920,1142
26397,30,131,2005,11,0,11
26398,30,114,2005,12,5,7
26399,30,171,2005,465,308,157
26400,30,1,2005,494,161,333
26401,30,28,2005,38,8,30
26402,30,132,2005,9,5,4
26403,30,133,2005,20,6,14
26404,152,151,2005,3540,1732,1808
26405,152,156,2005,27293,17541,9752
26406,152,160,2005,37118,21667,15451
26407,152,162,2005,4380,2335,2045
26408,152,164,2005,3417,1550,1867
26409,152,166,2005,13040,8320,4720
26410,116,67,2005,466,242,224
26411,116,137,2005,99099,49131,49968
26412,116,68,2005,232,120,112
26413,116,121,2005,502,219,283
26414,116,126,2005,61104,32291,28813
26415,116,130,2005,805,380,425
26416,116,131,2005,13732,7283,6449
26417,153,134,2005,1283,624,659
26418,153,103,2005,7,5,2
26419,153,67,2005,17,8,9
26420,153,105,2005,203,104,99
26421,153,172,2005,37,19,18
26422,153,81,2005,99,50,49
26423,153,68,2005,183,94,89
26424,153,139,2005,13,5,8
26425,153,155,2005,9,5,4
26426,153,69,2005,53,24,29
26427,153,156,2005,67,34,33
26428,153,157,2005,249,128,121
26429,153,57,2005,349,154,195
26430,153,177,2005,3,2,1
26431,153,71,2005,7,5,2
26432,153,160,2005,11,5,6
26433,153,100,2005,5,1,4
26434,153,125,2005,51,28,23
26435,153,73,2005,59,27,32
26436,153,162,2005,395,206,189
26437,153,112,2005,4,1,3
26438,153,61,2005,1023,513,510
26439,153,158,2005,2984,1304,1680
26440,153,36,2005,382,204,178
26441,153,140,2005,2698,1419,1279
26442,153,164,2005,1025,472,553
26443,153,165,2005,23,13,10
26444,153,65,2005,94,49,45
26445,153,74,2005,21,10,11
26446,153,38,2005,34,16,18
26447,153,50,2005,40,19,21
26448,135,134,2005,2571,1327,1244
26449,135,136,2005,70899,33351,37548
26450,135,137,2005,2972,1497,1475
26451,135,137,2005,4102,1964,2138
26452,135,151,2005,2414,1066,1348
26453,135,138,2005,3377,1777,1600
26454,135,68,2005,4643,2184,2459
26455,135,139,2005,1061,526,535
26456,135,69,2005,296,146,150
26457,135,56,2005,193,65,128
26458,135,157,2005,4605,2383,2222
26459,135,57,2005,511,219,292
26460,135,159,2005,4281,2236,2045
26461,135,160,2005,8251,2491,5760
26462,135,73,2005,160,64,96
26463,135,162,2005,101721,44594,57127
26464,135,164,2005,3172,611,2561
26465,135,50,2005,256,107,149
26466,80,103,2005,12,7,5
26467,80,66,2005,47,10,37
26468,80,78,2005,172,82,90
26469,80,79,2005,180,56,124
26470,80,67,2005,12,5,7
26471,80,105,2005,66,35,31
26472,80,95,2005,326,148,178
26473,80,107,2005,296,139,157
26474,80,96,2005,193,56,137
26475,80,81,2005,693,336,357
26476,80,39,2005,18,6,12
26477,80,83,2005,62,14,48
26478,80,42,2005,10,5,5
26479,80,68,2005,36,14,22
26480,80,69,2005,127,42,85
26481,80,84,2005,16,6,10
26482,80,110,2005,241,108,133
26483,80,85,2005,18,6,12
26484,80,99,2005,1176,699,477
26485,80,5,2005,324,91,233
26486,80,6,2005,10,3,7
26487,80,44,2005,225,113,112
26488,80,17,2005,12,10,2
26489,80,57,2005,85,11,74
26490,80,86,2005,8110,4271,3839
26491,80,177,2005,20,5,15
26492,80,121,2005,34,24,10
26493,80,100,2005,38,20,18
26494,80,73,2005,36,5,31
26495,80,101,2005,543,310,233
26496,80,162,2005,10,0,10
26497,80,9,2005,103,37,66
26498,80,102,2005,127,59,68
26499,80,112,2005,14,10,4
26500,80,88,2005,44,24,20
26501,80,91,2005,10,5,5
26502,80,92,2005,29,7,22
26503,80,115,2005,36,18,18
26504,80,133,2005,18,5,13
26505,80,65,2005,27,16,11
26506,80,74,2005,75,18,57
26507,80,93,2005,312,154,158
26508,80,50,2005,1965,901,1064
26509,80,131,2005,14,13,1
26510,80,132,2005,10,3,7
26511,136,135,2005,25161,13747,11414
26512,136,137,2005,581,319,262
26513,136,137,2005,210,115,95
26514,136,68,2005,720,394,326
26515,136,139,2005,238,131,107
26516,136,143,2005,891,487,404
26517,136,162,2005,2028,1109,919
26518,136,145,2005,247573,135259,112314
26519,106,103,2005,50740,25140,25600
26520,106,105,2005,8477,4421,4056
26521,106,172,2005,3733,1668,2065
26522,106,107,2005,9159,4967,4192
26523,106,81,2005,4479,2106,2373
26524,106,83,2005,406,216,190
26525,106,108,2005,13414,7332,6082
26526,106,68,2005,4655,2224,2431
26527,106,69,2005,8044,4023,4021
26528,106,85,2005,67,29,38
26529,106,57,2005,5552,2485,3067
26530,106,100,2005,2552,1258,1294
26531,106,111,2005,1798,925,873
26532,106,112,2005,80085,47870,32215
26533,106,65,2005,9969,4751,5218
26534,106,114,2005,3359,1591,1768
26535,172,3,2005,1839,978,861
26536,172,105,2005,33986,14071,19915
26537,172,10,2005,2487,1500,987
26538,172,173,2005,68509,27041,41468
26539,172,5,2005,4103,1590,2513
26540,172,177,2005,3123,1143,1980
26541,172,174,2005,9755,4254,5501
26542,172,9,2005,2015,772,1243
26543,172,112,2005,6168,2554,3614
26544,172,36,2005,1356,551,805
26545,172,1,2005,300897,132523,168374
26546,172,50,2005,4168,1455,2713
26547,107,103,2005,2540,1115,1425
26548,107,105,2005,1854,1052,802
26549,107,106,2005,1604,732,872
26550,107,172,2005,1632,723,909
26551,107,96,2005,839,434,405
26552,107,81,2005,1450,559,891
26553,107,83,2005,305,161,144
26554,107,108,2005,11337,5476,5861
26555,107,97,2005,305,134,171
26556,107,68,2005,1640,764,876
26557,107,69,2005,1889,822,1067
26558,107,98,2005,365,192,173
26559,107,99,2005,280,139,141
26560,107,57,2005,2241,793,1448
26561,107,177,2005,576,241,335
26562,107,100,2005,2264,1080,1184
26563,107,73,2005,279,98,181
26564,107,102,2005,1645,881,764
26565,107,112,2005,4026,1682,2344
26566,107,36,2005,538,336,202
26567,107,65,2005,5245,2445,2800
26568,107,74,2005,543,201,342
26569,107,50,2005,993,414,579
26570,107,114,2005,345,131,214
26571,117,68,2005,509,220,289
26572,117,121,2005,81,45,36
26573,117,122,2005,10142,5454,4688
26574,117,131,2005,153,79,74
26575,137,134,2005,15550,8201,7349
26576,137,135,2005,3570,1213,2357
26577,137,136,2005,3338,965,2373
26578,137,172,2005,292,19,273
26579,137,137,2005,230684,107545,123139
26580,137,81,2005,169,98,71
26581,137,151,2005,7171,3357,3814
26582,137,138,2005,500,191,309
26583,137,68,2005,3260,1240,2020
26584,137,139,2005,1000,429,571
26585,137,69,2005,183,83,100
26586,137,20,2005,369,117,252
26587,137,160,2005,10715,2974,7741
26588,137,161,2005,994,192,802
26589,137,61,2005,455,161,294
26590,137,36,2005,814,413,401
26591,137,126,2005,7936,2884,5052
26592,137,164,2005,9227,3967,5260
26593,137,166,2005,770,347,423
26594,137,134,2005,262144,136073,126071
26595,137,116,2005,35973,18330,17643
26596,137,137,2005,9473,4827,4646
26597,137,126,2005,82035,41800,40235
26598,137,129,2005,57568,29333,28235
26599,137,145,2005,16647,8482,8165
26600,137,130,2005,30118,15346,14772
26601,96,2,2005,3,2,1
26602,96,51,2005,3,0,3
26603,96,141,2005,7,4,3
26604,96,134,2005,2,2,0
26605,96,12,2005,2,2,0
26606,96,103,2005,735,381,354
26607,96,66,2005,65,19,46
26608,96,78,2005,7,2,5
26609,96,13,2005,2,0,2
26610,96,3,2005,2,0,2
26611,96,11,2005,4,2,2
26612,96,79,2005,6,3,3
26613,96,67,2005,147,61,86
26614,96,4,2005,3,2,1
26615,96,105,2005,273,139,134
26616,96,95,2005,70,29,41
26617,96,30,2005,36,21,15
26618,96,29,2005,4,2,2
26619,96,135,2005,6,4,2
26620,96,80,2005,5,2,3
26621,96,10,2005,2,0,2
26622,96,106,2005,870,426,444
26623,96,172,2005,147,55,92
26624,96,107,2005,7708,3936,3772
26625,96,137,2005,5,2,3
26626,96,137,2005,2,2,0
26627,96,54,2005,13,6,7
26628,96,81,2005,2878,1366,1512
26629,96,14,2005,2,0,2
26630,96,151,2005,2,2,0
26631,96,39,2005,33,15,18
26632,96,82,2005,4,4,0
26633,96,83,2005,550,366,184
26634,96,108,2005,637,290,347
26635,96,97,2005,6451,3565,2886
26636,96,120,2005,2,0,2
26637,96,40,2005,2,2,0
26638,96,42,2005,12,8,4
26639,96,68,2005,437,195,242
26640,96,109,2005,7,4,3
26641,96,139,2005,2,2,0
26642,96,15,2005,7,4,3
26643,96,69,2005,934,397,537
26644,96,156,2005,2,0,2
26645,96,55,2005,3,3,0
26646,96,56,2005,18,6,12
26647,96,84,2005,5,2,3
26648,96,98,2005,1330,651,679
26649,96,110,2005,15,7,8
26650,96,85,2005,36,16,20
26651,96,99,2005,1963,1121,842
26652,96,173,2005,1643,769,874
26653,96,32,2005,38,18,20
26654,96,43,2005,2,2,0
26655,96,5,2005,28,12,16
26656,96,6,2005,51,11,40
26657,96,16,2005,8,4,4
26658,96,44,2005,16,8,8
26659,96,17,2005,86,32,54
26660,96,57,2005,1066,408,658
26661,96,86,2005,110,63,47
26662,96,177,2005,143,61,82
26663,96,167,2005,4,4,0
26664,96,18,2005,6,2,4
26665,96,121,2005,5,0,5
26666,96,176,2005,19,11,8
26667,96,20,2005,45,16,29
26668,96,46,2005,2,2,0
26669,96,143,2005,6,4,2
26670,96,70,2005,3,2,1
26671,96,47,2005,6,3,3
26672,96,71,2005,8,6,2
26673,96,174,2005,2,0,2
26674,96,122,2005,2,2,0
26675,96,7,2005,2,2,0
26676,96,100,2005,1550,836,714
26677,96,72,2005,2,0,2
26678,96,87,2005,3,2,1
26679,96,144,2005,3,2,1
26680,96,125,2005,3,2,1
26681,96,21,2005,2,0,2
26682,96,8,2005,5,2,3
26683,96,73,2005,294,120,174
26684,96,77,2005,17,6,11
26685,96,101,2005,268157,136889,131268
26686,96,162,2005,2,2,0
26687,96,48,2005,39,16,23
26688,96,9,2005,6,0,6
26689,96,102,2005,6205,2993,3212
26690,96,111,2005,42,30,12
26691,96,112,2005,1893,918,975
26692,96,33,2005,152,87,65
26693,96,61,2005,40,17,23
26694,96,88,2005,179,71,108
26695,96,22,2005,2,2,0
26696,96,35,2005,51,27,24
26697,96,36,2005,300,198,102
26698,96,126,2005,2,2,0
26699,96,90,2005,2,2,0
26700,96,91,2005,2,2,0
26701,96,92,2005,2,0,2
26702,96,23,2005,8,3,5
26703,96,164,2005,2,2,0
26704,96,37,2005,12,5,7
26705,96,1,2005,2,0,2
26706,96,128,2005,2,2,0
26707,96,115,2005,30,18,12
26708,96,133,2005,2,0,2
26709,96,65,2005,1082,477,605
26710,96,145,2005,2,0,2
26711,96,113,2005,11,6,5
26712,96,148,2005,2,0,2
26713,96,49,2005,69,32,37
26714,96,74,2005,337,150,187
26715,96,25,2005,6,2,4
26716,96,93,2005,18,13,5
26717,96,146,2005,3,2,1
26718,96,26,2005,5,3,2
26719,96,130,2005,6,2,4
26720,96,38,2005,79,51,28
26721,96,60,2005,14,7,7
26722,96,142,2005,6,2,4
26723,96,50,2005,261,109,152
26724,96,131,2005,3,2,1
26725,96,114,2005,158,77,81
26726,96,171,2005,2,2,0
26727,54,51,2005,165,88,77
26728,54,141,2005,28,15,13
26729,54,103,2005,185,114,71
26730,54,66,2005,3288,1685,1603
26731,54,29,2005,47,39,8
26732,54,67,2005,285,157,128
26733,54,53,2005,416359,218340,198019
26734,54,105,2005,148,101,47
26735,54,30,2005,283,185,98
26736,54,106,2005,106,67,39
26737,54,172,2005,222,113,109
26738,54,107,2005,23,15,8
26739,54,31,2005,877,661,216
26740,54,39,2005,64,33,31
26741,54,142,2005,123,67,56
26742,54,40,2005,13,8,5
26743,54,42,2005,32,21,11
26744,54,68,2005,1075,573,502
26745,54,69,2005,20667,10635,10032
26746,54,56,2005,137,70,67
26747,54,32,2005,1004,711,293
26748,54,5,2005,34,13,21
26749,54,6,2005,24,11,13
26750,54,16,2005,41,9,32
26751,54,44,2005,32,17,15
26752,54,17,2005,28,9,19
26753,54,57,2005,2365,1193,1172
26754,54,177,2005,28,21,7
26755,54,18,2005,34,4,30
26756,54,167,2005,34,27,7
26757,54,46,2005,24,21,3
26758,54,20,2005,33,8,25
26759,54,143,2005,75,36,39
26760,54,47,2005,22,18,4
26761,54,71,2005,22,14,8
26762,54,100,2005,27,17,10
26763,54,59,2005,3071,1633,1438
26764,54,144,2005,15,9,6
26765,54,73,2005,523,287,236
26766,54,162,2005,15,6,9
26767,54,60,2005,9865,4911,4954
26768,54,48,2005,71,37,34
26769,54,112,2005,63,40,23
26770,54,33,2005,664,538,126
26771,54,61,2005,38,20,18
26772,54,35,2005,405,270,135
26773,54,36,2005,652,529,123
26774,54,63,2005,25928,14521,11407
26775,54,37,2005,585,455,130
26776,54,64,2005,20094,12947,7147
26777,54,115,2005,101,54,47
26778,54,65,2005,123,75,48
26779,54,145,2005,33,9,24
26780,54,49,2005,434,239,195
26781,54,74,2005,1851,936,915
26782,54,25,2005,90,12,78
26783,54,26,2005,43,17,26
26784,54,38,2005,377,296,81
26785,54,50,2005,419,200,219
26786,54,132,2005,23,10,13
26787,81,51,2005,40,18,22
26788,81,141,2005,35,19,16
26789,81,134,2005,84,41,43
26790,81,103,2005,134,76,58
26791,81,30,2005,95,65,30
26792,81,106,2005,155,74,81
26793,81,172,2005,223,63,160
26794,81,107,2005,132,73,59
26795,81,31,2005,136,88,48
26796,81,83,2005,87,58,29
26797,81,108,2005,60,34,26
26798,81,68,2005,134,70,64
26799,81,69,2005,289,155,134
26800,81,84,2005,0,0,0
26801,81,98,2005,56,32,24
26802,81,85,2005,607,215,392
26803,81,32,2005,50,31,19
26804,81,57,2005,246,79,167
26805,81,86,2005,218,123,95
26806,81,20,2005,42,18,24
26807,81,100,2005,331,183,148
26808,81,101,2005,223,150,73
26809,81,102,2005,61,44,17
26810,81,112,2005,78,48,30
26811,81,33,2005,69,50,19
26812,81,88,2005,84,51,33
26813,81,35,2005,68,51,17
26814,81,36,2005,1563,1085,478
26815,81,65,2005,3449,1891,1558
26816,81,38,2005,493,364,129
26817,81,50,2005,47,22,25
26818,14,2,2005,6,2,4
26819,14,51,2005,190,83,107
26820,14,141,2005,25,12,13
26821,14,103,2005,57,25,32
26822,14,11,2005,803,393,410
26823,14,66,2005,243,145,98
26824,14,12,2005,25,15,10
26825,14,13,2005,74,35,39
26826,14,3,2005,1569,31,1538
26827,14,29,2005,232,186,46
26828,14,67,2005,179,97,82
26829,14,151,2005,6,0,6
26830,14,53,2005,47,25,22
26831,14,147,2005,6,3,3
26832,14,105,2005,40,25,15
26833,14,30,2005,4209,3050,1159
26834,14,116,2005,3,0,3
26835,14,135,2005,39,18,21
26836,14,106,2005,33,20,13
26837,14,172,2005,1094,575,519
26838,14,107,2005,87,66,21
26839,14,96,2005,3,3,0
26840,14,54,2005,57,35,22
26841,14,81,2005,25,12,13
26842,14,31,2005,461,315,146
26843,14,176,2005,23,15,8
26844,14,137,2005,468,264,204
26845,14,39,2005,115,68,47
26846,14,118,2005,3,3,0
26847,14,83,2005,7,6,1
26848,14,108,2005,6,3,3
26849,14,142,2005,3545,1528,2017
26850,14,97,2005,7,3,4
26851,14,119,2005,3,3,0
26852,14,40,2005,19,15,4
26853,14,120,2005,55,35,20
26854,14,42,2005,338,261,77
26855,14,68,2005,627,387,240
26856,14,15,2005,10451,5093,5358
26857,14,69,2005,1776,1043,733
26858,14,156,2005,57,29,28
26859,14,55,2005,3,0,3
26860,14,56,2005,16211,7365,8846
26861,14,85,2005,3,3,0
26862,14,99,2005,3,0,3
26863,14,32,2005,237,148,89
26864,14,43,2005,23,18,5
26865,14,5,2005,1880,799,1081
26866,14,6,2005,1128,439,689
26867,14,16,2005,215,71,144
26868,14,44,2005,532,364,168
26869,14,17,2005,262,122,140
26870,14,57,2005,330,175,155
26871,14,86,2005,10,6,4
26872,14,177,2005,57,35,22
26873,14,18,2005,302,116,186
26874,14,167,2005,162,103,59
26875,14,121,2005,57,29,28
26876,14,19,2005,159,71,88
26877,14,168,2005,16,9,7
26878,14,46,2005,112,83,29
26879,14,20,2005,1882,883,999
26880,14,143,2005,156,68,88
26881,14,47,2005,64,52,12
26882,14,71,2005,7,6,1
26883,14,122,2005,6,3,3
26884,14,123,2005,6,3,3
26885,14,58,2005,23,9,14
26886,14,124,2005,7,3,4
26887,14,100,2005,44,29,15
26888,14,144,2005,44,20,24
26889,14,125,2005,7,6,1
26890,14,150,2005,3,0,3
26891,14,8,2005,39,6,33
26892,14,73,2005,330,202,128
26893,14,101,2005,7,3,4
26894,14,162,2005,208,95,113
26895,14,60,2005,13,9,4
26896,14,48,2005,137,91,46
26897,14,21,2005,44,18,26
26898,14,9,2005,1409,97,1312
26899,14,102,2005,13,3,10
26900,14,111,2005,6,6,0
26901,14,112,2005,23,15,8
26902,14,33,2005,484,377,107
26903,14,61,2005,44,32,12
26904,14,88,2005,3,0,3
26905,14,22,2005,7,3,4
26906,14,35,2005,3697,2730,967
26907,14,36,2005,8891,5414,3477
26908,14,23,2005,159,75,84
26909,14,164,2005,6,3,3
26910,14,63,2005,1732,969,763
26911,14,127,2005,6,3,3
26912,14,165,2005,3,0,3
26913,14,37,2005,94,60,34
26914,14,64,2005,10,6,4
26915,14,128,2005,7,3,4
26916,14,115,2005,3395,1925,1470
26917,14,65,2005,107,79,28
26918,14,10,2005,6752,5625,1127
26919,14,145,2005,355,186,169
26920,14,113,2005,3,3,0
26921,14,49,2005,624,424,200
26922,14,74,2005,258,173,85
26923,14,25,2005,2228,557,1671
26924,14,169,2005,6,3,3
26925,14,93,2005,10,9,1
26926,14,146,2005,25,9,16
26927,14,26,2005,418,229,189
26928,14,170,2005,7,6,1
26929,14,130,2005,13,3,10
26930,14,38,2005,2240,1564,676
26931,14,27,2005,103,43,60
26932,14,50,2005,24892,13936,10956
26933,14,131,2005,99,52,47
26934,14,114,2005,3,3,0
26935,14,171,2005,50,29,21
26936,14,1,2005,44,38,6
26937,14,28,2005,10,6,4
26938,14,132,2005,94,63,31
26939,14,133,2005,208,126,82
26940,31,2,2005,221,79,142
26941,31,51,2005,184,61,123
26942,31,141,2005,408,42,366
26943,31,52,2005,4,2,2
26944,31,134,2005,129,19,110
26945,31,76,2005,2,0,2
26946,31,103,2005,133,62,71
26947,31,11,2005,1305,582,723
26948,31,77,2005,0,0,0
26949,31,66,2005,3043,1200,1843
26950,31,12,2005,406,182,224
26951,31,78,2005,0,0,0
26952,31,13,2005,15,2,13
26953,31,3,2005,70,9,61
26954,31,79,2005,4,3,1
26955,31,29,2005,2344,1356,988
26956,31,67,2005,419,138,281
26957,31,95,2005,1,1,0
26958,31,151,2005,28,4,24
26959,31,4,2005,2,1,1
26960,31,53,2005,1713,590,1123
26961,31,147,2005,40,16,24
26962,31,105,2005,188,81,107
26963,31,30,2005,4421,1603,2818
26964,31,152,2005,8,3,5
26965,31,116,2005,2,0,2
26966,31,153,2005,9,4,5
26967,31,135,2005,44,9,35
26968,31,80,2005,0,0,0
26969,31,136,2005,6,1,5
26970,31,106,2005,53,20,33
26971,31,172,2005,2714,1207,1507
26972,31,173,2005,6,4,2
26973,31,107,2005,99,47,52
26974,31,117,2005,1,0,1
26975,31,137,2005,43,12,31
26976,31,96,2005,17,6,11
26977,31,54,2005,1163,397,766
26978,31,81,2005,320,84,236
26979,31,14,2005,56,10,46
26980,31,176,2005,35,18,17
26981,31,137,2005,37,10,27
26982,31,39,2005,172,45,127
26983,31,118,2005,3,2,1
26984,31,82,2005,1,0,1
26985,31,83,2005,18,7,11
26986,31,108,2005,50,19,31
26987,31,142,2005,289,29,260
26988,31,97,2005,9,5,4
26989,31,138,2005,1,1,0
26990,31,119,2005,2,1,1
26991,31,40,2005,83,47,36
26992,31,148,2005,1,1,0
26993,31,120,2005,58,12,46
26994,31,42,2005,200,91,109
26995,31,68,2005,1978,762,1216
26996,31,139,2005,1,0,1
26997,31,155,2005,8,2,6
26998,31,15,2005,607,256,351
26999,31,69,2005,8294,2404,5890
27000,31,156,2005,70,13,57
27001,31,55,2005,0,0,0
27002,31,56,2005,718,282,436
27003,31,84,2005,1,0,1
27004,31,98,2005,18,10,8
27005,31,157,2005,43,10,33
27006,31,158,2005,13,2,11
27007,31,110,2005,4,1,3
27008,31,85,2005,8,4,4
27009,31,99,2005,6,3,3
27010,31,32,2005,1998,939,1059
27011,31,43,2005,19,7,12
27012,31,5,2005,547,140,407
27013,31,6,2005,212,62,150
27014,31,16,2005,298,87,211
27015,31,44,2005,262,62,200
27016,31,17,2005,252,65,187
27017,31,57,2005,1467,244,1223
27018,31,86,2005,7,3,4
27019,31,177,2005,758,373,385
27020,31,18,2005,104,16,88
27021,31,167,2005,2909,1489,1420
27022,31,121,2005,52,16,36
27023,31,19,2005,59,13,46
27024,31,168,2005,415,219,196
27025,31,46,2005,153,96,57
27026,31,20,2005,221,40,181
27027,31,149,2005,3,0,3
27028,31,159,2005,7,3,4
27029,31,143,2005,102,25,77
27030,31,70,2005,1,0,1
27031,31,47,2005,285,154,131
27032,31,71,2005,13,4,9
27033,31,122,2005,20,7,13
27034,31,123,2005,5,3,2
27035,31,7,2005,2,1,1
27036,31,160,2005,19,5,14
27037,31,58,2005,11,4,7
27038,31,161,2005,3,0,3
27039,31,124,2005,15,6,9
27040,31,100,2005,147,60,87
27041,31,72,2005,2,0,2
27042,31,59,2005,46,13,33
27043,31,144,2005,154,22,132
27044,31,125,2005,3,1,2
27045,31,150,2005,14,6,8
27046,31,8,2005,59,12,47
27047,31,73,2005,1330,403,927
27048,31,101,2005,10,2,8
27049,31,162,2005,275,40,235
27050,31,60,2005,1155,236,919
27051,31,48,2005,84,24,60
27052,31,21,2005,0,0,0
27053,31,9,2005,222,42,180
27054,31,102,2005,15,4,11
27055,31,111,2005,24,8,16
27056,31,112,2005,105,38,67
27057,31,33,2005,16032,8872,7160
27058,31,61,2005,78,25,53
27059,31,22,2005,10,6,4
27060,31,35,2005,5109,2244,2865
27061,31,36,2005,18399,10122,8277
27062,31,126,2005,6,1,5
27063,31,90,2005,2,0,2
27064,31,91,2005,2,1,1
27065,31,92,2005,1,0,1
27066,31,62,2005,1,1,0
27067,31,140,2005,1,0,1
27068,31,23,2005,36,3,33
27069,31,164,2005,34,2,32
27070,31,63,2005,1639,608,1031
27071,31,127,2005,1,0,1
27072,31,165,2005,6,2,4
27073,31,37,2005,109909,50468,59441
27074,31,64,2005,182,69,113
27075,31,128,2005,20,9,11
27076,31,115,2005,187,79,108
27077,31,65,2005,306,101,205
27078,31,10,2005,58,17,41
27079,31,145,2005,49,9,40
27080,31,113,2005,4,1,3
27081,31,49,2005,236,63,173
27082,31,74,2005,332,108,224
27083,31,25,2005,396,86,310
27084,31,169,2005,170,58,112
27085,31,166,2005,11,4,7
27086,31,93,2005,3,1,2
27087,31,146,2005,330,29,301
27088,31,26,2005,539,115,424
27089,31,170,2005,91,52,39
27090,31,130,2005,16,8,8
27091,31,38,2005,73905,31832,42073
27092,31,27,2005,25,5,20
27093,31,50,2005,2383,539,1844
27094,31,131,2005,16,5,11
27095,31,114,2005,19,7,12
27096,31,171,2005,1202,312,890
27097,31,1,2005,31521,12287,19234
27098,31,28,2005,122,32,90
27099,31,132,2005,31,10,21
27100,31,133,2005,25,10,15
27101,39,2,2005,6609,3047,3562
27102,39,51,2005,173,96,77
27103,39,141,2005,920,319,601
27104,39,52,2005,1,0,1
27105,39,134,2005,129,68,61
27106,39,76,2005,2,2,0
27107,39,103,2005,1038,536,502
27108,39,11,2005,542,275,267
27109,39,77,2005,3,1,2
27110,39,66,2005,1644,833,811
27111,39,12,2005,187,110,77
27112,39,78,2005,12,8,4
27113,39,13,2005,88,44,44
27114,39,3,2005,551,286,265
27115,39,79,2005,29,11,18
27116,39,29,2005,395,261,134
27117,39,67,2005,1494,733,761
27118,39,95,2005,8,5,3
27119,39,151,2005,44,14,30
27120,39,4,2005,148,72,76
27121,39,53,2005,18774,9295,9479
27122,39,147,2005,66,38,28
27123,39,105,2005,2269,1496,773
27124,39,30,2005,1752,890,862
27125,39,152,2005,39,18,21
27126,39,116,2005,384,218,166
27127,39,153,2005,22,12,10
27128,39,135,2005,347,133,214
27129,39,136,2005,9,2,7
27130,39,106,2005,1397,708,689
27131,39,172,2005,7194,4393,2801
27132,39,173,2005,501,251,250
27133,39,174,2005,0,0,0
27134,39,107,2005,2510,1180,1330
27135,39,117,2005,17,8,9
27136,39,137,2005,376,193,183
27137,39,96,2005,119,46,73
27138,39,54,2005,662,325,337
27139,39,81,2005,301,170,131
27140,39,14,2005,155,89,66
27141,39,31,2005,556,320,236
27142,39,176,2005,305,171,134
27143,39,137,2005,394,187,207
27144,39,118,2005,19,12,7
27145,39,82,2005,10,6,4
27146,39,83,2005,103,72,31
27147,39,108,2005,460,250,210
27148,39,142,2005,1408,467,941
27149,39,97,2005,62,36,26
27150,39,138,2005,0,0,0
27151,39,119,2005,152,82,70
27152,39,40,2005,772,544,228
27153,39,148,2005,44,18,26
27154,39,120,2005,1378,608,770
27155,39,41,2005,10844,6425,4419
27156,39,42,2005,3784,2549,1235
27157,39,68,2005,5206,2300,2906
27158,39,109,2005,0,0,0
27159,39,139,2005,6,3,3
27160,39,155,2005,546,228,318
27161,39,15,2005,143,79,64
27162,39,69,2005,31594,16398,15196
27163,39,156,2005,1318,558,760
27164,39,56,2005,1268,397,871
27165,39,84,2005,9,3,6
27166,39,98,2005,182,96,86
27167,39,157,2005,73,34,39
27168,39,158,2005,39,8,31
27169,39,110,2005,100,70,30
27170,39,85,2005,140,54,86
27171,39,99,2005,91,58,33
27172,39,32,2005,2189,1084,1105
27173,39,43,2005,7339,3789,3550
27174,39,5,2005,6325,3352,2973
27175,39,6,2005,11970,4881,7089
27176,39,16,2005,17558,7649,9909
27177,39,44,2005,1280,497,783
27178,39,17,2005,1568,574,994
27179,39,57,2005,4179,1350,2829
27180,39,86,2005,144,74,70
27181,39,177,2005,1518,1018,500
27182,39,18,2005,1050,436,614
27183,39,167,2005,96,66,30
27184,39,121,2005,1198,671,527
27185,39,19,2005,1155,497,658
27186,39,168,2005,18,13,5
27187,39,46,2005,1681,995,686
27188,39,20,2005,12509,5681,6828
27189,39,149,2005,42,29,13
27190,39,159,2005,130,67,63
27191,39,143,2005,194,71,123
27192,39,70,2005,16,10,6
27193,39,47,2005,3138,1676,1462
27194,39,71,2005,333,163,170
27195,39,122,2005,38,22,16
27196,39,123,2005,64,34,30
27197,39,7,2005,5,4,1
27198,39,160,2005,32,14,18
27199,39,58,2005,79,31,48
27200,39,161,2005,28,15,13
27201,39,124,2005,128,68,60
27202,39,100,2005,691,390,301
27203,39,72,2005,11,5,6
27204,39,59,2005,1018,485,533
27205,39,144,2005,5132,2356,2776
27206,39,125,2005,155,97,58
27207,39,150,2005,48,29,19
27208,39,8,2005,816,266,550
27209,39,73,2005,5666,2413,3253
27210,39,101,2005,153,86,67
27211,39,162,2005,834,329,505
27212,39,60,2005,1967,931,1036
27213,39,48,2005,17961,10989,6972
27214,39,21,2005,16,10,6
27215,39,9,2005,10743,4964,5779
27216,39,102,2005,53,25,28
27217,39,111,2005,60,33,27
27218,39,112,2005,766,486,280
27219,39,33,2005,18914,10312,8602
27220,39,61,2005,939,423,516
27221,39,88,2005,0,0,0
27222,39,22,2005,50,33,17
27223,39,35,2005,4213,2193,2020
27224,39,36,2005,4212,2911,1301
27225,39,126,2005,226,125,101
27226,39,90,2005,0,0,0
27227,39,91,2005,4,2,2
27228,39,92,2005,8,1,7
27229,39,62,2005,1,1,0
27230,39,140,2005,0,0,0
27231,39,23,2005,219,106,113
27232,39,164,2005,107,46,61
27233,39,63,2005,4771,2302,2469
27234,39,127,2005,20,14,6
27235,39,165,2005,292,141,151
27236,39,37,2005,502,244,258
27237,39,64,2005,152,81,71
27238,39,128,2005,10963,5148,5815
27239,39,115,2005,1306,630,676
27240,39,129,2005,0,0,0
27241,39,65,2005,3627,1750,1877
27242,39,10,2005,7994,3995,3999
27243,39,145,2005,438,164,274
27244,39,113,2005,28,13,15
27245,39,49,2005,20591,11890,8701
27246,39,74,2005,2208,1068,1140
27247,39,25,2005,1706,916,790
27248,39,169,2005,16,11,5
27249,39,166,2005,121,39,82
27250,39,93,2005,157,88,69
27251,39,146,2005,802,238,564
27252,39,26,2005,31767,15112,16655
27253,39,170,2005,10,8,2
27254,39,130,2005,1154,714,440
27255,39,38,2005,3585,1637,1948
27256,39,27,2005,257,121,136
27257,39,50,2005,15379,5980,9399
27258,39,131,2005,898,514,384
27259,39,114,2005,212,103,109
27260,39,171,2005,147,82,65
27261,39,1,2005,9215,4712,4503
27262,39,28,2005,148,74,74
27263,39,132,2005,439,271,168
27264,39,133,2005,309,165,144
27265,118,120,2005,10103,5271,4832
27266,118,128,2005,76278,33127,43151
27267,118,28,2005,219,106,113
27268,82,76,2005,357,168,189
27269,82,78,2005,8,5,3
27270,82,79,2005,117,54,63
27271,82,172,2005,27,8,19
27272,82,81,2005,8,8,0
27273,82,68,2005,56,18,38
27274,82,109,2005,16,13,3
27275,82,69,2005,21,13,8
27276,82,110,2005,133,60,73
27277,82,85,2005,1071,546,525
27278,82,5,2005,19,7,12
27279,82,86,2005,91,60,31
27280,82,20,2005,23,5,18
27281,82,87,2005,114,54,60
27282,82,73,2005,7,4,3
27283,82,77,2005,32,21,11
27284,82,162,2005,35,21,14
27285,82,88,2005,12,1,11
27286,82,90,2005,44,26,18
27287,82,75,2005,13,4,9
27288,82,91,2005,198,99,99
27289,82,92,2005,88,38,50
27290,82,113,2005,13,5,8
27291,82,25,2005,12,4,8
27292,82,93,2005,215,88,127
27293,82,50,2005,446,216,230
27294,83,76,2005,248,124,124
27295,83,103,2005,2126,925,1201
27296,83,66,2005,689,135,554
27297,83,78,2005,74,38,36
27298,83,13,2005,23,4,19
27299,83,67,2005,422,167,255
27300,83,4,2005,10,0,10
27301,83,53,2005,6,0,6
27302,83,105,2005,888,480,408
27303,83,30,2005,254,112,142
27304,83,116,2005,4,4,0
27305,83,135,2005,13,6,7
27306,83,153,2005,4,4,0
27307,83,136,2005,4,0,4
27308,83,106,2005,1458,552,906
27309,83,172,2005,2916,1301,1615
27310,83,107,2005,4586,2280,2306
27311,83,96,2005,1096,658,438
27312,83,81,2005,5999,2682,3317
27313,83,31,2005,22,11,11
27314,83,39,2005,55,12,43
27315,83,82,2005,22,8,14
27316,83,108,2005,858,462,396
27317,83,97,2005,351,179,172
27318,83,42,2005,41,17,24
27319,83,68,2005,2515,991,1524
27320,83,69,2005,3899,1544,2355
27321,83,56,2005,88,29,59
27322,83,98,2005,495,182,313
27323,83,110,2005,39,12,27
27324,83,85,2005,270852,100592,170260
27325,83,99,2005,467,237,230
27326,83,32,2005,41,16,25
27327,83,5,2005,221,92,129
27328,83,6,2005,57,7,50
27329,83,16,2005,17,4,13
27330,83,44,2005,47,21,26
27331,83,17,2005,143,32,111
27332,83,57,2005,6061,1791,4270
27333,83,86,2005,321,105,216
27334,83,177,2005,933,443,490
27335,83,167,2005,7,3,4
27336,83,20,2005,511,194,317
27337,83,58,2005,32,19,13
27338,83,100,2005,1775,956,819
27339,83,144,2005,29,10,19
27340,83,73,2005,636,207,429
27341,83,77,2005,278,130,148
27342,83,101,2005,393,212,181
27343,83,162,2005,38,8,30
27344,83,48,2005,67,26,41
27345,83,9,2005,139,26,113
27346,83,102,2005,787,365,422
27347,83,111,2005,50,19,31
27348,83,112,2005,1897,769,1128
27349,83,33,2005,312,266,46
27350,83,61,2005,149,51,98
27351,83,88,2005,8253,4301,3952
27352,83,35,2005,39,21,18
27353,83,36,2005,405,245,160
27354,83,90,2005,112,39,73
27355,83,75,2005,101,43,58
27356,83,23,2005,23,2,21
27357,83,63,2005,145,64,81
27358,83,115,2005,154,66,88
27359,83,65,2005,7852,2976,4876
27360,83,113,2005,76,47,29
27361,83,49,2005,261,196,65
27362,83,74,2005,1806,653,1153
27363,83,25,2005,59,25,34
27364,83,93,2005,72,34,38
27365,83,26,2005,59,26,33
27366,83,94,2005,19,10,9
27367,83,38,2005,110,70,40
27368,83,60,2005,16,5,11
27369,83,50,2005,586,236,350
27370,83,114,2005,1082,655,427
27371,108,2,2005,28,11,17
27372,108,51,2005,36,17,19
27373,108,141,2005,25,7,18
27374,108,134,2005,22,14,8
27375,108,103,2005,2679,1081,1598
27376,108,66,2005,272,116,156
27377,108,78,2005,25,11,14
27378,108,11,2005,20,10,10
27379,108,67,2005,425,204,221
27380,108,105,2005,1317,694,623
27381,108,30,2005,97,52,45
27382,108,135,2005,23,8,15
27383,108,106,2005,5625,2494,3131
27384,108,172,2005,1453,574,879
27385,108,107,2005,94258,49066,45192
27386,108,96,2005,466,245,221
27387,108,54,2005,41,14,27
27388,108,81,2005,1486,650,836
27389,108,31,2005,158,42,116
27390,108,39,2005,92,28,64
27391,108,83,2005,176,97,79
27392,108,97,2005,260,133,127
27393,108,42,2005,63,39,24
27394,108,68,2005,1123,544,579
27395,108,155,2005,17,4,13
27396,108,69,2005,2185,1072,1113
27397,108,156,2005,20,7,13
27398,108,56,2005,36,8,28
27399,108,98,2005,214,108,106
27400,108,85,2005,48,14,34
27401,108,99,2005,234,126,108
27402,108,173,2005,49,21,28
27403,108,32,2005,108,64,44
27404,108,5,2005,114,37,77
27405,108,6,2005,96,27,69
27406,108,16,2005,18,2,16
27407,108,44,2005,100,41,59
27408,108,17,2005,259,98,161
27409,108,57,2005,1907,760,1147
27410,108,86,2005,20,11,9
27411,108,177,2005,365,150,215
27412,108,18,2005,36,8,28
27413,108,176,2005,242,107,135
27414,108,20,2005,220,76,144
27415,108,100,2005,1121,591,530
27416,108,144,2005,25,10,15
27417,108,73,2005,412,179,233
27418,108,101,2005,195,94,101
27419,108,162,2005,25,2,23
27420,108,48,2005,117,59,58
27421,108,9,2005,27,3,24
27422,108,102,2005,479,228,251
27423,108,111,2005,121,55,66
27424,108,112,2005,6798,2719,4079
27425,108,33,2005,156,76,80
27426,108,61,2005,182,66,116
27427,108,88,2005,249,119,130
27428,108,35,2005,150,83,67
27429,108,36,2005,742,463,279
27430,108,23,2005,45,17,28
27431,108,37,2005,25,14,11
27432,108,1,2005,25,11,14
27433,108,115,2005,61,18,43
27434,108,65,2005,3707,1780,1927
27435,108,49,2005,174,80,94
27436,108,74,2005,974,324,650
27437,108,25,2005,33,10,23
27438,108,93,2005,23,14,9
27439,108,38,2005,200,110,90
27440,108,60,2005,2,2,0
27441,108,142,2005,42,14,28
27442,108,50,2005,1071,492,579
27443,108,114,2005,476,174,302
27444,142,2,2005,183,41,142
27445,142,51,2005,105,39,66
27446,142,141,2005,771,490,281
27447,142,134,2005,25,12,13
27448,142,76,2005,15,8,7
27449,142,12,2005,29,1,28
27450,142,103,2005,218,83,135
27451,142,66,2005,526,284,242
27452,142,78,2005,13,10,3
27453,142,13,2005,350,173,177
27454,142,3,2005,221,25,196
27455,142,11,2005,140,83,57
27456,142,67,2005,489,240,249
27457,142,53,2005,55,26,29
27458,142,105,2005,114,66,48
27459,142,30,2005,60,34,26
27460,142,116,2005,32,3,29
27461,142,29,2005,243,136,107
27462,142,135,2005,110,18,92
27463,142,10,2005,195,82,113
27464,142,136,2005,290,102,188
27465,142,106,2005,24,11,13
27466,142,172,2005,669,209,460
27467,142,107,2005,51,12,39
27468,142,117,2005,791,139,652
27469,142,137,2005,65,20,45
27470,142,137,2005,114,39,75
27471,142,54,2005,90,20,70
27472,142,14,2005,75,34,41
27473,142,31,2005,176,98,78
27474,142,151,2005,32,1,31
27475,142,39,2005,263,125,138
27476,142,108,2005,11,8,3
27477,142,97,2005,185,101,84
27478,142,120,2005,569,316,253
27479,142,119,2005,462,219,243
27480,142,40,2005,23,11,12
27481,142,42,2005,217,122,95
27482,142,68,2005,2487,1133,1354
27483,142,118,2005,323,123,200
27484,142,155,2005,26,7,19
27485,142,69,2005,6725,3019,3706
27486,142,156,2005,205,49,156
27487,142,55,2005,8,3,5
27488,142,56,2005,1112,621,491
27489,142,98,2005,8,4,4
27490,142,157,2005,125,11,114
27491,142,32,2005,117,67,50
27492,142,5,2005,1083,382,701
27493,142,6,2005,132,54,78
27494,142,16,2005,9278,4587,4691
27495,142,44,2005,83,49,34
27496,142,17,2005,617,240,377
27497,142,57,2005,3641,1672,1969
27498,142,177,2005,1004,466,538
27499,142,167,2005,185,82,103
27500,142,18,2005,4567,2018,2549
27501,142,121,2005,120,38,82
27502,142,176,2005,90,35,55
27503,142,19,2005,2605,933,1672
27504,142,168,2005,55,12,43
27505,142,20,2005,2767,1511,1256
27506,142,159,2005,42,17,25
27507,142,143,2005,4368,1888,2480
27508,142,122,2005,36,2,34
27509,142,123,2005,25,4,21
27510,142,7,2005,25,7,18
27511,142,160,2005,188,40,148
27512,142,161,2005,136,36,100
27513,142,100,2005,57,36,21
27514,142,72,2005,71,35,36
27515,142,144,2005,924,677,247
27516,142,125,2005,15,6,9
27517,142,21,2005,473,157,316
27518,142,150,2005,233,147,86
27519,142,73,2005,864,431,433
27520,142,162,2005,706,187,519
27521,142,48,2005,106,46,60
27522,142,9,2005,538,181,357
27523,142,33,2005,331,164,167
27524,142,61,2005,40,21,19
27525,142,158,2005,81,1,80
27526,142,22,2005,348,132,216
27527,142,35,2005,211,118,93
27528,142,36,2005,6521,3939,2582
27529,142,126,2005,39,8,31
27530,142,23,2005,7128,2537,4591
27531,142,164,2005,370,69,301
27532,142,127,2005,18,6,12
27533,142,165,2005,55,29,26
27534,142,37,2005,55,31,24
27535,142,128,2005,17739,7274,10465
27536,142,115,2005,195,80,115
27537,142,133,2005,30,6,24
27538,142,65,2005,361,170,191
27539,142,129,2005,0,0,0
27540,142,145,2005,24677,9771,14906
27541,142,49,2005,308,133,175
27542,142,74,2005,1188,548,640
27543,142,25,2005,6606,2883,3723
27544,142,169,2005,113,31,82
27545,142,27,2005,623,248,375
27546,142,146,2005,681,361,320
27547,142,26,2005,779,217,562
27548,142,170,2005,42,11,31
27549,142,130,2005,76,12,64
27550,142,38,2005,149,95,54
27551,142,60,2005,105,41,64
27552,142,50,2005,2737,1235,1502
27553,142,131,2005,127,28,99
27554,142,152,2005,57,8,49
27555,142,171,2005,98,20,78
27556,142,28,2005,4961,1958,3003
27557,142,132,2005,23,7,16
27558,97,103,2005,187,75,112
27559,97,66,2005,11,6,5
27560,97,3,2005,6,0,6
27561,97,79,2005,37,19,18
27562,97,67,2005,50,25,25
27563,97,105,2005,215,118,97
27564,97,95,2005,272,144,128
27565,97,106,2005,214,109,105
27566,97,172,2005,218,83,135
27567,97,107,2005,458,239,219
27568,97,96,2005,829,442,387
27569,97,81,2005,102,46,56
27570,97,83,2005,56,26,30
27571,97,108,2005,108,58,50
27572,97,68,2005,178,75,103
27573,97,69,2005,224,95,129
27574,97,98,2005,7367,3950,3417
27575,97,99,2005,10362,6079,4283
27576,97,173,2005,8,4,4
27577,97,5,2005,11,4,7
27578,97,6,2005,16,6,10
27579,97,44,2005,12,5,7
27580,97,17,2005,55,30,25
27581,97,57,2005,252,87,165
27582,97,86,2005,10,4,6
27583,97,177,2005,44,13,31
27584,97,100,2005,1541,841,700
27585,97,73,2005,34,12,22
27586,97,101,2005,6024,2882,3142
27587,97,102,2005,394,214,180
27588,97,111,2005,13,6,7
27589,97,112,2005,198,83,115
27590,97,61,2005,12,3,9
27591,97,88,2005,59,27,32
27592,97,36,2005,17,10,7
27593,97,65,2005,493,212,281
27594,97,49,2005,30,11,19
27595,97,74,2005,54,29,25
27596,97,50,2005,82,33,49
27597,97,114,2005,70,24,46
27598,138,135,2005,486,164,322
27599,138,68,2005,2776,1524,1252
27600,138,139,2005,156,69,87
27601,138,162,2005,219,103,116
27602,138,140,2005,909,361,548
27603,138,65,2005,779,321,458
27604,119,134,2005,424,187,237
27605,119,116,2005,1189,560,629
27606,119,172,2005,102,10,92
27607,119,117,2005,125,61,64
27608,119,137,2005,1273,591,682
27609,119,120,2005,1554,722,832
27610,119,68,2005,283,140,143
27611,119,5,2005,83,52,31
27612,119,121,2005,248,109,139
27613,119,123,2005,487,228,259
27614,119,125,2005,876,523,353
27615,119,126,2005,385,206,179
27616,119,128,2005,3657,1701,1956
27617,119,115,2005,136,56,80
27618,119,133,2005,215,64,151
27619,119,129,2005,1214,469,745
27620,119,145,2005,170,66,104
27621,119,130,2005,1187,424,763
27622,119,50,2005,44,29,15
27623,119,131,2005,394,194,200
27624,119,132,2005,172,63,109
27625,40,2,2005,0,0,0
27626,40,51,2005,0,0,0
27627,40,141,2005,0,0,0
27628,40,52,2005,0,0,0
27629,40,134,2005,0,0,0
27630,40,76,2005,0,0,0
27631,40,103,2005,0,0,0
27632,40,11,2005,645,256,389
27633,40,66,2005,0,0,0
27634,40,12,2005,1525,624,901
27635,40,13,2005,0,0,0
27636,40,3,2005,0,0,0
27637,40,79,2005,0,0,0
27638,40,29,2005,13834,8110,5724
27639,40,67,2005,0,0,0
27640,40,95,2005,0,0,0
27641,40,151,2005,0,0,0
27642,40,4,2005,0,0,0
27643,40,53,2005,0,0,0
27644,40,105,2005,0,0,0
27645,40,30,2005,0,0,0
27646,40,153,2005,0,0,0
27647,40,135,2005,0,0,0
27648,40,106,2005,0,0,0
27649,40,172,2005,163,82,81
27650,40,173,2005,0,0,0
27651,40,107,2005,0,0,0
27652,40,137,2005,0,0,0
27653,40,96,2005,0,0,0
27654,40,54,2005,0,0,0
27655,40,81,2005,0,0,0
27656,40,14,2005,0,0,0
27657,40,31,2005,0,0,0
27658,40,176,2005,0,0,0
27659,40,137,2005,0,0,0
27660,40,39,2005,94,27,67
27661,40,83,2005,0,0,0
27662,40,108,2005,0,0,0
27663,40,142,2005,0,0,0
27664,40,97,2005,0,0,0
27665,40,120,2005,0,0,0
27666,40,41,2005,0,0,0
27667,40,42,2005,1891,809,1082
27668,40,68,2005,151,64,87
27669,40,155,2005,0,0,0
27670,40,15,2005,1592,798,794
27671,40,69,2005,1174,556,618
27672,40,156,2005,0,0,0
27673,40,55,2005,0,0,0
27674,40,56,2005,0,0,0
27675,40,98,2005,0,0,0
27676,40,157,2005,0,0,0
27677,40,110,2005,0,0,0
27678,40,99,2005,0,0,0
27679,40,32,2005,88,46,42
27680,40,43,2005,0,0,0
27681,40,5,2005,82,21,61
27682,40,6,2005,0,0,0
27683,40,16,2005,0,0,0
27684,40,44,2005,0,0,0
27685,40,17,2005,0,0,0
27686,40,57,2005,0,0,0
27687,40,86,2005,0,0,0
27688,40,177,2005,0,0,0
27689,40,18,2005,0,0,0
27690,40,167,2005,3968,2227,1741
27691,40,121,2005,0,0,0
27692,40,19,2005,0,0,0
27693,40,168,2005,581,324,257
27694,40,46,2005,4292,2484,1808
27695,40,20,2005,0,0,0
27696,40,143,2005,0,0,0
27697,40,70,2005,0,0,0
27698,40,47,2005,2052,1183,869
27699,40,71,2005,0,0,0
27700,40,122,2005,0,0,0
27701,40,123,2005,0,0,0
27702,40,58,2005,0,0,0
27703,40,161,2005,0,0,0
27704,40,124,2005,0,0,0
27705,40,100,2005,0,0,0
27706,40,72,2005,0,0,0
27707,40,59,2005,0,0,0
27708,40,144,2005,0,0,0
27709,40,125,2005,0,0,0
27710,40,150,2005,0,0,0
27711,40,8,2005,0,0,0
27712,40,73,2005,0,0,0
27713,40,101,2005,0,0,0
27714,40,162,2005,0,0,0
27715,40,60,2005,0,0,0
27716,40,48,2005,0,0,0
27717,40,21,2005,0,0,0
27718,40,9,2005,0,0,0
27719,40,102,2005,0,0,0
27720,40,111,2005,0,0,0
27721,40,112,2005,0,0,0
27722,40,33,2005,550,310,240
27723,40,61,2005,0,0,0
27724,40,22,2005,0,0,0
27725,40,35,2005,0,0,0
27726,40,36,2005,172571,107100,65471
27727,40,126,2005,0,0,0
27728,40,90,2005,0,0,0
27729,40,23,2005,0,0,0
27730,40,164,2005,0,0,0
27731,40,63,2005,0,0,0
27732,40,165,2005,0,0,0
27733,40,37,2005,0,0,0
27734,40,64,2005,0,0,0
27735,40,128,2005,0,0,0
27736,40,115,2005,0,0,0
27737,40,65,2005,0,0,0
27738,40,10,2005,0,0,0
27739,40,145,2005,0,0,0
27740,40,113,2005,0,0,0
27741,40,49,2005,321,113,208
27742,40,74,2005,0,0,0
27743,40,25,2005,0,0,0
27744,40,169,2005,381,196,185
27745,40,166,2005,0,0,0
27746,40,93,2005,0,0,0
27747,40,146,2005,0,0,0
27748,40,26,2005,0,0,0
27749,40,170,2005,366,223,143
27750,40,130,2005,0,0,0
27751,40,38,2005,24004,12323,11681
27752,40,27,2005,0,0,0
27753,40,50,2005,295,92,203
27754,40,131,2005,0,0,0
27755,40,114,2005,0,0,0
27756,40,171,2005,1133,613,520
27757,40,1,2005,0,0,0
27758,40,28,2005,0,0,0
27759,40,132,2005,0,0,0
27760,40,133,2005,0,0,0
27761,148,134,2005,219,113,106
27762,148,147,2005,69,39,30
27763,148,116,2005,337,177,160
27764,148,137,2005,49,25,24
27765,148,137,2005,246,126,120
27766,148,120,2005,20,10,10
27767,148,149,2005,167,137,30
27768,148,159,2005,29,14,15
27769,148,125,2005,11345,4622,6723
27770,148,126,2005,195,102,93
27771,148,128,2005,156,79,77
27772,148,115,2005,12415,6768,5647
27773,148,130,2005,39,20,19
27774,120,116,2005,26,12,14
27775,120,137,2005,66,29,37
27776,120,119,2005,10700,4513,6187
27777,120,118,2005,2389,1027,1362
27778,120,126,2005,97,42,55
27779,120,128,2005,285575,147020,138555
27780,120,129,2005,96365,41353,55012
27781,120,145,2005,73927,31181,42746
27782,120,130,2005,141,61,80
27783,120,28,2005,94,40,54
27784,41,105,2005,18,4,14
27785,41,30,2005,10,4,6
27786,41,172,2005,7,6,1
27787,41,107,2005,43,19,24
27788,41,54,2005,25,11,14
27789,41,39,2005,3137,1409,1728
27790,41,120,2005,5,1,4
27791,41,69,2005,20,8,12
27792,41,156,2005,5,4,1
27793,41,43,2005,241,104,137
27794,41,5,2005,56,36,20
27795,41,121,2005,2,0,2
27796,41,47,2005,11,8,3
27797,41,48,2005,153,74,79
27798,41,112,2005,2,2,0
27799,41,33,2005,69,19,50
27800,41,35,2005,48,23,25
27801,41,36,2005,30,19,11
27802,41,63,2005,35,15,20
27803,41,115,2005,6,5,1
27804,41,49,2005,58,25,33
27805,41,146,2005,7,1,6
27806,41,50,2005,86,49,37
27807,42,2,2005,1604,713,891
27808,42,51,2005,114,20,94
27809,42,141,2005,539,98,441
27810,42,52,2005,2,0,2
27811,42,134,2005,227,85,142
27812,42,76,2005,0,0,0
27813,42,103,2005,217,89,128
27814,42,11,2005,47,29,18
27815,42,77,2005,0,0,0
27816,42,66,2005,397,174,223
27817,42,12,2005,48,29,19
27818,42,78,2005,6,3,3
27819,42,13,2005,10,3,7
27820,42,3,2005,875,244,631
27821,42,79,2005,10,2,8
27822,42,29,2005,131,75,56
27823,42,67,2005,321,115,206
27824,42,95,2005,2,1,1
27825,42,151,2005,4,1,3
27826,42,4,2005,2,1,1
27827,42,53,2005,404,190,214
27828,42,147,2005,8,3,5
27829,42,105,2005,631,361,270
27830,42,30,2005,788,348,440
27831,42,152,2005,4,1,3
27832,42,116,2005,24,10,14
27833,42,153,2005,6,2,4
27834,42,135,2005,284,99,185
27835,42,136,2005,5,1,4
27836,42,106,2005,282,144,138
27837,42,172,2005,4541,2583,1958
27838,42,107,2005,619,291,328
27839,42,117,2005,3,1,2
27840,42,137,2005,55,26,29
27841,42,96,2005,38,15,23
27842,42,54,2005,139,68,71
27843,42,81,2005,241,92,149
27844,42,14,2005,96,24,72
27845,42,31,2005,441,217,224
27846,42,176,2005,2,2,0
27847,42,137,2005,680,309,371
27848,42,39,2005,745,296,449
27849,42,118,2005,4,3,1
27850,42,82,2005,2,0,2
27851,42,83,2005,81,37,44
27852,42,108,2005,103,44,59
27853,42,142,2005,584,96,488
27854,42,97,2005,34,19,15
27855,42,138,2005,5,3,2
27856,42,119,2005,38,21,17
27857,42,40,2005,16258,8484,7774
27858,42,148,2005,0,0,0
27859,42,120,2005,1073,442,631
27860,42,68,2005,1461,544,917
27861,42,139,2005,4,3,1
27862,42,155,2005,307,54,253
27863,42,15,2005,23,13,10
27864,42,69,2005,4573,1872,2701
27865,42,156,2005,601,166,435
27866,42,56,2005,560,115,445
27867,42,84,2005,0,0,0
27868,42,98,2005,46,16,30
27869,42,157,2005,32,6,26
27870,42,158,2005,5,1,4
27871,42,110,2005,14,7,7
27872,42,85,2005,7,2,5
27873,42,99,2005,27,17,10
27874,42,32,2005,1177,530,647
27875,42,43,2005,129,54,75
27876,42,5,2005,2545,942,1603
27877,42,6,2005,3019,1233,1786
27878,42,16,2005,5065,1990,3075
27879,42,44,2005,309,78,231
27880,42,17,2005,563,167,396
27881,42,57,2005,1331,343,988
27882,42,86,2005,44,17,27
27883,42,177,2005,864,488,376
27884,42,18,2005,180,50,130
27885,42,167,2005,108,62,46
27886,42,121,2005,556,276,280
27887,42,19,2005,87,29,58
27888,42,168,2005,19,11,8
27889,42,46,2005,662,378,284
27890,42,20,2005,380,125,255
27891,42,159,2005,71,20,51
27892,42,143,2005,106,35,71
27893,42,47,2005,388,233,155
27894,42,71,2005,53,26,27
27895,42,122,2005,8,6,2
27896,42,123,2005,8,3,5
27897,42,7,2005,1,0,1
27898,42,160,2005,4,0,4
27899,42,58,2005,25,7,18
27900,42,161,2005,4,0,4
27901,42,124,2005,31,14,17
27902,42,100,2005,334,147,187
27903,42,72,2005,3,0,3
27904,42,59,2005,2,1,1
27905,42,144,2005,1292,297,995
27906,42,125,2005,39,23,16
27907,42,150,2005,49,29,20
27908,42,8,2005,631,149,482
27909,42,73,2005,967,244,723
27910,42,101,2005,66,36,30
27911,42,162,2005,843,147,696
27912,42,60,2005,0,0,0
27913,42,48,2005,1189,556,633
27914,42,21,2005,4,3,1
27915,42,9,2005,860,252,608
27916,42,102,2005,17,5,12
27917,42,111,2005,10,5,5
27918,42,112,2005,291,154,137
27919,42,33,2005,1926,937,989
27920,42,61,2005,245,75,170
27921,42,22,2005,9,3,6
27922,42,35,2005,1156,500,656
27923,42,36,2005,4366,2526,1840
27924,42,126,2005,137,69,68
27925,42,90,2005,1,0,1
27926,42,91,2005,2,1,1
27927,42,92,2005,3,0,3
27928,42,62,2005,0,0,0
27929,42,23,2005,211,102,109
27930,42,164,2005,81,15,66
27931,42,63,2005,1296,602,694
27932,42,127,2005,4,3,1
27933,42,165,2005,74,17,57
27934,42,37,2005,68,25,43
27935,42,64,2005,16,6,10
27936,42,128,2005,5928,2720,3208
27937,42,115,2005,411,165,246
27938,42,129,2005,0,0,0
27939,42,65,2005,1183,447,736
27940,42,10,2005,511,223,288
27941,42,145,2005,0,0,0
27942,42,113,2005,3,1,2
27943,42,49,2005,27840,13134,14706
27944,42,74,2005,731,294,437
27945,42,25,2005,296,109,187
27946,42,169,2005,20,10,10
27947,42,166,2005,33,6,27
27948,42,93,2005,20,10,10
27949,42,146,2005,415,70,345
27950,42,26,2005,3569,893,2676
27951,42,170,2005,12,7,5
27952,42,94,2005,0,0,0
27953,42,130,2005,80,36,44
27954,42,38,2005,589,334,255
27955,42,27,2005,56,17,39
27956,42,50,2005,3504,975,2529
27957,42,131,2005,294,111,183
27958,42,114,2005,64,21,43
27959,42,171,2005,50,26,24
27960,42,1,2005,3535,1864,1671
27961,42,28,2005,28,12,16
27962,42,132,2005,107,60,47
27963,42,133,2005,42,16,26
27964,68,2,2005,3409,1463,1946
27965,68,51,2005,5747,2732,3015
27966,68,141,2005,1337210,660830,676380
27967,68,52,2005,980,537,443
27968,68,134,2005,14835,7085,7750
27969,68,75,2005,123,83,40
27970,68,76,2005,103,63,40
27971,68,103,2005,11825,6522,5303
27972,68,11,2005,12278,6611,5667
27973,68,77,2005,67,41,26
27974,68,66,2005,12167,7380,4787
27975,68,12,2005,2560,1371,1189
27976,68,78,2005,42,26,16
27977,68,13,2005,143,71,72
27978,68,3,2005,3164,1123,2041
27979,68,79,2005,69,35,34
27980,68,29,2005,2388,1657,731
27981,68,67,2005,138343,77562,60781
27982,68,95,2005,12,1,11
27983,68,151,2005,17643,7979,9664
27984,68,4,2005,44,9,35
27985,68,53,2005,11323,5645,5678
27986,68,147,2005,48,26,22
27987,68,105,2005,42128,23241,18887
27988,68,30,2005,13222,7728,5494
27989,68,152,2005,6972,3406,3566
27990,68,116,2005,1493,817,676
27991,68,153,2005,18180,9898,8282
27992,68,135,2005,63768,36658,27110
27993,68,136,2005,6219,2910,3309
27994,68,106,2005,13011,6735,6276
27995,68,172,2005,70951,39450,31501
27996,68,173,2005,1415,787,628
27997,68,174,2005,67,34,33
27998,68,107,2005,22163,12116,10047
27999,68,117,2005,30384,15304,15080
28000,68,137,2005,57496,28974,28522
28001,68,96,2005,640,391,249
28002,68,54,2005,9031,4484,4547
28003,68,81,2005,3744,2132,1612
28004,68,14,2005,937,454,483
28005,68,31,2005,4616,2914,1702
28006,68,176,2005,80,50,30
28007,68,137,2005,49330,25702,23628
28008,68,39,2005,6496,3888,2608
28009,68,118,2005,6015,3072,2943
28010,68,82,2005,7416,4964,2452
28011,68,83,2005,4454,3143,1311
28012,68,108,2005,3500,2100,1400
28013,68,142,2005,26659,9479,17180
28014,68,97,2005,1418,624,794
28015,68,138,2005,347,250,97
28016,68,119,2005,270,167,103
28017,68,40,2005,786,524,262
28018,68,148,2005,26,16,10
28019,68,120,2005,5594,3216,2378
28020,68,41,2005,3,3,0
28021,68,42,2005,3613,2630,983
28022,68,139,2005,17241,9541,7700
28023,68,155,2005,1546,670,876
28024,68,15,2005,5304,2713,2591
28025,68,69,2005,222726,128611,94115
28026,68,156,2005,5389,2800,2589
28027,68,55,2005,20,7,13
28028,68,56,2005,11470,5887,5583
28029,68,98,2005,2817,1345,1472
28030,68,157,2005,21387,9787,11600
28031,68,158,2005,2476,860,1616
28032,68,110,2005,4226,2152,2074
28033,68,85,2005,67078,37038,30040
28034,68,99,2005,453,295,158
28035,68,32,2005,9674,5046,4628
28036,68,43,2005,398,214,184
28037,68,5,2005,41118,20199,20919
28038,68,6,2005,20643,9794,10849
28039,68,16,2005,4953,2095,2858
28040,68,44,2005,8596,4763,3833
28041,68,45,2005,12,10,2
28042,68,17,2005,8559,4303,4256
28043,68,57,2005,373839,192874,180965
28044,68,86,2005,732,458,274
28045,68,177,2005,18116,12212,5904
28046,68,18,2005,1173,484,689
28047,68,167,2005,1897,1194,703
28048,68,121,2005,1328,760,568
28049,68,19,2005,651,294,357
28050,68,168,2005,454,319,135
28051,68,46,2005,1852,1004,848
28052,68,20,2005,42108,18119,23989
28053,68,149,2005,60,27,33
28054,68,159,2005,645,283,362
28055,68,143,2005,1800,805,995
28056,68,70,2005,32,13,19
28057,68,47,2005,2048,1252,796
28058,68,71,2005,12062,6689,5373
28059,68,122,2005,106558,61213,45345
28060,68,123,2005,133,65,68
28061,68,7,2005,8,4,4
28062,68,160,2005,57153,22466,34687
28063,68,58,2005,472,286,186
28064,68,161,2005,12537,4296,8241
28065,68,124,2005,38979,23222,15757
28066,68,100,2005,9332,5533,3799
28067,68,72,2005,16581,8272,8309
28068,68,59,2005,1147,563,584
28069,68,87,2005,18,5,13
28070,68,144,2005,832641,400859,431782
28071,68,125,2005,1036,506,530
28072,68,150,2005,103,58,45
28073,68,8,2005,1007,522,485
28074,68,73,2005,37519,19930,17589
28075,68,101,2005,472,296,176
28076,68,162,2005,3986,1977,2009
28077,68,60,2005,3711,1859,1852
28078,68,48,2005,3173,1875,1298
28079,68,21,2005,89,25,64
28080,68,9,2005,16544,6497,10047
28081,68,102,2005,385,235,150
28082,68,111,2005,699,415,284
28083,68,112,2005,9822,5709,4113
28084,68,33,2005,101024,64872,36152
28085,68,61,2005,586242,287268,298974
28086,68,88,2005,51,25,26
28087,68,22,2005,64,24,40
28088,68,35,2005,43381,23506,19875
28089,68,36,2005,34476,22068,12408
28090,68,126,2005,4950,2631,2319
28091,68,90,2005,114,74,40
28092,68,91,2005,4341,2694,1647
28093,68,92,2005,45,27,18
28094,68,62,2005,278,163,115
28095,68,140,2005,757,398,359
28096,68,23,2005,2165,924,1241
28097,68,164,2005,99224,45780,53444
28098,68,63,2005,17288,8388,8900
28099,68,127,2005,538,346,192
28100,68,165,2005,975,412,563
28101,68,37,2005,3290,2082,1208
28102,68,64,2005,2853,1651,1202
28103,68,128,2005,1464,768,696
28104,68,115,2005,4182,2229,1953
28105,68,65,2005,306067,171179,134888
28106,68,10,2005,34159,16400,17759
28107,68,145,2005,2075,718,1357
28108,68,113,2005,22274,11489,10785
28109,68,49,2005,9125,5993,3132
28110,68,74,2005,84249,46229,38020
28111,68,25,2005,15414,6404,9010
28112,68,169,2005,146,95,51
28113,68,166,2005,19915,9608,10307
28114,68,93,2005,417,273,144
28115,68,146,2005,362087,165682,196405
28116,68,26,2005,229714,106342,123372
28117,68,170,2005,156,115,41
28118,68,94,2005,1,1,0
28119,68,130,2005,343,196,147
28120,68,38,2005,12020,8091,3929
28121,68,27,2005,641,319,322
28122,68,50,2005,143491,72579,70912
28123,68,131,2005,526,308,218
28124,68,114,2005,2114,1142,972
28125,68,171,2005,728,506,222
28126,68,1,2005,118704,63614,55090
28127,68,28,2005,342,165,177
28128,68,132,2005,372,190,182
28129,68,133,2005,475,251,224
28130,109,141,2005,88,46,42
28131,109,67,2005,137,72,65
28132,109,105,2005,11989,5951,6038
28133,109,172,2005,1236,622,614
28134,109,82,2005,571,409,162
28135,109,68,2005,20818,9628,11190
28136,109,110,2005,2870,1504,1366
28137,109,85,2005,14450,7868,6582
28138,109,57,2005,125,65,60
28139,109,112,2005,399,204,195
28140,109,91,2005,1327,676,651
28141,109,113,2005,20487,10694,9793
28142,139,141,2005,62,24,38
28143,139,134,2005,624,252,372
28144,139,67,2005,282,125,157
28145,139,116,2005,95,38,57
28146,139,135,2005,28544,14155,14389
28147,139,136,2005,2550,1000,1550
28148,139,172,2005,195,55,140
28149,139,137,2005,9393,4957,4436
28150,139,137,2005,5019,2278,2741
28151,139,151,2005,29417,14338,15079
28152,139,138,2005,49009,24492,24517
28153,139,68,2005,9056,3878,5178
28154,139,69,2005,50,21,29
28155,139,156,2005,3586,521,3065
28156,139,157,2005,2805,723,2082
28157,139,17,2005,8,3,5
28158,139,177,2005,18,8,10
28159,139,176,2005,90,36,54
28160,139,20,2005,1409,424,985
28161,139,160,2005,31083,11000,20083
28162,139,144,2005,402,202,200
28163,139,162,2005,13475,3649,9826
28164,139,126,2005,119,58,61
28165,139,140,2005,3667,1921,1746
28166,139,164,2005,17189,3451,13738
28167,139,115,2005,7,0,7
28168,139,25,2005,16,7,9
28169,139,166,2005,12971,6436,6535
28170,139,146,2005,126,55,71
28171,139,152,2005,3940,1546,2394
28172,155,157,2005,37318,15678,21640
28173,155,159,2005,948,446,502
28174,155,160,2005,8552,3134,5418
28175,155,161,2005,3011,445,2566
28176,155,158,2005,11396,5867,5529
28177,155,164,2005,109499,55243,54256
28178,155,165,2005,5956,2779,3177
28179,15,2,2005,39,18,21
28180,15,51,2005,10,6,4
28181,15,141,2005,17,10,7
28182,15,12,2005,5490,3605,1885
28183,15,103,2005,15,7,8
28184,15,66,2005,24,11,13
28185,15,11,2005,11654,5269,6385
28186,15,67,2005,21,13,8
28187,15,30,2005,213,117,96
28188,15,29,2005,1006,814,192
28189,15,172,2005,70,36,34
28190,15,81,2005,12,5,7
28191,15,31,2005,32,20,12
28192,15,40,2005,113,78,35
28193,15,42,2005,11,8,3
28194,15,68,2005,38,25,13
28195,15,69,2005,576,317,259
28196,15,56,2005,151,72,79
28197,15,32,2005,46,26,20
28198,15,5,2005,30,12,18
28199,15,6,2005,113,50,63
28200,15,17,2005,30,11,19
28201,15,57,2005,17,6,11
28202,15,167,2005,1568,682,886
28203,15,168,2005,229,154,75
28204,15,20,2005,9,5,4
28205,15,46,2005,189,123,66
28206,15,47,2005,194,149,45
28207,15,8,2005,17,0,17
28208,15,73,2005,11,7,4
28209,15,9,2005,81,6,75
28210,15,112,2005,20,18,2
28211,15,33,2005,166,119,47
28212,15,35,2005,202,153,49
28213,15,36,2005,32888,18844,14044
28214,15,65,2005,18,9,9
28215,15,74,2005,14,7,7
28216,15,169,2005,137,87,50
28217,15,26,2005,432,132,300
28218,15,170,2005,187,121,66
28219,15,38,2005,11120,6340,4780
28220,15,50,2005,32,9,23
28221,15,171,2005,699,452,247
28222,69,2,2005,75824,34082,41742
28223,69,51,2005,13162,6147,7015
28224,69,141,2005,17681,4519,13162
28225,69,134,2005,0,0,0
28226,69,103,2005,10339,5603,4736
28227,69,11,2005,10221,5205,5016
28228,69,66,2005,196503,97808,98695
28229,69,12,2005,14234,7026,7208
28230,69,3,2005,6009,1701,4308
28231,69,29,2005,20329,13173,7156
28232,69,67,2005,25787,13199,12588
28233,69,151,2005,1451,406,1045
28234,69,53,2005,157145,78759,78386
28235,69,105,2005,38846,26708,12138
28236,69,30,2005,61639,31100,30539
28237,69,152,2005,1608,294,1314
28238,69,116,2005,504,214,290
28239,69,135,2005,12888,5150,7738
28240,69,136,2005,275,57,218
28241,69,106,2005,9900,5272,4628
28242,69,172,2005,67622,34243,33379
28243,69,107,2005,13677,8801,4876
28244,69,137,2005,2465,1167,1298
28245,69,96,2005,1182,698,484
28246,69,54,2005,188110,97524,90586
28247,69,81,2005,9720,5448,4272
28248,69,14,2005,1243,541,702
28249,69,31,2005,431679,233460,198219
28250,69,176,2005,2063,1243,820
28251,69,137,2005,10422,4655,5767
28252,69,39,2005,20711,11731,8980
28253,69,83,2005,7013,4974,2039
28254,69,108,2005,5360,3318,2042
28255,69,142,2005,16492,4538,11954
28256,69,97,2005,807,475,332
28257,69,119,2005,8806,4438,4368
28258,69,40,2005,9351,6030,3321
28259,69,120,2005,15936,7694,8242
28260,69,42,2005,14205,10216,3989
28261,69,68,2005,112952,61716,51236
28262,69,139,2005,340,126,214
28263,69,155,2005,3143,666,2477
28264,69,15,2005,14882,8817,6065
28265,69,156,2005,23382,11270,12112
28266,69,56,2005,256149,118257,137892
28267,69,98,2005,1221,687,534
28268,69,157,2005,2777,736,2041
28269,69,85,2005,884,488,396
28270,69,99,2005,890,581,309
28271,69,32,2005,116809,52394,64415
28272,69,43,2005,1479,726,753
28273,69,5,2005,45659,16294,29365
28274,69,6,2005,108310,46046,62264
28275,69,16,2005,77641,28995,48646
28276,69,44,2005,11942,5585,6357
28277,69,17,2005,10661,4031,6630
28278,69,57,2005,410250,158400,251850
28279,69,86,2005,1586,908,678
28280,69,177,2005,28874,16635,12239
28281,69,18,2005,10407,3444,6963
28282,69,167,2005,671031,355549,315482
28283,69,121,2005,8720,6166,2554
28284,69,168,2005,51974,27730,24244
28285,69,46,2005,19481,11381,8100
28286,69,20,2005,57764,23371,34393
28287,69,159,2005,2291,496,1795
28288,69,143,2005,3204,1153,2051
28289,69,70,2005,209,126,83
28290,69,47,2005,29529,19325,10204
28291,69,71,2005,11880,5865,6015
28292,69,122,2005,997,646,351
28293,69,160,2005,1009,338,671
28294,69,58,2005,489,277,212
28295,69,100,2005,10738,6700,4038
28296,69,59,2005,19700,9011,10689
28297,69,144,2005,85965,36182,49783
28298,69,8,2005,2600,989,1611
28299,69,73,2005,110348,52752,57596
28300,69,101,2005,951,530,421
28301,69,162,2005,18538,5500,13038
28302,69,60,2005,24598,12296,12302
28303,69,48,2005,7252,4101,3151
28304,69,9,2005,38473,13772,24701
28305,69,102,2005,446,258,188
28306,69,111,2005,2622,1523,1099
28307,69,112,2005,11825,7695,4130
28308,69,33,2005,1157821,629483,528338
28309,69,61,2005,102455,46495,55960
28310,69,35,2005,407829,207848,199981
28311,69,36,2005,889324,504480,384844
28312,69,126,2005,943,444,499
28313,69,23,2005,1993,790,1203
28314,69,164,2005,3012,808,2204
28315,69,63,2005,319713,148700,171013
28316,69,165,2005,3821,819,3002
28317,69,37,2005,30070,15942,14128
28318,69,64,2005,29475,15377,14098
28319,69,128,2005,6784,2853,3931
28320,69,115,2005,10414,5641,4773
28321,69,65,2005,101503,51237,50266
28322,69,10,2005,42932,19217,23715
28323,69,145,2005,0,0,0
28324,69,49,2005,17149,9692,7457
28325,69,74,2005,53952,29637,24315
28326,69,25,2005,34895,14341,20554
28327,69,169,2005,16462,8519,7943
28328,69,166,2005,11436,4010,7426
28329,69,93,2005,611,379,232
28330,69,146,2005,28888,9559,19329
28331,69,26,2005,1315719,605758,709961
28332,69,170,2005,4529,2489,2040
28333,69,130,2005,1731,912,819
28334,69,38,2005,186103,110040,76063
28335,69,50,2005,96506,39148,57358
28336,69,131,2005,455,199,256
28337,69,114,2005,1839,998,841
28338,69,171,2005,25587,13828,11759
28339,69,1,2005,86970,43694,43276
28340,69,28,2005,2049,596,1453
28341,69,132,2005,581,302,279
28342,156,141,2005,11,3,8
28343,156,105,2005,11,5,6
28344,156,135,2005,96,33,63
28345,156,10,2005,24,11,13
28346,156,136,2005,13,3,10
28347,156,172,2005,190,32,158
28348,156,137,2005,25,13,12
28349,156,151,2005,14044,6510,7534
28350,156,120,2005,25,13,12
28351,156,68,2005,183,81,102
28352,156,155,2005,30,11,19
28353,156,157,2005,115,44,71
28354,156,5,2005,712,286,426
28355,156,17,2005,38,17,21
28356,156,57,2005,193,77,116
28357,156,177,2005,46,17,29
28358,156,121,2005,13,3,10
28359,156,20,2005,823,332,491
28360,156,159,2005,50459,23254,27205
28361,156,160,2005,5631,1549,4082
28362,156,161,2005,14,4,10
28363,156,73,2005,205,85,120
28364,156,162,2005,28321,11871,16450
28365,156,9,2005,73,32,41
28366,156,33,2005,53,26,27
28367,156,36,2005,73,40,33
28368,156,126,2005,420,252,168
28369,156,164,2005,83,29,54
28370,156,165,2005,3354,1509,1845
28371,156,145,2005,28,5,23
28372,156,74,2005,163,67,96
28373,156,25,2005,58,25,33
28374,156,166,2005,86196,47474,38722
28375,156,142,2005,32,15,17
28376,156,50,2005,1524,732,792
28377,156,131,2005,10,4,6
28378,156,152,2005,50321,21218,29103
28379,55,144,2005,1020,364,656
28380,55,65,2005,2010,1350,660
28381,55,50,2005,4462,2127,2335
28382,56,2,2005,3401,660,2741
28383,56,51,2005,423598,187560,236038
28384,56,141,2005,722,147,575
28385,56,52,2005,4,1,3
28386,56,134,2005,14,8,6
28387,56,75,2005,14,7,7
28388,56,76,2005,22,10,12
28389,56,103,2005,641,406,235
28390,56,11,2005,11750,6401,5349
28391,56,77,2005,47,21,26
28392,56,66,2005,2267,1538,729
28393,56,12,2005,453,275,178
28394,56,78,2005,22,13,9
28395,56,13,2005,25,11,14
28396,56,3,2005,7361,380,6981
28397,56,79,2005,10,3,7
28398,56,29,2005,1027,756,271
28399,56,67,2005,4933,2889,2044
28400,56,95,2005,4,3,1
28401,56,151,2005,9,3,6
28402,56,4,2005,3,0,3
28403,56,53,2005,407,265,142
28404,56,147,2005,6,4,2
28405,56,105,2005,2180,1468,712
28406,56,30,2005,56513,35392,21121
28407,56,152,2005,44,5,39
28408,56,116,2005,137,69,68
28409,56,153,2005,24,12,12
28410,56,135,2005,453,219,234
28411,56,80,2005,5,4,1
28412,56,136,2005,22,9,13
28413,56,106,2005,383,243,140
28414,56,172,2005,2015,938,1077
28415,56,173,2005,26,12,14
28416,56,107,2005,397,305,92
28417,56,117,2005,38,9,29
28418,56,137,2005,1144,608,536
28419,56,96,2005,33,25,8
28420,56,54,2005,397,270,127
28421,56,81,2005,284,204,80
28422,56,14,2005,22208,12586,9622
28423,56,31,2005,4110,2420,1690
28424,56,176,2005,23,12,11
28425,56,137,2005,715,397,318
28426,56,39,2005,867,590,277
28427,56,118,2005,32,19,13
28428,56,82,2005,209,189,20
28429,56,83,2005,374,310,64
28430,56,108,2005,66,55,11
28431,56,142,2005,30642,14064,16578
28432,56,97,2005,43,32,11
28433,56,138,2005,1,1,0
28434,56,119,2005,193,105,88
28435,56,40,2005,96,71,25
28436,56,148,2005,18,8,10
28437,56,120,2005,2479,1627,852
28438,56,41,2005,2,2,0
28439,56,42,2005,815,687,128
28440,56,68,2005,6696,4135,2561
28441,56,109,2005,2,1,1
28442,56,139,2005,27,13,14
28443,56,155,2005,48,16,32
28444,56,15,2005,78132,44078,34054
28445,56,69,2005,108685,58586,50099
28446,56,156,2005,507,143,364
28447,56,55,2005,9,5,4
28448,56,84,2005,4,3,1
28449,56,98,2005,32,26,6
28450,56,157,2005,105,13,92
28451,56,158,2005,4,3,1
28452,56,110,2005,12,8,4
28453,56,85,2005,36,21,15
28454,56,99,2005,42,32,10
28455,56,32,2005,1669,1067,602
28456,56,43,2005,44,28,16
28457,56,5,2005,8679,1273,7406
28458,56,6,2005,1613,484,1129
28459,56,16,2005,5303,1393,3910
28460,56,44,2005,549,387,162
28461,56,45,2005,9,4,5
28462,56,17,2005,698,308,390
28463,56,57,2005,6159,3614,2545
28464,56,86,2005,39,20,19
28465,56,177,2005,538,395,143
28466,56,18,2005,822,203,619
28467,56,167,2005,25878,13814,12064
28468,56,121,2005,415,252,163
28469,56,19,2005,145,61,84
28470,56,168,2005,386,216,170
28471,56,46,2005,208,168,40
28472,56,20,2005,2152,889,1263
28473,56,149,2005,1,1,0
28474,56,159,2005,27,12,15
28475,56,143,2005,621,258,363
28476,56,70,2005,8,5,3
28477,56,47,2005,362,303,59
28478,56,71,2005,120,66,54
28479,56,122,2005,137,78,59
28480,56,7,2005,4,2,2
28481,56,160,2005,24,9,15
28482,56,58,2005,96,67,29
28483,56,161,2005,63,4,59
28484,56,124,2005,46,35,11
28485,56,100,2005,383,302,81
28486,56,72,2005,34,19,15
28487,56,87,2005,41,22,19
28488,56,144,2005,1458,493,965
28489,56,125,2005,66,40,26
28490,56,150,2005,8,2,6
28491,56,8,2005,33,9,24
28492,56,73,2005,3442,2312,1130
28493,56,101,2005,97,51,46
28494,56,162,2005,2396,777,1619
28495,56,60,2005,1573,838,735
28496,56,48,2005,492,341,151
28497,56,21,2005,4,2,2
28498,56,9,2005,21381,815,20566
28499,56,102,2005,149,84,65
28500,56,111,2005,69,58,11
28501,56,112,2005,233,170,63
28502,56,33,2005,15669,9439,6230
28503,56,61,2005,311,212,99
28504,56,88,2005,10,5,5
28505,56,22,2005,570,303,267
28506,56,35,2005,36759,19691,17068
28507,56,36,2005,63706,38604,25102
28508,56,126,2005,112,27,85
28509,56,90,2005,4,2,2
28510,56,92,2005,61,12,49
28511,56,62,2005,5,4,1
28512,56,140,2005,6,2,4
28513,56,23,2005,446,206,240
28514,56,164,2005,350,37,313
28515,56,63,2005,4768,2898,1870
28516,56,127,2005,29,24,5
28517,56,165,2005,219,76,143
28518,56,37,2005,645,505,140
28519,56,64,2005,120,90,30
28520,56,128,2005,412,102,310
28521,56,115,2005,6279,3545,2734
28522,56,65,2005,1085,748,337
28523,56,10,2005,860,547,313
28524,56,145,2005,1650,717,933
28525,56,113,2005,6,4,2
28526,56,49,2005,5459,3191,2268
28527,56,74,2005,3657,2136,1521
28528,56,25,2005,6597,1534,5063
28529,56,169,2005,83,55,28
28530,56,166,2005,14,7,7
28531,56,93,2005,14,11,3
28532,56,146,2005,471,125,346
28533,56,26,2005,55051,31889,23162
28534,56,170,2005,108,63,45
28535,56,130,2005,118,73,45
28536,56,38,2005,18198,13883,4315
28537,56,27,2005,83,34,49
28538,56,50,2005,15618,9597,6021
28539,56,131,2005,401,183,218
28540,56,114,2005,117,76,41
28541,56,171,2005,6778,3792,2986
28542,56,1,2005,220,106,114
28543,56,28,2005,27,10,17
28544,56,132,2005,242,126,116
28545,56,133,2005,440,244,196
28546,84,76,2005,36,18,18
28547,84,78,2005,28,14,14
28548,84,79,2005,168,84,84
28549,84,82,2005,70,35,35
28550,84,110,2005,322,273,49
28551,84,86,2005,109,55,54
28552,84,87,2005,9,4,5
28553,84,90,2005,14,6,8
28554,84,91,2005,154,77,77
28555,84,92,2005,357,274,83
28556,84,93,2005,2075,1390,685
28557,98,103,2005,416,170,246
28558,98,105,2005,180,85,95
28559,98,95,2005,688,352,336
28560,98,106,2005,227,99,128
28561,98,172,2005,493,233,260
28562,98,107,2005,868,430,438
28563,98,96,2005,872,455,417
28564,98,81,2005,496,217,279
28565,98,83,2005,82,37,45
28566,98,108,2005,125,57,68
28567,98,97,2005,14364,10487,3877
28568,98,68,2005,194,66,128
28569,98,109,2005,15,8,7
28570,98,69,2005,480,196,284
28571,98,85,2005,11,5,6
28572,98,99,2005,6294,3658,2636
28573,98,6,2005,14,5,9
28574,98,17,2005,99,37,62
28575,98,57,2005,276,88,188
28576,98,177,2005,111,45,66
28577,98,20,2005,19,4,15
28578,98,100,2005,13160,6027,7133
28579,98,73,2005,106,51,55
28580,98,101,2005,6424,3221,3203
28581,98,9,2005,20,11,9
28582,98,102,2005,226,116,110
28583,98,111,2005,45,22,23
28584,98,112,2005,343,157,186
28585,98,61,2005,21,3,18
28586,98,88,2005,77,35,42
28587,98,23,2005,24,5,19
28588,98,65,2005,991,398,593
28589,98,49,2005,36,13,23
28590,98,74,2005,115,42,73
28591,98,25,2005,59,20,39
28592,98,26,2005,19,12,7
28593,98,142,2005,24,22,2
28594,98,50,2005,168,66,102
28595,98,114,2005,106,40,66
28596,157,2,2005,0,0,0
28597,157,51,2005,0,0,0
28598,157,141,2005,0,0,0
28599,157,52,2005,0,0,0
28600,157,134,2005,0,0,0
28601,157,76,2005,0,0,0
28602,157,12,2005,0,0,0
28603,157,103,2005,0,0,0
28604,157,66,2005,0,0,0
28605,157,78,2005,0,0,0
28606,157,13,2005,0,0,0
28607,157,3,2005,0,0,0
28608,157,11,2005,0,0,0
28609,157,79,2005,0,0,0
28610,157,67,2005,116,40,76
28611,157,4,2005,0,0,0
28612,157,53,2005,0,0,0
28613,157,147,2005,0,0,0
28614,157,105,2005,139,38,101
28615,157,95,2005,0,0,0
28616,157,30,2005,0,0,0
28617,157,116,2005,0,0,0
28618,157,135,2005,0,0,0
28619,157,153,2005,54,20,34
28620,157,10,2005,0,0,0
28621,157,136,2005,0,0,0
28622,157,106,2005,0,0,0
28623,157,172,2005,116,22,94
28624,157,107,2005,0,0,0
28625,157,117,2005,0,0,0
28626,157,137,2005,0,0,0
28627,157,137,2005,0,0,0
28628,157,96,2005,0,0,0
28629,157,54,2005,0,0,0
28630,157,81,2005,375,151,224
28631,157,151,2005,1327,416,911
28632,157,39,2005,0,0,0
28633,157,82,2005,0,0,0
28634,157,83,2005,0,0,0
28635,157,108,2005,0,0,0
28636,157,97,2005,0,0,0
28637,157,138,2005,0,0,0
28638,157,120,2005,0,0,0
28639,157,119,2005,0,0,0
28640,157,42,2005,0,0,0
28641,157,68,2005,927,278,649
28642,157,118,2005,0,0,0
28643,157,139,2005,0,0,0
28644,157,155,2005,457,180,277
28645,157,69,2005,0,0,0
28646,157,156,2005,0,0,0
28647,157,85,2005,0,0,0
28648,157,99,2005,0,0,0
28649,157,5,2005,0,0,0
28650,157,17,2005,0,0,0
28651,157,57,2005,0,0,0
28652,157,177,2005,39,14,25
28653,157,18,2005,0,0,0
28654,157,121,2005,0,0,0
28655,157,176,2005,0,0,0
28656,157,20,2005,0,0,0
28657,157,149,2005,0,0,0
28658,157,46,2005,0,0,0
28659,157,159,2005,102158,56185,45973
28660,157,143,2005,0,0,0
28661,157,70,2005,0,0,0
28662,157,122,2005,0,0,0
28663,157,123,2005,0,0,0
28664,157,160,2005,35367,18254,17113
28665,157,161,2005,870,334,536
28666,157,124,2005,0,0,0
28667,157,144,2005,0,0,0
28668,157,125,2005,0,0,0
28669,157,150,2005,0,0,0
28670,157,8,2005,0,0,0
28671,157,73,2005,0,0,0
28672,157,101,2005,0,0,0
28673,157,162,2005,513,90,423
28674,157,48,2005,0,0,0
28675,157,9,2005,0,0,0
28676,157,33,2005,0,0,0
28677,157,61,2005,206,0,206
28678,157,158,2005,4194,1799,2395
28679,157,35,2005,0,0,0
28680,157,36,2005,298,60,238
28681,157,126,2005,0,0,0
28682,157,92,2005,0,0,0
28683,157,140,2005,0,0,0
28684,157,23,2005,250,87,163
28685,157,164,2005,5495,2165,3330
28686,157,63,2005,0,0,0
28687,157,127,2005,0,0,0
28688,157,165,2005,27115,14913,12202
28689,157,1,2005,0,0,0
28690,157,64,2005,0,0,0
28691,157,128,2005,0,0,0
28692,157,115,2005,0,0,0
28693,157,133,2005,0,0,0
28694,157,65,2005,511,209,302
28695,157,129,2005,0,0,0
28696,157,145,2005,0,0,0
28697,157,148,2005,0,0,0
28698,157,49,2005,0,0,0
28699,157,74,2005,0,0,0
28700,157,25,2005,20,1,19
28701,157,169,2005,0,0,0
28702,157,166,2005,1354,370,984
28703,157,146,2005,0,0,0
28704,157,26,2005,0,0,0
28705,157,130,2005,0,0,0
28706,157,38,2005,50,16,34
28707,157,142,2005,0,0,0
28708,157,50,2005,0,0,0
28709,157,131,2005,0,0,0
28710,157,152,2005,650,232,418
28711,157,114,2005,0,0,0
28712,157,171,2005,0,0,0
28713,158,153,2005,549,328,221
28714,158,68,2005,108,32,76
28715,158,155,2005,1472,728,744
28716,158,157,2005,4813,2233,2580
28717,158,159,2005,878,324,554
28718,158,161,2005,545,271,274
28719,158,61,2005,802,381,421
28720,158,164,2005,9265,4946,4319
28721,158,165,2005,863,432,431
28722,110,76,2005,13,8,5
28723,110,78,2005,11,6,5
28724,110,79,2005,223,105,118
28725,110,105,2005,1448,568,880
28726,110,172,2005,780,315,465
28727,110,82,2005,31,13,18
28728,110,84,2005,137,63,74
28729,110,86,2005,209,96,113
28730,110,91,2005,226,94,132
28731,110,92,2005,260,117,143
28732,110,113,2005,3117,1568,1549
28733,110,93,2005,591,265,326
28734,110,50,2005,390,176,214
28735,85,103,2005,398,170,228
28736,85,66,2005,144,22,122
28737,85,106,2005,284,101,183
28738,85,172,2005,297,125,172
28739,85,107,2005,708,347,361
28740,85,96,2005,233,143,90
28741,85,81,2005,1029,453,576
28742,85,83,2005,2061,908,1153
28743,85,68,2005,379,147,232
28744,85,69,2005,767,309,458
28745,85,57,2005,1050,307,743
28746,85,177,2005,188,86,102
28747,85,100,2005,261,149,112
28748,85,112,2005,300,121,179
28749,85,88,2005,1324,721,603
28750,85,65,2005,1111,404,707
28751,85,74,2005,322,116,206
28752,85,114,2005,244,148,96
28753,99,103,2005,139,62,77
28754,99,67,2005,19,6,13
28755,99,105,2005,173,104,69
28756,99,95,2005,266,128,138
28757,99,80,2005,66,32,34
28758,99,106,2005,226,113,113
28759,99,172,2005,434,161,273
28760,99,107,2005,631,280,351
28761,99,96,2005,626,295,331
28762,99,81,2005,446,144,302
28763,99,83,2005,99,38,61
28764,99,108,2005,335,111,224
28765,99,97,2005,6439,3508,2931
28766,99,68,2005,105,46,59
28767,99,69,2005,213,75,138
28768,99,98,2005,3351,1669,1682
28769,99,85,2005,32,5,27
28770,99,17,2005,66,23,43
28771,99,57,2005,190,48,142
28772,99,86,2005,20,4,16
28773,99,177,2005,101,47,54
28774,99,18,2005,30,15,15
28775,99,176,2005,46,15,31
28776,99,100,2005,1140,583,557
28777,99,73,2005,67,21,46
28778,99,101,2005,5649,2832,2817
28779,99,102,2005,290,127,163
28780,99,111,2005,26,11,15
28781,99,112,2005,280,121,159
28782,99,88,2005,94,37,57
28783,99,36,2005,19,8,11
28784,99,65,2005,383,168,215
28785,99,49,2005,23,11,12
28786,99,74,2005,45,14,31
28787,99,50,2005,75,23,52
28788,99,114,2005,49,19,30
28789,173,3,2005,400,147,253
28790,173,172,2005,2070537,1078752,991785
28791,173,174,2005,64994,34039,30955
28792,173,68,2005,1978,675,1303
28793,173,69,2005,1778,476,1302
28794,173,5,2005,16228,8261,7967
28795,173,44,2005,627,263,364
28796,173,57,2005,579,216,363
28797,173,177,2005,12786,6141,6645
28798,173,8,2005,8413,4259,4154
28799,173,73,2005,919,323,596
28800,173,9,2005,6809,2731,4078
28801,173,61,2005,98,54,44
28802,173,36,2005,79,65,14
28803,173,65,2005,362,178,184
28804,173,10,2005,705,451,254
28805,173,74,2005,655,197,458
28806,173,50,2005,15924,5976,9948
28807,173,1,2005,9852,6014,3838
28808,32,2,2005,2385,911,1474
28809,32,51,2005,159,80,79
28810,32,141,2005,575,141,434
28811,32,52,2005,0,0,0
28812,32,134,2005,67,23,44
28813,32,76,2005,0,0,0
28814,32,103,2005,274,127,147
28815,32,11,2005,177,97,80
28816,32,77,2005,0,0,0
28817,32,66,2005,6780,3124,3656
28818,32,12,2005,127,68,59
28819,32,78,2005,6,2,4
28820,32,13,2005,12,6,6
28821,32,3,2005,57,7,50
28822,32,79,2005,4,2,2
28823,32,29,2005,195,130,65
28824,32,67,2005,1356,666,690
28825,32,95,2005,1,0,1
28826,32,151,2005,22,4,18
28827,32,4,2005,0,0,0
28828,32,53,2005,324,137,187
28829,32,147,2005,5,2,3
28830,32,105,2005,425,197,228
28831,32,30,2005,1755,952,803
28832,32,152,2005,0,0,0
28833,32,116,2005,0,0,0
28834,32,153,2005,0,0,0
28835,32,135,2005,168,46,122
28836,32,80,2005,0,0,0
28837,32,136,2005,1,1,0
28838,32,106,2005,133,63,70
28839,32,172,2005,9259,4318,4941
28840,32,107,2005,166,79,87
28841,32,117,2005,0,0,0
28842,32,137,2005,68,11,57
28843,32,96,2005,27,8,19
28844,32,54,2005,1958,1049,909
28845,32,81,2005,512,294,218
28846,32,14,2005,232,116,116
28847,32,31,2005,1336,834,502
28848,32,176,2005,0,0,0
28849,32,137,2005,22,7,15
28850,32,39,2005,306,127,179
28851,32,118,2005,0,0,0
28852,32,82,2005,0,0,0
28853,32,83,2005,30,13,17
28854,32,108,2005,94,35,59
28855,32,142,2005,649,143,506
28856,32,97,2005,11,7,4
28857,32,138,2005,0,0,0
28858,32,119,2005,9,5,4
28859,32,40,2005,107,79,28
28860,32,148,2005,0,0,0
28861,32,120,2005,111,29,82
28862,32,41,2005,0,0,0
28863,32,42,2005,586,302,284
28864,32,68,2005,3207,1519,1688
28865,32,139,2005,5,2,3
28866,32,155,2005,9,4,5
28867,32,15,2005,177,81,96
28868,32,69,2005,26133,13483,12650
28869,32,156,2005,105,35,70
28870,32,56,2005,1109,568,541
28871,32,84,2005,5,2,3
28872,32,98,2005,15,8,7
28873,32,157,2005,36,6,30
28874,32,158,2005,7,0,7
28875,32,110,2005,4,1,3
28876,32,85,2005,0,0,0
28877,32,99,2005,9,4,5
28878,32,43,2005,109,59,50
28879,32,5,2005,928,327,601
28880,32,6,2005,1706,653,1053
28881,32,16,2005,1255,397,858
28882,32,44,2005,674,327,347
28883,32,17,2005,1410,585,825
28884,32,57,2005,3202,1196,2006
28885,32,86,2005,25,8,17
28886,32,177,2005,1128,559,569
28887,32,18,2005,331,84,247
28888,32,167,2005,445,233,212
28889,32,121,2005,74,34,40
28890,32,19,2005,147,50,97
28891,32,168,2005,111,87,24
28892,32,46,2005,119,89,30
28893,32,20,2005,289,68,221
28894,32,149,2005,5,1,4
28895,32,159,2005,28,8,20
28896,32,143,2005,268,95,173
28897,32,70,2005,6,4,2
28898,32,47,2005,122,69,53
28899,32,71,2005,116,53,63
28900,32,122,2005,27,16,11
28901,32,123,2005,0,0,0
28902,32,160,2005,18,2,16
28903,32,58,2005,31,16,15
28904,32,161,2005,4,0,4
28905,32,124,2005,43,19,24
28906,32,100,2005,355,170,185
28907,32,72,2005,5,2,3
28908,32,59,2005,33,12,21
28909,32,144,2005,158,44,114
28910,32,125,2005,18,7,11
28911,32,150,2005,7,2,5
28912,32,8,2005,47,16,31
28913,32,73,2005,2262,939,1323
28914,32,101,2005,19,10,9
28915,32,162,2005,981,317,664
28916,32,60,2005,121,44,77
28917,32,48,2005,973,596,377
28918,32,21,2005,14,10,4
28919,32,9,2005,194,64,130
28920,32,102,2005,22,7,15
28921,32,111,2005,17,10,7
28922,32,112,2005,183,90,93
28923,32,33,2005,3378,2227,1151
28924,32,61,2005,276,109,167
28925,32,22,2005,28,12,16
28926,32,35,2005,179463,95536,83927
28927,32,36,2005,3768,2402,1366
28928,32,126,2005,15,7,8
28929,32,90,2005,4,2,2
28930,32,91,2005,0,0,0
28931,32,92,2005,4,2,2
28932,32,62,2005,0,0,0
28933,32,23,2005,272,74,198
28934,32,164,2005,21,6,15
28935,32,63,2005,20672,10405,10267
28936,32,127,2005,0,0,0
28937,32,165,2005,25,1,24
28938,32,37,2005,18522,11797,6725
28939,32,64,2005,346,170,176
28940,32,128,2005,334,72,262
28941,32,115,2005,283,133,150
28942,32,65,2005,1006,493,513
28943,32,10,2005,44,18,26
28944,32,145,2005,145,33,112
28945,32,113,2005,0,0,0
28946,32,49,2005,1281,654,627
28947,32,74,2005,1857,864,993
28948,32,25,2005,1039,256,783
28949,32,169,2005,15,7,8
28950,32,166,2005,7,2,5
28951,32,93,2005,12,7,5
28952,32,146,2005,159,25,134
28953,32,26,2005,1782,540,1242
28954,32,170,2005,0,0,0
28955,32,130,2005,27,11,16
28956,32,38,2005,24333,14615,9718
28957,32,27,2005,152,68,84
28958,32,50,2005,4494,1895,2599
28959,32,131,2005,49,15,34
28960,32,114,2005,57,32,25
28961,32,171,2005,98,56,42
28962,32,1,2005,2880,1487,1393
28963,32,28,2005,229,67,162
28964,32,132,2005,15,10,5
28965,32,133,2005,33,11,22
28966,43,2,2005,4,0,4
28967,43,51,2005,30,17,13
28968,43,141,2005,24,6,18
28969,43,52,2005,0,0,0
28970,43,134,2005,30,9,21
28971,43,76,2005,0,0,0
28972,43,103,2005,20,7,13
28973,43,11,2005,4,3,1
28974,43,77,2005,1,0,1
28975,43,66,2005,109,62,47
28976,43,12,2005,5,4,1
28977,43,78,2005,3,2,1
28978,43,13,2005,1,0,1
28979,43,3,2005,0,0,0
28980,43,79,2005,2,1,1
28981,43,29,2005,21,15,6
28982,43,67,2005,92,47,45
28983,43,95,2005,2,1,1
28984,43,151,2005,0,0,0
28985,43,53,2005,83,40,43
28986,43,105,2005,67,49,18
28987,43,30,2005,106,57,49
28988,43,152,2005,1,0,1
28989,43,153,2005,40,21,19
28990,43,135,2005,3,0,3
28991,43,136,2005,0,0,0
28992,43,106,2005,68,30,38
28993,43,172,2005,335,207,128
28994,43,107,2005,110,65,45
28995,43,137,2005,0,0,0
28996,43,96,2005,6,2,4
28997,43,54,2005,81,38,43
28998,43,81,2005,25,13,12
28999,43,14,2005,4,1,3
29000,43,31,2005,122,68,54
29001,43,176,2005,0,0,0
29002,43,137,2005,2,0,2
29003,43,39,2005,2637,1392,1245
29004,43,118,2005,1,0,1
29005,43,82,2005,2,1,1
29006,43,83,2005,13,9,4
29007,43,108,2005,20,12,8
29008,43,142,2005,22,5,17
29009,43,97,2005,6,3,3
29010,43,138,2005,2,2,0
29011,43,119,2005,2,0,2
29012,43,40,2005,81,47,34
29013,43,120,2005,47,26,21
29014,43,41,2005,320,190,130
29015,43,42,2005,153,105,48
29016,43,68,2005,355,173,182
29017,43,139,2005,0,0,0
29018,43,155,2005,6,3,3
29019,43,15,2005,12,7,5
29020,43,69,2005,1387,869,518
29021,43,156,2005,32,18,14
29022,43,55,2005,0,0,0
29023,43,56,2005,18,8,10
29024,43,98,2005,30,13,17
29025,43,157,2005,11,5,6
29026,43,158,2005,0,0,0
29027,43,110,2005,17,11,6
29028,43,85,2005,4,3,1
29029,43,99,2005,24,11,13
29030,43,32,2005,110,53,57
29031,43,5,2005,213,117,96
29032,43,6,2005,27,9,18
29033,43,16,2005,32,13,19
29034,43,44,2005,68,26,42
29035,43,17,2005,26,9,17
29036,43,57,2005,165,68,97
29037,43,86,2005,13,9,4
29038,43,177,2005,66,43,23
29039,43,18,2005,12,7,5
29040,43,167,2005,8,7,1
29041,43,121,2005,38,27,11
29042,43,19,2005,2,0,2
29043,43,168,2005,1,1,0
29044,43,46,2005,339,161,178
29045,43,20,2005,25,8,17
29046,43,159,2005,0,0,0
29047,43,143,2005,1,0,1
29048,43,70,2005,0,0,0
29049,43,47,2005,753,328,425
29050,43,71,2005,94,48,46
29051,43,122,2005,2,1,1
29052,43,123,2005,2,1,1
29053,43,160,2005,1,0,1
29054,43,58,2005,3,2,1
29055,43,161,2005,0,0,0
29056,43,124,2005,7,4,3
29057,43,100,2005,54,34,20
29058,43,72,2005,1,1,0
29059,43,59,2005,0,0,0
29060,43,144,2005,120,41,79
29061,43,125,2005,11,6,5
29062,43,150,2005,28,15,13
29063,43,8,2005,56,23,33
29064,43,73,2005,228,120,108
29065,43,101,2005,4,4,0
29066,43,162,2005,46,18,28
29067,43,60,2005,21,9,12
29068,43,48,2005,921,505,416
29069,43,21,2005,0,0,0
29070,43,9,2005,20,7,13
29071,43,102,2005,4,2,2
29072,43,111,2005,3,1,2
29073,43,112,2005,56,36,20
29074,43,33,2005,5895,2636,3259
29075,43,61,2005,358,122,236
29076,43,88,2005,1,0,1
29077,43,22,2005,2,2,0
29078,43,35,2005,137,55,82
29079,43,36,2005,406,241,165
29080,43,126,2005,1,0,1
29081,43,92,2005,0,0,0
29082,43,62,2005,0,0,0
29083,43,23,2005,3,2,1
29084,43,164,2005,10,4,6
29085,43,63,2005,466,218,248
29086,43,165,2005,12,5,7
29087,43,37,2005,120,37,83
29088,43,64,2005,21,8,13
29089,43,128,2005,1,1,0
29090,43,115,2005,65,42,23
29091,43,65,2005,224,92,132
29092,43,10,2005,134,86,48
29093,43,145,2005,0,0,0
29094,43,49,2005,1716,895,821
29095,43,74,2005,111,56,55
29096,43,25,2005,17,5,12
29097,43,169,2005,4,3,1
29098,43,166,2005,2,1,1
29099,43,93,2005,3,2,1
29100,43,146,2005,14,3,11
29101,43,26,2005,49,18,31
29102,43,170,2005,1,1,0
29103,43,130,2005,14,12,2
29104,43,38,2005,118,77,41
29105,43,27,2005,2,1,1
29106,43,50,2005,918,376,542
29107,43,131,2005,16,10,6
29108,43,114,2005,7,2,5
29109,43,171,2005,4,2,2
29110,43,1,2005,355,196,159
29111,43,28,2005,1,1,0
29112,43,132,2005,6,5,1
29113,43,133,2005,9,8,1
29114,5,2,2005,15792,7581,8211
29115,5,3,2005,3298833,1639775,1659058
29116,5,4,2005,9661,4556,5105
29117,5,172,2005,96684,46391,50293
29118,5,68,2005,1734,870,864
29119,5,69,2005,2687,1564,1123
29120,5,6,2005,2330,1213,1117
29121,5,16,2005,700,317,383
29122,5,177,2005,1548,806,742
29123,5,167,2005,1449,1360,89
29124,5,121,2005,6291,2892,3399
29125,5,19,2005,10884,5147,5737
29126,5,7,2005,667,274,393
29127,5,124,2005,382,232,150
29128,5,8,2005,764918,438663,326255
29129,5,162,2005,930,398,532
29130,5,9,2005,1128173,565988,562185
29131,5,61,2005,299,148,151
29132,5,23,2005,11769,4896,6873
29133,5,10,2005,202417,99734,102683
29134,5,26,2005,141,69,72
29135,5,36,2005,1526,823,703
29136,5,130,2005,29845,15175,14670
29137,5,27,2005,31371,13364,18007
29138,5,50,2005,9732,4578,5154
29139,5,1,2005,1161,624,537
29140,5,132,2005,1304,697,607
29141,6,2,2005,2376348,1071112,1305236
29142,6,11,2005,1867,933,934
29143,6,12,2005,7767,3845,3922
29144,6,16,2005,121384,56684,64700
29145,6,9,2005,18233,7835,10398
29146,6,26,2005,1099,515,584
29147,6,170,2005,2990,1229,1761
29148,16,2,2005,313,170,143
29149,16,119,2005,808,301,507
29150,16,5,2005,233,105,128
29151,16,6,2005,17651,9490,8161
29152,16,18,2005,10358,3578,6780
29153,16,19,2005,401,151,250
29154,16,20,2005,1526,738,788
29155,16,161,2005,200,61,139
29156,16,144,2005,587,257,330
29157,16,9,2005,683,210,473
29158,16,36,2005,273,99,174
29159,16,23,2005,675,224,451
29160,16,128,2005,415,136,279
29161,16,129,2005,296,46,250
29162,16,145,2005,3800,586,3214
29163,16,25,2005,6209,2670,3539
29164,16,27,2005,289,79,210
29165,16,146,2005,313,53,260
29166,16,26,2005,17586,7225,10361
29167,16,142,2005,14394,3182,11212
29168,16,28,2005,2005,481,1524
29169,44,2,2005,173,31,142
29170,44,51,2005,347,134,213
29171,44,141,2005,688,184,504
29172,44,52,2005,3,3,0
29173,44,134,2005,561,260,301
29174,44,75,2005,2,1,1
29175,44,76,2005,3,1,2
29176,44,103,2005,382,188,194
29177,44,11,2005,62,28,34
29178,44,77,2005,8,4,4
29179,44,66,2005,634,364,270
29180,44,12,2005,59,25,34
29181,44,78,2005,31,14,17
29182,44,13,2005,96,46,50
29183,44,3,2005,2413,798,1615
29184,44,79,2005,22,11,11
29185,44,29,2005,714,375,339
29186,44,67,2005,1321,662,659
29187,44,95,2005,3,3,0
29188,44,151,2005,39,23,16
29189,44,4,2005,8,3,5
29190,44,53,2005,749,367,382
29191,44,147,2005,93,40,53
29192,44,105,2005,7146,2913,4233
29193,44,30,2005,1642,821,821
29194,44,152,2005,11,3,8
29195,44,116,2005,56,25,31
29196,44,153,2005,5,1,4
29197,44,135,2005,405,218,187
29198,44,80,2005,29,15,14
29199,44,136,2005,12,4,8
29200,44,106,2005,165,90,75
29201,44,172,2005,10704,5095,5609
29202,44,173,2005,1610,848,762
29203,44,137,2005,2058,980,1078
29204,44,96,2005,13,7,6
29205,44,54,2005,591,267,324
29206,44,81,2005,96,49,47
29207,44,14,2005,240,112,128
29208,44,31,2005,5096,2271,2825
29209,44,176,2005,153,85,68
29210,44,137,2005,60,31,29
29211,44,39,2005,807,405,402
29212,44,118,2005,2,1,1
29213,44,82,2005,2,1,1
29214,44,83,2005,12,4,8
29215,44,108,2005,46,29,17
29216,44,142,2005,622,184,438
29217,44,97,2005,31,17,14
29218,44,119,2005,45,15,30
29219,44,40,2005,2297,1196,1101
29220,44,148,2005,25,14,11
29221,44,120,2005,180,92,88
29222,44,41,2005,4,3,1
29223,44,42,2005,844,524,320
29224,44,68,2005,9213,5074,4139
29225,44,139,2005,5,3,2
29226,44,155,2005,66,29,37
29227,44,15,2005,299,125,174
29228,44,69,2005,11805,6356,5449
29229,44,156,2005,588,302,286
29230,44,55,2005,45,21,24
29231,44,56,2005,505,202,303
29232,44,84,2005,17,7,10
29233,44,98,2005,145,71,74
29234,44,157,2005,59,24,35
29235,44,158,2005,2,1,1
29236,44,110,2005,34,19,15
29237,44,85,2005,5,3,2
29238,44,99,2005,14,9,5
29239,44,32,2005,5545,2425,3120
29240,44,43,2005,45,21,24
29241,44,5,2005,13821,6594,7227
29242,44,6,2005,520,165,355
29243,44,16,2005,529,191,338
29244,44,17,2005,256,110,146
29245,44,57,2005,6259,2722,3537
29246,44,86,2005,139,89,50
29247,44,177,2005,618,385,233
29248,44,18,2005,131,54,77
29249,44,167,2005,302,153,149
29250,44,121,2005,563,304,259
29251,44,19,2005,235,89,146
29252,44,168,2005,37,19,18
29253,44,46,2005,16717,8245,8472
29254,44,20,2005,155,62,93
29255,44,149,2005,45,23,22
29256,44,159,2005,125,51,74
29257,44,143,2005,513,205,308
29258,44,70,2005,3,1,2
29259,44,47,2005,29282,13983,15299
29260,44,71,2005,123,59,64
29261,44,122,2005,14,9,5
29262,44,123,2005,88,39,49
29263,44,7,2005,3,3,0
29264,44,160,2005,34,17,17
29265,44,58,2005,299,151,148
29266,44,161,2005,9,4,5
29267,44,124,2005,1969,802,1167
29268,44,100,2005,356,231,125
29269,44,72,2005,8,3,5
29270,44,87,2005,2,1,1
29271,44,144,2005,319,91,228
29272,44,125,2005,46,21,25
29273,44,150,2005,44,25,19
29274,44,8,2005,159,48,111
29275,44,73,2005,4163,2003,2160
29276,44,101,2005,19,10,9
29277,44,162,2005,17533,9018,8515
29278,44,60,2005,765,304,461
29279,44,48,2005,356,176,180
29280,44,21,2005,57,27,30
29281,44,9,2005,6971,2662,4309
29282,44,102,2005,19,11,8
29283,44,111,2005,31,20,11
29284,44,112,2005,148,91,57
29285,44,33,2005,90158,37756,52402
29286,44,61,2005,1860,791,1069
29287,44,22,2005,40,18,22
29288,44,35,2005,13632,6683,6949
29289,44,36,2005,5108,2543,2565
29290,44,126,2005,93,52,41
29291,44,90,2005,3,1,2
29292,44,91,2005,8,3,5
29293,44,92,2005,3,1,2
29294,44,23,2005,502,230,272
29295,44,164,2005,26,13,13
29296,44,127,2005,13,7,6
29297,44,165,2005,229,88,141
29298,44,37,2005,9193,3836,5357
29299,44,64,2005,160,74,86
29300,44,128,2005,620,273,347
29301,44,115,2005,7504,3648,3856
29302,44,65,2005,6314,3601,2713
29303,44,10,2005,278,109,169
29304,44,145,2005,688,232,456
29305,44,113,2005,14,9,5
29306,44,49,2005,1633,949,684
29307,44,74,2005,646,364,282
29308,44,25,2005,133,39,94
29309,44,169,2005,25,14,11
29310,44,166,2005,133,50,83
29311,44,93,2005,131,77,54
29312,44,146,2005,117,21,96
29313,44,26,2005,572,128,444
29314,44,170,2005,5,3,2
29315,44,94,2005,2,0,2
29316,44,130,2005,175,90,85
29317,44,38,2005,3627,1649,1978
29318,44,27,2005,235,107,128
29319,44,50,2005,207764,100139,107625
29320,44,131,2005,147,77,70
29321,44,114,2005,65,34,31
29322,44,171,2005,108,58,50
29323,44,1,2005,742,434,308
29324,44,28,2005,36,14,22
29325,44,132,2005,397,197,200
29326,44,133,2005,2459,1215,1244
29327,45,44,2005,1955,1185,770
29328,45,115,2005,485,265,220
29329,45,50,2005,36200,18255,17945
29330,17,2,2005,2610,1375,1235
29331,17,141,2005,36950,19904,17046
29332,17,12,2005,13969,7402,6567
29333,17,103,2005,34777,18320,16457
29334,17,66,2005,5525,3007,2518
29335,17,67,2005,5219,2894,2325
29336,17,105,2005,7919,4480,3439
29337,17,30,2005,17611,9756,7855
29338,17,29,2005,26567,14655,11912
29339,17,106,2005,3134,1687,1447
29340,17,172,2005,747,414,333
29341,17,107,2005,2226,1304,922
29342,17,39,2005,1625,1073,552
29343,17,120,2005,67189,33746,33443
29344,17,42,2005,384,282,102
29345,17,68,2005,33850,18462,15388
29346,17,15,2005,14988,7860,7128
29347,17,69,2005,24742,13985,10757
29348,17,56,2005,2495,1362,1133
29349,17,32,2005,13609,7463,6146
29350,17,5,2005,18334,9564,8770
29351,17,6,2005,50950,26154,24796
29352,17,16,2005,70291,36518,33773
29353,17,57,2005,5035,2768,2267
29354,17,167,2005,11179,6103,5076
29355,17,168,2005,2037,1139,898
29356,17,20,2005,5468,3160,2308
29357,17,46,2005,5829,3235,2594
29358,17,143,2005,17977,9679,8298
29359,17,47,2005,7185,4019,3166
29360,17,100,2005,2209,1153,1056
29361,17,144,2005,161576,84709,76867
29362,17,73,2005,4864,2829,2035
29363,17,112,2005,1840,1010,830
29364,17,33,2005,71802,39837,31965
29365,17,35,2005,112577,62551,50026
29366,17,36,2005,135827,76270,59557
29367,17,115,2005,10671,5714,4957
29368,17,65,2005,2317,1312,1005
29369,17,49,2005,856,511,345
29370,17,74,2005,3461,2021,1440
29371,17,25,2005,10017,5419,4598
29372,17,169,2005,2774,1440,1334
29373,17,146,2005,29309,15558,13751
29374,17,26,2005,29236,15281,13955
29375,17,170,2005,1699,898,801
29376,17,38,2005,146749,81088,65661
29377,17,142,2005,21399,11289,10110
29378,17,50,2005,19593,10556,9037
29379,17,114,2005,5697,3050,2647
29380,17,171,2005,25379,13392,11987
29381,17,28,2005,32787,17902,14885
29382,57,2,2005,3384,220,3164
29383,57,51,2005,360959,170943,190016
29384,57,141,2005,19139,6406,12733
29385,57,52,2005,75,52,23
29386,57,134,2005,1807,935,872
29387,57,76,2005,17,12,5
29388,57,103,2005,46708,25623,21085
29389,57,11,2005,768,481,287
29390,57,66,2005,13214,9566,3648
29391,57,12,2005,404,276,128
29392,57,78,2005,60,39,21
29393,57,13,2005,27,15,12
29394,57,3,2005,60160,16566,43594
29395,57,79,2005,36,18,18
29396,57,29,2005,17026,8417,8609
29397,57,67,2005,27739,16160,11579
29398,57,95,2005,20,9,11
29399,57,151,2005,1886,778,1108
29400,57,4,2005,36,12,24
29401,57,53,2005,18972,10974,7998
29402,57,147,2005,27,14,13
29403,57,105,2005,66536,45192,21344
29404,57,30,2005,34041,21931,12110
29405,57,152,2005,8261,2726,5535
29406,57,116,2005,780,468,312
29407,57,153,2005,5598,4341,1257
29408,57,135,2005,7462,3630,3832
29409,57,136,2005,344,100,244
29410,57,106,2005,8795,5233,3562
29411,57,172,2005,137633,68928,68705
29412,57,107,2005,27259,18449,8810
29413,57,117,2005,24,16,8
29414,57,137,2005,3336,1642,1694
29415,57,96,2005,1009,666,343
29416,57,54,2005,26910,15391,11519
29417,57,81,2005,22561,17884,4677
29418,57,14,2005,423,235,188
29419,57,31,2005,8038,6820,1218
29420,57,176,2005,83,50,33
29421,57,137,2005,4059,2079,1980
29422,57,39,2005,2924,2021,903
29423,57,118,2005,56,31,25
29424,57,82,2005,191,137,54
29425,57,83,2005,30028,21716,8312
29426,57,108,2005,55031,34005,21026
29427,57,142,2005,75904,23013,52891
29428,57,97,2005,8882,6020,2862
29429,57,138,2005,91,47,44
29430,57,119,2005,10504,5834,4670
29431,57,40,2005,887,760,127
29432,57,148,2005,22,15,7
29433,57,120,2005,17983,10752,7231
29434,57,42,2005,2519,2095,424
29435,57,68,2005,90429,56970,33459
29436,57,139,2005,260,127,133
29437,57,155,2005,1078,228,850
29438,57,15,2005,6271,5342,929
29439,57,69,2005,137808,80838,56970
29440,57,156,2005,40455,16655,23800
29441,57,56,2005,13720,6956,6764
29442,57,84,2005,12,9,3
29443,57,98,2005,1367,891,476
29444,57,157,2005,2587,831,1756
29445,57,158,2005,525,187,338
29446,57,110,2005,53,45,8
29447,57,85,2005,466,307,159
29448,57,99,2005,1442,1070,372
29449,57,32,2005,8970,7026,1944
29450,57,43,2005,217,149,68
29451,57,5,2005,89745,36220,53525
29452,57,6,2005,11701,5113,6588
29453,57,16,2005,2693,748,1945
29454,57,44,2005,2968,1800,1168
29455,57,17,2005,3218,1323,1895
29456,57,86,2005,260,163,97
29457,57,177,2005,7707,5404,2303
29458,57,18,2005,2982,889,2093
29459,57,167,2005,2196,1852,344
29460,57,121,2005,2345,1438,907
29461,57,19,2005,325,132,193
29462,57,168,2005,703,586,117
29463,57,46,2005,1918,1562,356
29464,57,20,2005,5617,2120,3497
29465,57,149,2005,19,9,10
29466,57,159,2005,1109,229,880
29467,57,143,2005,19794,10250,9544
29468,57,70,2005,85,46,39
29469,57,47,2005,3113,2412,701
29470,57,71,2005,2713,1511,1202
29471,57,122,2005,1740,1286,454
29472,57,123,2005,110,62,48
29473,57,7,2005,23,5,18
29474,57,160,2005,2339,356,1983
29475,57,58,2005,1533,1182,351
29476,57,161,2005,531,136,395
29477,57,124,2005,10018,5728,4290
29478,57,100,2005,6424,4563,1861
29479,57,72,2005,910,501,409
29480,57,59,2005,4170,2059,2111
29481,57,144,2005,355367,153290,202077
29482,57,125,2005,586,394,192
29483,57,150,2005,64,37,27
29484,57,8,2005,985,422,563
29485,57,73,2005,11432,7272,4160
29486,57,101,2005,806,549,257
29487,57,162,2005,41515,23349,18166
29488,57,60,2005,58767,25560,33207
29489,57,48,2005,1478,990,488
29490,57,21,2005,46,27,19
29491,57,9,2005,54772,17487,37285
29492,57,102,2005,801,610,191
29493,57,111,2005,1607,1152,455
29494,57,112,2005,81359,51302,30057
29495,57,33,2005,80891,61473,19418
29496,57,61,2005,5830,3941,1889
29497,57,22,2005,41,20,21
29498,57,35,2005,570087,329488,240599
29499,57,36,2005,47776,37591,10185
29500,57,126,2005,705,388,317
29501,57,90,2005,7,6,1
29502,57,91,2005,17,9,8
29503,57,92,2005,13,8,5
29504,57,62,2005,2509,1391,1118
29505,57,140,2005,59,44,15
29506,57,23,2005,527,246,281
29507,57,164,2005,67115,13675,53440
29508,57,63,2005,61890,31521,30369
29509,57,127,2005,919,737,182
29510,57,165,2005,1098,488,610
29511,57,37,2005,7134,5443,1691
29512,57,64,2005,4763,2987,1776
29513,57,128,2005,9198,4632,4566
29514,57,115,2005,3447,2024,1423
29515,57,129,2005,0,0,0
29516,57,65,2005,25685,19334,6351
29517,57,10,2005,63528,28517,35011
29518,57,145,2005,1864,457,1407
29519,57,113,2005,36,24,12
29520,57,49,2005,5224,3662,1562
29521,57,74,2005,110133,59986,50147
29522,57,25,2005,4728,1750,2978
29523,57,169,2005,108,78,30
29524,57,166,2005,3273,1241,2032
29525,57,93,2005,125,94,31
29526,57,146,2005,91608,34015,57593
29527,57,26,2005,15053,6563,8490
29528,57,170,2005,125,106,19
29529,57,130,2005,665,384,281
29530,57,38,2005,117957,92797,25160
29531,57,27,2005,195,93,102
29532,57,50,2005,48310,29209,19101
29533,57,131,2005,1195,706,489
29534,57,114,2005,5048,2957,2091
29535,57,171,2005,1835,1556,279
29536,57,1,2005,3637,2064,1573
29537,57,28,2005,245,121,124
29538,57,132,2005,517,276,241
29539,57,133,2005,516,289,227
29540,86,76,2005,161,82,79
29541,86,78,2005,695,354,341
29542,86,79,2005,560,285,275
29543,86,95,2005,7,4,3
29544,86,96,2005,104,59,45
29545,86,81,2005,1879,950,929
29546,86,82,2005,144,74,70
29547,86,97,2005,139,79,60
29548,86,84,2005,216,111,105
29549,86,98,2005,318,179,139
29550,86,99,2005,169,96,73
29551,86,5,2005,1183,445,738
29552,86,101,2005,130,74,56
29553,86,102,2005,78,44,34
29554,86,90,2005,101,52,49
29555,86,91,2005,344,175,169
29556,86,92,2005,236,120,116
29557,86,93,2005,2413,1229,1184
29558,86,50,2005,4973,2558,2415
29559,177,103,2005,3000,1634,1366
29560,177,66,2005,537,292,245
29561,177,3,2005,9597,5226,4371
29562,177,67,2005,657,357,300
29563,177,105,2005,217455,118405,99050
29564,177,172,2005,648120,351301,296819
29565,177,39,2005,471,256,215
29566,177,142,2005,1503,818,685
29567,177,42,2005,565,308,257
29568,177,68,2005,8545,4653,3892
29569,177,69,2005,5632,3067,2565
29570,177,156,2005,1776,967,809
29571,177,5,2005,21219,11554,9665
29572,177,6,2005,4566,2486,2080
29573,177,44,2005,1001,545,456
29574,177,57,2005,2576,1403,1173
29575,177,100,2005,1845,1004,841
29576,177,73,2005,1037,564,473
29577,177,162,2005,2574,1402,1172
29578,177,48,2005,392,213,179
29579,177,9,2005,9714,5289,4425
29580,177,112,2005,51532,28060,23472
29581,177,33,2005,922,502,420
29582,177,61,2005,439,239,200
29583,177,36,2005,7370,4013,3357
29584,177,65,2005,1799,980,819
29585,177,10,2005,8580,4671,3909
29586,177,49,2005,1465,798,667
29587,177,74,2005,1027,559,468
29588,177,50,2005,15133,8240,6893
29589,177,1,2005,39408,21457,17951
29590,18,2,2005,38,12,26
29591,18,141,2005,313,135,178
29592,18,66,2005,107,33,74
29593,18,13,2005,388,111,277
29594,18,3,2005,9088,1828,7260
29595,18,11,2005,24,12,12
29596,18,67,2005,67,26,41
29597,18,53,2005,56,22,34
29598,18,105,2005,97,37,60
29599,18,30,2005,46,20,26
29600,18,10,2005,11370,7440,3930
29601,18,136,2005,24,4,20
29602,18,172,2005,8438,5431,3007
29603,18,107,2005,23,10,13
29604,18,54,2005,24,13,11
29605,18,14,2005,121,46,75
29606,18,31,2005,22,10,12
29607,18,39,2005,46,15,31
29608,18,120,2005,70,47,23
29609,18,119,2005,69,22,47
29610,18,68,2005,361,127,234
29611,18,69,2005,653,224,429
29612,18,156,2005,25,6,19
29613,18,56,2005,57,27,30
29614,18,173,2005,36,11,25
29615,18,32,2005,535,221,314
29616,18,5,2005,4622,419,4203
29617,18,6,2005,87,31,56
29618,18,16,2005,139668,55278,84390
29619,18,44,2005,48,20,28
29620,18,17,2005,1431,345,1086
29621,18,57,2005,282,108,174
29622,18,177,2005,95,24,71
29623,18,167,2005,19,10,9
29624,18,176,2005,77,17,60
29625,18,19,2005,685,144,541
29626,18,20,2005,1674,673,1001
29627,18,143,2005,888,273,615
29628,18,161,2005,63,11,52
29629,18,144,2005,545,308,237
29630,18,21,2005,580,219,361
29631,18,8,2005,166,51,115
29632,18,73,2005,182,67,115
29633,18,162,2005,24,6,18
29634,18,48,2005,40,15,25
29635,18,9,2005,2965,880,2085
29636,18,33,2005,75,33,42
29637,18,22,2005,204,39,165
29638,18,35,2005,248,142,106
29639,18,36,2005,544,292,252
29640,18,23,2005,4586,1086,3500
29641,18,63,2005,54,32,22
29642,18,37,2005,21,11,10
29643,18,128,2005,69,21,48
29644,18,115,2005,54,13,41
29645,18,65,2005,278,120,158
29646,18,129,2005,253,65,188
29647,18,145,2005,2048,525,1523
29648,18,49,2005,83,34,49
29649,18,74,2005,182,66,116
29650,18,25,2005,54460,17064,37396
29651,18,27,2005,191,59,132
29652,18,146,2005,237,85,152
29653,18,26,2005,935,171,764
29654,18,38,2005,361,225,136
29655,18,60,2005,81,42,39
29656,18,142,2005,97992,23498,74494
29657,18,50,2005,737,230,507
29658,18,28,2005,2169,522,1647
29659,167,12,2005,40508,18460,22048
29660,167,11,2005,7657,3254,4403
29661,167,29,2005,57891,29951,27940
29662,167,172,2005,1811,814,997
29663,167,40,2005,932,509,423
29664,167,15,2005,2742,1068,1674
29665,167,176,2005,51580,25985,25595
29666,167,168,2005,5639,3051,2588
29667,167,46,2005,932,457,475
29668,167,47,2005,3673,1729,1944
29669,167,36,2005,2122379,1134252,988127
29670,167,169,2005,13244,6204,7040
29671,167,26,2005,39266,19069,20197
29672,167,170,2005,879,356,523
29673,167,38,2005,283038,148638,134400
29674,167,171,2005,216537,105443,111094
29675,121,116,2005,2045,991,1054
29676,121,137,2005,2749,1301,1448
29677,121,120,2005,20917,9158,11759
29678,121,119,2005,696,337,359
29679,121,125,2005,523,252,271
29680,121,150,2005,60,29,31
29681,121,126,2005,4059,1962,2097
29682,121,128,2005,208156,98561,109595
29683,121,115,2005,98,48,50
29684,121,129,2005,62546,29187,33359
29685,121,145,2005,76711,34519,42192
29686,121,130,2005,291776,147181,144595
29687,121,131,2005,42082,20281,21801
29688,19,2,2005,1317,449,868
29689,19,13,2005,538,361,177
29690,19,3,2005,175042,28466,146576
29691,19,10,2005,20377,10870,9507
29692,19,136,2005,859,292,567
29693,19,120,2005,2189,745,1444
29694,19,119,2005,3108,1059,2049
29695,19,68,2005,1426,615,811
29696,19,5,2005,485921,131954,353967
29697,19,18,2005,24523,9691,14832
29698,19,20,2005,4456,1517,2939
29699,19,144,2005,1574,536,1038
29700,19,8,2005,1398,477,921
29701,19,73,2005,641,297,344
29702,19,162,2005,1145,390,755
29703,19,9,2005,162388,42300,120088
29704,19,22,2005,142,106,36
29705,19,23,2005,1088,387,701
29706,19,128,2005,2084,709,1375
29707,19,129,2005,0,0,0
29708,19,145,2005,30756,12118,18638
29709,19,25,2005,10882,3705,7177
29710,19,27,2005,13638,7333,6305
29711,19,146,2005,949,324,625
29712,19,26,2005,7907,2692,5215
29713,19,142,2005,128040,47580,80460
29714,19,50,2005,6444,2558,3886
29715,19,28,2005,35981,12252,23729
29716,168,12,2005,7024,3421,3603
29717,168,11,2005,3603,1733,1870
29718,168,29,2005,15151,9378,5773
29719,168,172,2005,375,184,191
29720,168,40,2005,848,492,356
29721,168,42,2005,185,77,108
29722,168,15,2005,4973,2544,2429
29723,168,69,2005,3864,2220,1644
29724,168,167,2005,19645,11867,7778
29725,168,176,2005,1654,918,736
29726,168,46,2005,1351,777,574
29727,168,47,2005,3875,2240,1635
29728,168,33,2005,4539,2785,1754
29729,168,35,2005,628,339,289
29730,168,36,2005,170969,101430,69539
29731,168,1,2005,150,53,97
29732,168,169,2005,2320,1181,1139
29733,168,26,2005,1098,573,525
29734,168,170,2005,1502,856,646
29735,168,38,2005,41421,24834,16587
29736,168,171,2005,12800,7096,5704
29737,46,2,2005,24,1,23
29738,46,51,2005,7,3,4
29739,46,141,2005,14,2,12
29740,46,52,2005,0,0,0
29741,46,134,2005,2,1,1
29742,46,75,2005,4,1,3
29743,46,76,2005,0,0,0
29744,46,103,2005,21,12,9
29745,46,11,2005,1010,378,632
29746,46,77,2005,0,0,0
29747,46,66,2005,124,57,67
29748,46,12,2005,2806,1132,1674
29749,46,13,2005,0,0,0
29750,46,3,2005,6,0,6
29751,46,79,2005,1,0,1
29752,46,29,2005,67044,42036,25008
29753,46,67,2005,72,30,42
29754,46,151,2005,0,0,0
29755,46,53,2005,4,0,4
29756,46,147,2005,0,0,0
29757,46,105,2005,27,9,18
29758,46,30,2005,297,46,251
29759,46,116,2005,0,0,0
29760,46,153,2005,1,0,1
29761,46,135,2005,1,0,1
29762,46,106,2005,3,0,3
29763,46,172,2005,281,132,149
29764,46,107,2005,7,5,2
29765,46,137,2005,1,0,1
29766,46,96,2005,0,0,0
29767,46,54,2005,7,1,6
29768,46,81,2005,64,23,41
29769,46,14,2005,12,7,5
29770,46,31,2005,215,118,97
29771,46,176,2005,14,5,9
29772,46,137,2005,0,0,0
29773,46,39,2005,222,45,177
29774,46,83,2005,0,0,0
29775,46,108,2005,0,0,0
29776,46,142,2005,26,4,22
29777,46,119,2005,0,0,0
29778,46,40,2005,3803,2045,1758
29779,46,41,2005,0,0,0
29780,46,42,2005,226,90,136
29781,46,68,2005,232,101,131
29782,46,139,2005,0,0,0
29783,46,155,2005,0,0,0
29784,46,15,2005,1850,806,1044
29785,46,69,2005,3723,1478,2245
29786,46,156,2005,0,0,0
29787,46,56,2005,23,9,14
29788,46,98,2005,0,0,0
29789,46,32,2005,267,142,125
29790,46,43,2005,24,4,20
29791,46,5,2005,89,16,73
29792,46,6,2005,34,7,27
29793,46,16,2005,8,3,5
29794,46,44,2005,399,198,201
29795,46,17,2005,81,32,49
29796,46,57,2005,189,61,128
29797,46,86,2005,0,0,0
29798,46,177,2005,12,7,5
29799,46,18,2005,7,1,6
29800,46,167,2005,7993,4282,3711
29801,46,121,2005,1,1,0
29802,46,19,2005,2,0,2
29803,46,168,2005,1124,624,500
29804,46,20,2005,44,4,40
29805,46,143,2005,4,2,2
29806,46,70,2005,0,0,0
29807,46,47,2005,24365,14239,10126
29808,46,71,2005,7,3,4
29809,46,122,2005,0,0,0
29810,46,123,2005,0,0,0
29811,46,160,2005,2,0,2
29812,46,58,2005,6,1,5
29813,46,161,2005,0,0,0
29814,46,124,2005,0,0,0
29815,46,100,2005,28,6,22
29816,46,72,2005,0,0,0
29817,46,59,2005,0,0,0
29818,46,144,2005,8,2,6
29819,46,125,2005,0,0,0
29820,46,150,2005,0,0,0
29821,46,8,2005,8,1,7
29822,46,73,2005,89,19,70
29823,46,101,2005,0,0,0
29824,46,162,2005,10,0,10
29825,46,60,2005,0,0,0
29826,46,48,2005,123,40,83
29827,46,9,2005,34,4,30
29828,46,111,2005,1,0,1
29829,46,112,2005,7,1,6
29830,46,33,2005,1397,811,586
29831,46,61,2005,27,8,19
29832,46,22,2005,0,0,0
29833,46,35,2005,191,34,157
29834,46,36,2005,201748,124009,77739
29835,46,126,2005,0,0,0
29836,46,23,2005,1,0,1
29837,46,63,2005,3,0,3
29838,46,165,2005,2,0,2
29839,46,37,2005,36,17,19
29840,46,64,2005,7,4,3
29841,46,128,2005,2,0,2
29842,46,115,2005,8,2,6
29843,46,129,2005,2,0,2
29844,46,65,2005,107,39,68
29845,46,10,2005,26,7,19
29846,46,145,2005,1,0,1
29847,46,49,2005,331,108,223
29848,46,74,2005,58,22,36
29849,46,25,2005,15,0,15
29850,46,169,2005,754,378,376
29851,46,166,2005,0,0,0
29852,46,93,2005,1,0,1
29853,46,146,2005,1,0,1
29854,46,26,2005,66,16,50
29855,46,170,2005,831,430,401
29856,46,130,2005,2,0,2
29857,46,38,2005,47145,24498,22647
29858,46,27,2005,5,1,4
29859,46,50,2005,803,324,479
29860,46,131,2005,0,0,0
29861,46,114,2005,3,1,2
29862,46,171,2005,2641,1430,1211
29863,46,1,2005,8,2,6
29864,46,28,2005,0,0,0
29865,46,132,2005,0,0,0
29866,46,133,2005,3,0,3
29867,20,13,2005,180,76,104
29868,20,3,2005,3646,1077,2569
29869,20,10,2005,5279,5042,237
29870,20,172,2005,3918,3680,238
29871,20,68,2005,168,87,81
29872,20,69,2005,304,153,151
29873,20,32,2005,249,151,98
29874,20,5,2005,1854,248,1606
29875,20,16,2005,82759,39590,43169
29876,20,17,2005,664,234,430
29877,20,18,2005,778,457,321
29878,20,19,2005,318,98,220
29879,20,143,2005,412,185,227
29880,20,144,2005,254,209,45
29881,20,21,2005,270,149,121
29882,20,9,2005,1377,597,780
29883,20,36,2005,254,199,55
29884,20,23,2005,2129,736,1393
29885,20,129,2005,117,45,72
29886,20,145,2005,951,357,594
29887,20,25,2005,22970,10556,12414
29888,20,26,2005,434,116,318
29889,20,38,2005,168,153,15
29890,20,142,2005,112519,34123,78396
29891,20,50,2005,343,156,187
29892,20,28,2005,1007,355,652
29893,149,147,2005,104,58,46
29894,149,172,2005,116,50,66
29895,149,156,2005,86,29,57
29896,149,5,2005,219,97,122
29897,149,123,2005,36,14,22
29898,149,125,2005,23,7,16
29899,149,150,2005,4,1,3
29900,149,9,2005,219,97,122
29901,149,115,2005,2492,1210,1282
29902,149,133,2005,67,32,35
29903,149,148,2005,36,19,17
29904,149,130,2005,132,59,73
29905,149,131,2005,82,41,41
29906,149,132,2005,67,32,35
29907,159,151,2005,32,8,24
29908,159,68,2005,128,45,83
29909,159,155,2005,504,155,349
29910,159,69,2005,404,146,258
29911,159,156,2005,6646,1932,4714
29912,159,157,2005,25289,9376,15913
29913,159,5,2005,546,103,443
29914,159,57,2005,109,32,77
29915,159,20,2005,1852,555,1297
29916,159,160,2005,1186,266,920
29917,159,73,2005,130,45,85
29918,159,162,2005,2713,529,2184
29919,159,158,2005,987,365,622
29920,159,164,2005,216,48,168
29921,159,165,2005,26426,14268,12158
29922,159,65,2005,124,42,82
29923,159,49,2005,488,173,315
29924,159,74,2005,64,21,43
29925,159,166,2005,227,60,167
29926,159,50,2005,499,175,324
29927,159,152,2005,223,55,168
29928,143,2,2005,260,73,187
29929,143,51,2005,245,76,169
29930,143,141,2005,2911,1242,1669
29931,143,66,2005,611,283,328
29932,143,13,2005,785,188,597
29933,143,3,2005,1014,48,966
29934,143,11,2005,208,76,132
29935,143,67,2005,548,219,329
29936,143,53,2005,268,82,186
29937,143,105,2005,208,82,126
29938,143,29,2005,618,245,373
29939,143,10,2005,298,114,184
29940,143,136,2005,697,178,519
29941,143,172,2005,2494,698,1796
29942,143,117,2005,3485,478,3007
29943,143,137,2005,327,82,245
29944,143,137,2005,353,80,273
29945,143,39,2005,625,199,426
29946,143,97,2005,574,202,372
29947,143,120,2005,1485,537,948
29948,143,119,2005,1608,510,1098
29949,143,42,2005,674,247,427
29950,143,68,2005,4077,1413,2664
29951,143,118,2005,1155,307,848
29952,143,69,2005,5701,2309,3392
29953,143,156,2005,499,99,400
29954,143,56,2005,2122,859,1263
29955,143,32,2005,275,126,149
29956,143,5,2005,3928,884,3044
29957,143,6,2005,334,85,249
29958,143,16,2005,55536,17715,37821
29959,143,57,2005,5426,2039,3387
29960,143,177,2005,816,292,524
29961,143,167,2005,652,126,526
29962,143,18,2005,16551,4769,11782
29963,143,121,2005,272,92,180
29964,143,19,2005,8759,1850,6909
29965,143,20,2005,8975,3351,5624
29966,143,160,2005,275,64,211
29967,143,161,2005,291,62,229
29968,143,72,2005,224,72,152
29969,143,144,2005,3974,1958,2016
29970,143,21,2005,1374,279,1095
29971,143,73,2005,1436,614,822
29972,143,162,2005,2312,528,1784
29973,143,48,2005,272,103,169
29974,143,9,2005,1995,500,1495
29975,143,33,2005,551,291,260
29976,143,158,2005,253,2,251
29977,143,22,2005,1147,256,891
29978,143,35,2005,484,251,233
29979,143,36,2005,5876,2099,3777
29980,143,23,2005,28771,6766,22005
29981,143,164,2005,909,119,790
29982,143,165,2005,193,62,131
29983,143,128,2005,84783,23277,61506
29984,143,115,2005,525,153,372
29985,143,65,2005,589,224,365
29986,143,129,2005,1441,414,1027
29987,143,145,2005,11701,3362,8339
29988,143,49,2005,608,197,411
29989,143,74,2005,756,318,438
29990,143,25,2005,22517,6499,16018
29991,143,169,2005,551,119,432
29992,143,27,2005,2252,679,1573
29993,143,146,2005,2502,940,1562
29994,143,26,2005,2056,514,1542
29995,143,170,2005,193,43,150
29996,143,38,2005,710,334,376
29997,143,142,2005,17035,4923,12112
29998,143,50,2005,5865,2083,3782
29999,143,131,2005,216,55,161
30000,143,171,2005,306,39,267
30001,143,28,2005,17283,4379,12904
30002,70,2,2005,0,0,0
30003,70,51,2005,0,0,0
30004,70,141,2005,0,0,0
30005,70,52,2005,0,0,0
30006,70,134,2005,0,0,0
30007,70,103,2005,9,5,4
30008,70,11,2005,0,0,0
30009,70,66,2005,3109,1783,1326
30010,70,12,2005,0,0,0
30011,70,78,2005,0,0,0
30012,70,3,2005,0,0,0
30013,70,29,2005,0,0,0
30014,70,67,2005,31,15,16
30015,70,53,2005,357,201,156
30016,70,105,2005,103,73,30
30017,70,30,2005,16,3,13
30018,70,152,2005,0,0,0
30019,70,135,2005,0,0,0
30020,70,106,2005,0,0,0
30021,70,172,2005,58,29,29
30022,70,107,2005,15,11,4
30023,70,96,2005,0,0,0
30024,70,54,2005,143,76,67
30025,70,81,2005,0,0,0
30026,70,31,2005,33,18,15
30027,70,137,2005,0,0,0
30028,70,39,2005,18,5,13
30029,70,83,2005,32,21,11
30030,70,108,2005,0,0,0
30031,70,142,2005,0,0,0
30032,70,97,2005,0,0,0
30033,70,119,2005,0,0,0
30034,70,40,2005,9,0,9
30035,70,120,2005,0,0,0
30036,70,42,2005,4,2,2
30037,70,68,2005,93,46,47
30038,70,155,2005,0,0,0
30039,70,15,2005,0,0,0
30040,70,69,2005,1560,803,757
30041,70,56,2005,75,38,37
30042,70,98,2005,0,0,0
30043,70,157,2005,0,0,0
30044,70,85,2005,0,0,0
30045,70,99,2005,0,0,0
30046,70,32,2005,28,15,13
30047,70,43,2005,1,0,1
30048,70,5,2005,11,4,7
30049,70,6,2005,0,0,0
30050,70,16,2005,0,0,0
30051,70,44,2005,8,4,4
30052,70,17,2005,0,0,0
30053,70,57,2005,1185,468,717
30054,70,86,2005,0,0,0
30055,70,177,2005,0,0,0
30056,70,18,2005,0,0,0
30057,70,167,2005,0,0,0
30058,70,121,2005,0,0,0
30059,70,19,2005,0,0,0
30060,70,168,2005,0,0,0
30061,70,46,2005,0,0,0
30062,70,143,2005,0,0,0
30063,70,47,2005,0,0,0
30064,70,71,2005,5,2,3
30065,70,122,2005,0,0,0
30066,70,7,2005,0,0,0
30067,70,58,2005,0,0,0
30068,70,124,2005,0,0,0
30069,70,100,2005,10,5,5
30070,70,72,2005,0,0,0
30071,70,59,2005,55,0,55
30072,70,144,2005,0,0,0
30073,70,125,2005,0,0,0
30074,70,8,2005,0,0,0
30075,70,73,2005,64,34,30
30076,70,101,2005,0,0,0
30077,70,162,2005,0,0,0
30078,70,60,2005,344,161,183
30079,70,48,2005,9,5,4
30080,70,9,2005,0,0,0
30081,70,102,2005,0,0,0
30082,70,111,2005,0,0,0
30083,70,112,2005,0,0,0
30084,70,33,2005,30,18,12
30085,70,61,2005,513,255,258
30086,70,35,2005,13,10,3
30087,70,36,2005,31,23,8
30088,70,91,2005,0,0,0
30089,70,164,2005,0,0,0
30090,70,63,2005,335,32,303
30091,70,127,2005,0,0,0
30092,70,37,2005,26,19,7
30093,70,64,2005,92,67,25
30094,70,128,2005,0,0,0
30095,70,115,2005,15,8,7
30096,70,65,2005,429,203,226
30097,70,10,2005,0,0,0
30098,70,49,2005,23,13,10
30099,70,74,2005,8532,4230,4302
30100,70,25,2005,0,0,0
30101,70,93,2005,0,0,0
30102,70,146,2005,8,2,6
30103,70,26,2005,870,431,439
30104,70,130,2005,0,0,0
30105,70,38,2005,14,12,2
30106,70,27,2005,0,0,0
30107,70,50,2005,51,20,31
30108,70,131,2005,0,0,0
30109,70,114,2005,0,0,0
30110,70,171,2005,0,0,0
30111,70,1,2005,0,0,0
30112,70,132,2005,0,0,0
30113,70,133,2005,0,0,0
30114,47,2,2005,31,7,24
30115,47,51,2005,0,0,0
30116,47,141,2005,0,0,0
30117,47,134,2005,0,0,0
30118,47,103,2005,74,35,39
30119,47,11,2005,729,228,501
30120,47,77,2005,0,0,0
30121,47,66,2005,54,24,30
30122,47,12,2005,1271,412,859
30123,47,78,2005,0,0,0
30124,47,13,2005,0,0,0
30125,47,3,2005,0,0,0
30126,47,29,2005,52280,29998,22282
30127,47,67,2005,123,46,77
30128,47,95,2005,0,0,0
30129,47,151,2005,0,0,0
30130,47,53,2005,0,0,0
30131,47,105,2005,72,39,33
30132,47,30,2005,59,12,47
30133,47,135,2005,0,0,0
30134,47,106,2005,0,0,0
30135,47,172,2005,105,59,46
30136,47,107,2005,0,0,0
30137,47,137,2005,0,0,0
30138,47,54,2005,0,0,0
30139,47,81,2005,0,0,0
30140,47,14,2005,19,7,12
30141,47,31,2005,81,41,40
30142,47,176,2005,0,0,0
30143,47,137,2005,0,0,0
30144,47,39,2005,236,84,152
30145,47,82,2005,0,0,0
30146,47,108,2005,0,0,0
30147,47,142,2005,31,6,25
30148,47,119,2005,0,0,0
30149,47,40,2005,1107,546,561
30150,47,120,2005,0,0,0
30151,47,42,2005,89,31,58
30152,47,68,2005,280,131,149
30153,47,155,2005,0,0,0
30154,47,15,2005,868,345,523
30155,47,69,2005,1819,829,990
30156,47,156,2005,0,0,0
30157,47,56,2005,35,12,23
30158,47,157,2005,0,0,0
30159,47,110,2005,0,0,0
30160,47,99,2005,0,0,0
30161,47,32,2005,123,57,66
30162,47,43,2005,32,14,18
30163,47,5,2005,0,0,0
30164,47,6,2005,55,8,47
30165,47,16,2005,0,0,0
30166,47,44,2005,794,365,429
30167,47,17,2005,34,18,16
30168,47,57,2005,200,62,138
30169,47,86,2005,0,0,0
30170,47,177,2005,20,9,11
30171,47,18,2005,0,0,0
30172,47,167,2005,6388,3231,3157
30173,47,121,2005,0,0,0
30174,47,19,2005,0,0,0
30175,47,168,2005,569,292,277
30176,47,46,2005,8048,4183,3865
30177,47,20,2005,83,7,76
30178,47,159,2005,0,0,0
30179,47,143,2005,0,0,0
30180,47,71,2005,0,0,0
30181,47,122,2005,0,0,0
30182,47,123,2005,0,0,0
30183,47,7,2005,0,0,0
30184,47,160,2005,0,0,0
30185,47,58,2005,0,0,0
30186,47,161,2005,0,0,0
30187,47,124,2005,0,0,0
30188,47,100,2005,0,0,0
30189,47,72,2005,0,0,0
30190,47,144,2005,0,0,0
30191,47,125,2005,0,0,0
30192,47,150,2005,0,0,0
30193,47,8,2005,0,0,0
30194,47,73,2005,85,30,55
30195,47,101,2005,0,0,0
30196,47,162,2005,16,0,16
30197,47,60,2005,0,0,0
30198,47,48,2005,632,284,348
30199,47,21,2005,0,0,0
30200,47,9,2005,50,4,46
30201,47,111,2005,0,0,0
30202,47,112,2005,0,0,0
30203,47,33,2005,3467,1976,1491
30204,47,61,2005,33,8,25
30205,47,22,2005,0,0,0
30206,47,35,2005,130,19,111
30207,47,36,2005,88849,48045,40804
30208,47,126,2005,0,0,0
30209,47,23,2005,0,0,0
30210,47,63,2005,0,0,0
30211,47,37,2005,25,12,13
30212,47,64,2005,0,0,0
30213,47,128,2005,0,0,0
30214,47,115,2005,0,0,0
30215,47,65,2005,745,306,439
30216,47,10,2005,0,0,0
30217,47,145,2005,0,0,0
30218,47,113,2005,0,0,0
30219,47,49,2005,293,115,178
30220,47,74,2005,37,10,27
30221,47,25,2005,0,0,0
30222,47,169,2005,487,221,266
30223,47,166,2005,0,0,0
30224,47,146,2005,0,0,0
30225,47,26,2005,59,13,46
30226,47,170,2005,356,198,158
30227,47,130,2005,0,0,0
30228,47,38,2005,18521,8826,9695
30229,47,27,2005,21,9,12
30230,47,50,2005,2224,1045,1179
30231,47,131,2005,0,0,0
30232,47,114,2005,24,14,10
30233,47,171,2005,1480,726,754
30234,47,1,2005,52,17,35
30235,47,132,2005,0,0,0
30236,47,133,2005,0,0,0
30237,71,2,2005,0,0,0
30238,71,51,2005,229,104,125
30239,71,141,2005,76,38,38
30240,71,52,2005,0,0,0
30241,71,134,2005,0,0,0
30242,71,76,2005,0,0,0
30243,71,103,2005,30,13,17
30244,71,11,2005,0,0,0
30245,71,77,2005,0,0,0
30246,71,66,2005,548,315,233
30247,71,12,2005,0,0,0
30248,71,78,2005,0,0,0
30249,71,13,2005,0,0,0
30250,71,3,2005,22,8,14
30251,71,79,2005,0,0,0
30252,71,29,2005,32,28,4
30253,71,67,2005,12758,6336,6422
30254,71,151,2005,0,0,0
30255,71,4,2005,0,0,0
30256,71,53,2005,1848,864,984
30257,71,147,2005,0,0,0
30258,71,105,2005,227,145,82
30259,71,30,2005,334,222,112
30260,71,152,2005,0,0,0
30261,71,116,2005,0,0,0
30262,71,153,2005,1234,640,594
30263,71,135,2005,45,26,19
30264,71,136,2005,0,0,0
30265,71,106,2005,44,19,25
30266,71,172,2005,804,389,415
30267,71,107,2005,19,12,7
30268,71,117,2005,0,0,0
30269,71,137,2005,0,0,0
30270,71,96,2005,0,0,0
30271,71,54,2005,316,145,171
30272,71,81,2005,17,10,7
30273,71,14,2005,21,10,11
30274,71,31,2005,336,227,109
30275,71,176,2005,0,0,0
30276,71,137,2005,74,37,37
30277,71,39,2005,1637,848,789
30278,71,118,2005,0,0,0
30279,71,82,2005,88,60,28
30280,71,83,2005,26,16,10
30281,71,108,2005,0,0,0
30282,71,142,2005,19,7,12
30283,71,97,2005,0,0,0
30284,71,138,2005,0,0,0
30285,71,119,2005,0,0,0
30286,71,40,2005,179,145,34
30287,71,148,2005,0,0,0
30288,71,120,2005,0,0,0
30289,71,42,2005,749,444,305
30290,71,68,2005,20304,10760,9544
30291,71,139,2005,0,0,0
30292,71,155,2005,0,0,0
30293,71,15,2005,0,0,0
30294,71,69,2005,8886,4875,4011
30295,71,156,2005,0,0,0
30296,71,55,2005,0,0,0
30297,71,56,2005,1083,542,541
30298,71,84,2005,0,0,0
30299,71,98,2005,0,0,0
30300,71,157,2005,0,0,0
30301,71,158,2005,0,0,0
30302,71,110,2005,0,0,0
30303,71,85,2005,0,0,0
30304,71,99,2005,0,0,0
30305,71,32,2005,414,277,137
30306,71,43,2005,251,136,115
30307,71,5,2005,147,72,75
30308,71,6,2005,177,81,96
30309,71,16,2005,0,0,0
30310,71,44,2005,910,478,432
30311,71,17,2005,31,12,19
30312,71,57,2005,14814,7282,7532
30313,71,86,2005,0,0,0
30314,71,177,2005,215,113,102
30315,71,18,2005,0,0,0
30316,71,167,2005,0,0,0
30317,71,121,2005,0,0,0
30318,71,19,2005,0,0,0
30319,71,168,2005,0,0,0
30320,71,46,2005,162,139,23
30321,71,20,2005,26,15,11
30322,71,159,2005,0,0,0
30323,71,143,2005,0,0,0
30324,71,70,2005,0,0,0
30325,71,47,2005,201,133,68
30326,71,122,2005,0,0,0
30327,71,123,2005,0,0,0
30328,71,160,2005,0,0,0
30329,71,58,2005,93,38,55
30330,71,161,2005,0,0,0
30331,71,124,2005,39,26,13
30332,71,100,2005,20,14,6
30333,71,72,2005,0,0,0
30334,71,59,2005,6563,2881,3682
30335,71,144,2005,186,101,85
30336,71,125,2005,0,0,0
30337,71,150,2005,0,0,0
30338,71,8,2005,23,6,17
30339,71,73,2005,3027,1529,1498
30340,71,101,2005,0,0,0
30341,71,162,2005,0,0,0
30342,71,60,2005,264,114,150
30343,71,48,2005,133,59,74
30344,71,21,2005,0,0,0
30345,71,9,2005,0,0,0
30346,71,102,2005,0,0,0
30347,71,111,2005,0,0,0
30348,71,112,2005,75,44,31
30349,71,33,2005,1310,812,498
30350,71,61,2005,55878,27169,28709
30351,71,22,2005,0,0,0
30352,71,35,2005,717,479,238
30353,71,36,2005,298,209,89
30354,71,126,2005,19,10,9
30355,71,92,2005,0,0,0
30356,71,62,2005,0,0,0
30357,71,140,2005,0,0,0
30358,71,23,2005,0,0,0
30359,71,164,2005,22,9,13
30360,71,63,2005,1929,759,1170
30361,71,127,2005,0,0,0
30362,71,165,2005,0,0,0
30363,71,37,2005,262,146,116
30364,71,64,2005,181,90,91
30365,71,128,2005,0,0,0
30366,71,115,2005,35,16,19
30367,71,65,2005,2495,1294,1201
30368,71,10,2005,0,0,0
30369,71,145,2005,0,0,0
30370,71,113,2005,0,0,0
30371,71,49,2005,1152,629,523
30372,71,74,2005,406,218,188
30373,71,25,2005,0,0,0
30374,71,169,2005,0,0,0
30375,71,166,2005,0,0,0
30376,71,93,2005,0,0,0
30377,71,146,2005,102,33,69
30378,71,26,2005,153,73,80
30379,71,170,2005,0,0,0
30380,71,130,2005,0,0,0
30381,71,38,2005,133,110,23
30382,71,27,2005,0,0,0
30383,71,50,2005,4047,1854,2193
30384,71,131,2005,0,0,0
30385,71,114,2005,0,0,0
30386,71,171,2005,0,0,0
30387,71,1,2005,54,35,19
30388,71,28,2005,0,0,0
30389,71,132,2005,0,0,0
30390,71,133,2005,0,0,0
30391,174,172,2005,236962,128804,108158
30392,174,173,2005,16517,7083,9434
30393,174,61,2005,1848,720,1128
30394,122,172,2005,1609,703,906
30395,122,117,2005,8910,3868,5042
30396,122,68,2005,7269,3154,4115
30397,122,5,2005,1282,559,723
30398,123,116,2005,5410,2481,2929
30399,123,137,2005,1438,655,783
30400,123,137,2005,2368,1113,1255
30401,123,5,2005,2462,1134,1328
30402,123,125,2005,55817,26714,29103
30403,123,126,2005,4714,2227,2487
30404,123,128,2005,147,64,83
30405,123,115,2005,8421,4654,3767
30406,123,50,2005,1504,726,778
30407,123,131,2005,9794,5443,4351
30408,123,132,2005,43640,25837,17803
30409,123,133,2005,37861,21328,16533
30410,7,66,2005,17,7,10
30411,7,3,2005,20163,7716,12447
30412,7,10,2005,6929,2933,3996
30413,7,68,2005,81,34,47
30414,7,69,2005,176,73,103
30415,7,5,2005,13773,5649,8124
30416,7,57,2005,294,127,167
30417,7,177,2005,86,34,52
30418,7,20,2005,8,3,5
30419,7,9,2005,104,43,61
30420,7,49,2005,26,11,15
30421,7,74,2005,84,35,49
30422,7,142,2005,27,11,16
30423,7,50,2005,101,41,60
30424,160,2,2005,0,0,0
30425,160,51,2005,0,0,0
30426,160,141,2005,2270,1227,1043
30427,160,52,2005,0,0,0
30428,160,134,2005,273,120,153
30429,160,135,2005,2323,1030,1293
30430,160,136,2005,0,0,0
30431,160,106,2005,0,0,0
30432,160,172,2005,309,123,186
30433,160,137,2005,15801,7755,8046
30434,160,137,2005,0,0,0
30435,160,54,2005,0,0,0
30436,160,151,2005,2127,911,1216
30437,160,138,2005,0,0,0
30438,160,68,2005,9615,4774,4841
30439,160,139,2005,17532,8376,9156
30440,160,155,2005,2333,1097,1236
30441,160,156,2005,9786,4574,5212
30442,160,84,2005,0,0,0
30443,160,157,2005,16372,8252,8120
30444,160,17,2005,0,0,0
30445,160,177,2005,0,0,0
30446,160,167,2005,0,0,0
30447,160,176,2005,0,0,0
30448,160,159,2005,2302,1169,1133
30449,160,143,2005,0,0,0
30450,160,161,2005,6283,3057,3226
30451,160,144,2005,0,0,0
30452,160,162,2005,6242,2926,3316
30453,160,158,2005,0,0,0
30454,160,36,2005,376,199,177
30455,160,126,2005,0,0,0
30456,160,23,2005,0,0,0
30457,160,164,2005,8569,4171,4398
30458,160,165,2005,4821,2406,2415
30459,160,115,2005,0,0,0
30460,160,145,2005,0,0,0
30461,160,166,2005,3508,1477,2031
30462,160,27,2005,0,0,0
30463,160,94,2005,0,0,0
30464,160,142,2005,0,0,0
30465,160,131,2005,0,0,0
30466,160,152,2005,22283,11015,11268
30467,160,114,2005,0,0,0
30468,160,132,2005,0,0,0
30469,58,51,2005,76,48,28
30470,58,141,2005,38,12,26
30471,58,103,2005,14,5,9
30472,58,11,2005,20,10,10
30473,58,66,2005,89,52,37
30474,58,3,2005,13,7,6
30475,58,29,2005,19,17,2
30476,58,67,2005,93,47,46
30477,58,53,2005,122,44,78
30478,58,105,2005,48,29,19
30479,58,30,2005,361,187,174
30480,58,172,2005,259,142,117
30481,58,54,2005,87,40,47
30482,58,14,2005,38,19,19
30483,58,31,2005,48,24,24
30484,58,39,2005,60,29,31
30485,58,142,2005,446,163,283
30486,58,119,2005,19,5,14
30487,58,120,2005,45,21,24
30488,58,42,2005,41,36,5
30489,58,68,2005,203,130,73
30490,58,15,2005,23,11,12
30491,58,69,2005,756,422,334
30492,58,156,2005,13,3,10
30493,58,56,2005,52,21,31
30494,58,32,2005,27,20,7
30495,58,5,2005,228,60,168
30496,58,6,2005,17,6,11
30497,58,16,2005,57,20,37
30498,58,44,2005,223,139,84
30499,58,17,2005,15,6,9
30500,58,57,2005,1118,376,742
30501,58,177,2005,28,23,5
30502,58,18,2005,23,4,19
30503,58,121,2005,34,18,16
30504,58,19,2005,16,2,14
30505,58,46,2005,22,10,12
30506,58,20,2005,54,25,29
30507,58,143,2005,755,250,505
30508,58,47,2005,18,10,8
30509,58,144,2005,147,109,38
30510,58,73,2005,335,155,180
30511,58,162,2005,90,21,69
30512,58,60,2005,70,42,28
30513,58,48,2005,31,13,18
30514,58,9,2005,97,62,35
30515,58,112,2005,15,9,6
30516,58,33,2005,97,61,36
30517,58,61,2005,19,14,5
30518,58,35,2005,351,204,147
30519,58,36,2005,598,428,170
30520,58,23,2005,20,11,9
30521,58,63,2005,472,181,291
30522,58,37,2005,64,38,26
30523,58,64,2005,32,14,18
30524,58,128,2005,14,5,9
30525,58,115,2005,80,43,37
30526,58,65,2005,56,32,24
30527,58,10,2005,17,8,9
30528,58,145,2005,16,4,12
30529,58,49,2005,131,63,68
30530,58,74,2005,80,35,45
30531,58,25,2005,179,35,144
30532,58,93,2005,17,14,3
30533,58,146,2005,281,119,162
30534,58,26,2005,139,45,94
30535,58,38,2005,145,109,36
30536,58,27,2005,13,6,7
30537,58,50,2005,8005,4259,3746
30538,58,171,2005,14,10,4
30539,58,133,2005,28,12,16
30540,161,141,2005,1617,560,1057
30541,161,103,2005,67,27,40
30542,161,67,2005,61,27,34
30543,161,105,2005,159,60,99
30544,161,135,2005,389,140,249
30545,161,136,2005,52,20,32
30546,161,172,2005,158,107,51
30547,161,137,2005,65,27,38
30548,161,151,2005,546,226,320
30549,161,139,2005,85,36,49
30550,161,156,2005,206,116,90
30551,161,157,2005,3073,1659,1414
30552,161,16,2005,85,37,48
30553,161,57,2005,55,25,30
30554,161,19,2005,32,17,15
30555,161,20,2005,118,56,62
30556,161,143,2005,138,60,78
30557,161,160,2005,7559,3592,3967
30558,161,144,2005,340,142,198
30559,161,158,2005,1190,668,522
30560,161,36,2005,61,14,47
30561,161,23,2005,303,122,181
30562,161,164,2005,38114,16226,21888
30563,161,65,2005,85,33,52
30564,161,25,2005,139,66,73
30565,161,166,2005,140,76,64
30566,161,27,2005,69,33,36
30567,161,146,2005,246,112,134
30568,161,142,2005,224,99,125
30569,124,3,2005,3672,2482,1190
30570,124,67,2005,57,12,45
30571,124,10,2005,496,393,103
30572,124,172,2005,5151,4377,774
30573,124,68,2005,1119,515,604
30574,124,69,2005,118,61,57
30575,124,173,2005,21,7,14
30576,124,5,2005,5252,940,4312
30577,124,44,2005,24,11,13
30578,124,57,2005,113,51,62
30579,124,177,2005,11,8,3
30580,124,122,2005,1236,545,691
30581,124,9,2005,82,50,32
30582,124,36,2005,39,25,14
30583,124,127,2005,80,55,25
30584,124,115,2005,412,246,166
30585,124,65,2005,13,4,9
30586,124,74,2005,51,14,37
30587,124,50,2005,415,233,182
30588,100,141,2005,109,36,73
30589,100,134,2005,48,25,23
30590,100,103,2005,9831,4743,5088
30591,100,66,2005,585,288,297
30592,100,3,2005,31,8,23
30593,100,11,2005,81,40,41
30594,100,67,2005,913,454,459
30595,100,105,2005,3745,2129,1616
30596,100,95,2005,1848,1081,767
30597,100,30,2005,269,149,120
30598,100,135,2005,22,6,16
30599,100,106,2005,5177,2652,2525
30600,100,172,2005,4698,2173,2525
30601,100,107,2005,9406,5303,4103
30602,100,137,2005,44,14,30
30603,100,96,2005,2670,1536,1134
30604,100,54,2005,64,33,31
30605,100,81,2005,9024,4539,4485
30606,100,31,2005,312,195,117
30607,100,39,2005,287,128,159
30608,100,83,2005,1325,680,645
30609,100,108,2005,1881,968,913
30610,100,97,2005,6925,3656,3269
30611,100,42,2005,129,80,49
30612,100,68,2005,6739,3422,3317
30613,100,69,2005,5987,2612,3375
30614,100,56,2005,259,80,179
30615,100,98,2005,29329,14027,15302
30616,100,85,2005,603,219,384
30617,100,99,2005,6704,3735,2969
30618,100,32,2005,341,209,132
30619,100,5,2005,684,284,400
30620,100,6,2005,247,72,175
30621,100,16,2005,51,14,37
30622,100,44,2005,244,97,147
30623,100,17,2005,1249,523,726
30624,100,57,2005,4974,1772,3202
30625,100,86,2005,117,58,59
30626,100,177,2005,3479,1760,1719
30627,100,18,2005,50,14,36
30628,100,121,2005,44,21,23
30629,100,176,2005,1033,502,531
30630,100,20,2005,1263,554,709
30631,100,46,2005,28,18,10
30632,100,47,2005,76,52,24
30633,100,144,2005,220,92,128
30634,100,73,2005,1045,435,610
30635,100,101,2005,3435,1889,1546
30636,100,162,2005,87,19,68
30637,100,48,2005,177,72,105
30638,100,9,2005,110,24,86
30639,100,102,2005,1967,1024,943
30640,100,111,2005,395,222,173
30641,100,112,2005,5373,2660,2713
30642,100,33,2005,1064,664,400
30643,100,61,2005,398,162,236
30644,100,88,2005,1847,964,883
30645,100,35,2005,357,221,136
30646,100,36,2005,1642,1061,581
30647,100,23,2005,132,44,88
30648,100,164,2005,25,10,15
30649,100,63,2005,39,23,16
30650,100,37,2005,65,41,24
30651,100,1,2005,62,28,34
30652,100,64,2005,48,24,24
30653,100,115,2005,144,70,74
30654,100,65,2005,19883,9304,10579
30655,100,49,2005,494,251,243
30656,100,74,2005,1726,779,947
30657,100,25,2005,314,128,186
30658,100,93,2005,33,14,19
30659,100,26,2005,298,138,160
30660,100,38,2005,308,189,119
30661,100,142,2005,168,47,121
30662,100,50,2005,3476,1647,1829
30663,100,114,2005,2050,985,1065
30664,72,68,2005,6719,3900,2819
30665,72,57,2005,4430,1920,2510
30666,59,51,2005,0,0,0
30667,59,66,2005,0,0,0
30668,59,53,2005,0,0,0
30669,59,30,2005,0,0,0
30670,59,54,2005,0,0,0
30671,59,31,2005,0,0,0
30672,59,39,2005,0,0,0
30673,59,68,2005,0,0,0
30674,59,69,2005,0,0,0
30675,59,56,2005,0,0,0
30676,59,32,2005,0,0,0
30677,59,57,2005,0,0,0
30678,59,71,2005,0,0,0
30679,59,73,2005,0,0,0
30680,59,33,2005,0,0,0
30681,59,35,2005,0,0,0
30682,59,36,2005,0,0,0
30683,59,63,2005,0,0,0
30684,59,37,2005,0,0,0
30685,59,64,2005,0,0,0
30686,59,49,2005,0,0,0
30687,59,74,2005,0,0,0
30688,59,26,2005,0,0,0
30689,59,38,2005,0,0,0
30690,59,60,2005,0,0,0
30691,59,50,2005,0,0,0
30692,87,76,2005,107,56,51
30693,87,82,2005,257,139,118
30694,87,83,2005,22,6,16
30695,87,110,2005,224,94,130
30696,87,90,2005,110,63,47
30697,87,92,2005,28,9,19
30698,87,93,2005,40,16,24
30699,87,50,2005,97,47,50
30700,144,141,2005,9412,4643,4769
30701,144,67,2005,984,485,499
30702,144,137,2005,1319,651,668
30703,144,68,2005,15422,7618,7804
30704,144,69,2005,1011,499,512
30705,144,157,2005,691,341,350
30706,144,16,2005,1202,593,609
30707,144,57,2005,1329,656,673
30708,144,20,2005,947,467,480
30709,144,143,2005,825,407,418
30710,144,161,2005,1117,550,567
30711,144,164,2005,1266,625,641
30712,144,65,2005,2872,1416,1456
30713,144,25,2005,1436,707,729
30714,144,146,2005,1808,891,917
30715,144,142,2005,1303,642,661
30716,144,50,2005,850,419,431
30717,125,134,2005,31493,16227,15266
30718,125,116,2005,1354,694,660
30719,125,153,2005,5495,2684,2811
30720,125,137,2005,5089,2611,2478
30721,125,5,2005,1980,751,1229
30722,125,121,2005,19963,10472,9491
30723,125,149,2005,6319,3583,2736
30724,125,123,2005,50465,25461,25004
30725,125,162,2005,4316,2285,2031
30726,125,9,2005,1139,434,705
30727,125,61,2005,3665,1311,2354
30728,125,127,2005,13647,7485,6162
30729,125,115,2005,16250,8196,8054
30730,125,133,2005,78441,41362,37079
30731,125,131,2005,5981,2904,3077
30732,125,132,2005,4281,2251,2030
30733,150,2,2005,45,27,18
30734,150,141,2005,503,266,237
30735,150,134,2005,39319,16138,23181
30736,150,76,2005,487,292,195
30737,150,103,2005,52,33,19
30738,150,66,2005,633,292,341
30739,150,78,2005,52,39,13
30740,150,13,2005,51,37,14
30741,150,3,2005,34,13,21
30742,150,11,2005,66,1,65
30743,150,67,2005,191,95,96
30744,150,147,2005,683,350,333
30745,150,105,2005,555,324,231
30746,150,30,2005,32,25,7
30747,150,116,2005,404,159,245
30748,150,135,2005,123,22,101
30749,150,106,2005,34,10,24
30750,150,172,2005,3224,912,2312
30751,150,137,2005,1160,487,673
30752,150,137,2005,3522,1811,1711
30753,150,81,2005,706,420,286
30754,150,31,2005,79,54,25
30755,150,151,2005,162,92,70
30756,150,39,2005,118,39,79
30757,150,120,2005,219,150,69
30758,150,42,2005,82,59,23
30759,150,68,2005,557,307,250
30760,150,155,2005,90,50,40
30761,150,69,2005,9406,5433,3973
30762,150,156,2005,149,62,87
30763,150,157,2005,56,22,34
30764,150,5,2005,700,243,457
30765,150,6,2005,32,13,19
30766,150,44,2005,63,33,30
30767,150,17,2005,113,50,63
30768,150,57,2005,856,473,383
30769,150,177,2005,118,74,44
30770,150,121,2005,1152,572,580
30771,150,176,2005,105,0,105
30772,150,20,2005,48,19,29
30773,150,149,2005,131,68,63
30774,150,143,2005,37,19,18
30775,150,71,2005,45,25,20
30776,150,123,2005,383,179,204
30777,150,124,2005,111,66,45
30778,150,125,2005,143,62,81
30779,150,73,2005,536,275,261
30780,150,162,2005,1020,397,623
30781,150,48,2005,56,37,19
30782,150,9,2005,173,19,154
30783,150,33,2005,175,115,60
30784,150,61,2005,450,185,265
30785,150,35,2005,32,15,17
30786,150,36,2005,472,196,276
30787,150,126,2005,372,165,207
30788,150,164,2005,32,13,19
30789,150,127,2005,59,37,22
30790,150,165,2005,170,92,78
30791,150,128,2005,97,30,67
30792,150,115,2005,8802,4420,4382
30793,150,133,2005,14995,7410,7585
30794,150,65,2005,357,147,210
30795,150,145,2005,207,115,92
30796,150,148,2005,204,112,92
30797,150,49,2005,105,57,48
30798,150,74,2005,445,257,188
30799,150,26,2005,37,15,22
30800,150,130,2005,500,246,254
30801,150,38,2005,267,37,230
30802,150,142,2005,181,71,110
30803,150,50,2005,1783,1032,751
30804,150,131,2005,1140,580,560
30805,150,152,2005,74,39,35
30806,150,132,2005,3139,1106,2033
30807,8,3,2005,453,331,122
30808,8,4,2005,108387,53264,55123
30809,8,10,2005,77,63,14
30810,8,172,2005,20155,9157,10998
30811,8,5,2005,514650,362498,152152
30812,8,9,2005,2156,1078,1078
30813,73,2,2005,32187,14145,18042
30814,73,51,2005,662,319,343
30815,73,141,2005,4026,1364,2662
30816,73,52,2005,0,0,0
30817,73,134,2005,9245,3573,5672
30818,73,75,2005,27,16,11
30819,73,76,2005,28,19,9
30820,73,103,2005,2700,1533,1167
30821,73,11,2005,1890,947,943
30822,73,77,2005,1416,682,734
30823,73,66,2005,6475,3705,2770
30824,73,12,2005,2934,1464,1470
30825,73,78,2005,54,24,30
30826,73,13,2005,112,62,50
30827,73,3,2005,988,649,339
30828,73,79,2005,75,33,42
30829,73,29,2005,135,70,65
30830,73,67,2005,46750,26497,20253
30831,73,95,2005,0,0,0
30832,73,151,2005,273,80,193
30833,73,4,2005,48,14,34
30834,73,53,2005,6625,3292,3333
30835,73,147,2005,201,102,99
30836,73,105,2005,10126,6368,3758
30837,73,30,2005,3093,2058,1035
30838,73,152,2005,283,103,180
30839,73,116,2005,2322,1004,1318
30840,73,153,2005,11463,5927,5536
30841,73,135,2005,1766,812,954
30842,73,80,2005,0,0,0
30843,73,136,2005,103,33,70
30844,73,106,2005,3013,1572,1441
30845,73,172,2005,43672,24344,19328
30846,73,107,2005,11618,6714,4904
30847,73,117,2005,0,0,0
30848,73,137,2005,1065,445,620
30849,73,96,2005,557,310,247
30850,73,54,2005,179,92,87
30851,73,81,2005,996,611,385
30852,73,14,2005,296,122,174
30853,73,31,2005,6133,4197,1936
30854,73,176,2005,27,6,21
30855,73,137,2005,5647,2615,3032
30856,73,39,2005,3265,1963,1302
30857,73,118,2005,107,68,39
30858,73,82,2005,82,47,35
30859,73,83,2005,6995,4968,2027
30860,73,108,2005,1425,882,543
30861,73,142,2005,11014,3134,7880
30862,73,97,2005,316,175,141
30863,73,138,2005,31,16,15
30864,73,119,2005,641,309,332
30865,73,40,2005,298,220,78
30866,73,148,2005,88,50,38
30867,73,120,2005,7956,3579,4377
30868,73,41,2005,0,0,0
30869,73,42,2005,2433,1742,691
30870,73,68,2005,19352,10692,8660
30871,73,139,2005,100,50,50
30872,73,155,2005,399,123,276
30873,73,15,2005,150,75,75
30874,73,69,2005,116888,69261,47627
30875,73,156,2005,12095,5842,6253
30876,73,55,2005,34,15,19
30877,73,56,2005,7941,2845,5096
30878,73,84,2005,40,24,16
30879,73,98,2005,544,265,279
30880,73,157,2005,2786,641,2145
30881,73,158,2005,216,79,137
30882,73,110,2005,2386,1550,836
30883,73,85,2005,967,478,489
30884,73,99,2005,325,206,119
30885,73,32,2005,5622,3363,2259
30886,73,43,2005,436,245,191
30887,73,5,2005,11962,5794,6168
30888,73,6,2005,23906,10438,13468
30889,73,16,2005,35666,14385,21281
30890,73,44,2005,4463,2358,2105
30891,73,45,2005,0,0,0
30892,73,17,2005,5306,2300,3006
30893,73,57,2005,17468,5860,11608
30894,73,86,2005,857,533,324
30895,73,177,2005,6101,3315,2786
30896,73,18,2005,894,356,538
30897,73,167,2005,90,47,43
30898,73,121,2005,2110,1171,939
30899,73,19,2005,1320,542,778
30900,73,168,2005,37,16,21
30901,73,46,2005,494,347,147
30902,73,20,2005,3252,1385,1867
30903,73,149,2005,89,46,43
30904,73,159,2005,2354,789,1565
30905,73,143,2005,585,189,396
30906,73,70,2005,0,0,0
30907,73,47,2005,923,690,233
30908,73,71,2005,866,472,394
30909,73,122,2005,158,100,58
30910,73,123,2005,252,129,123
30911,73,7,2005,0,0,0
30912,73,160,2005,148,73,75
30913,73,58,2005,259,163,96
30914,73,161,2005,399,36,363
30915,73,124,2005,319,198,121
30916,73,100,2005,2074,1280,794
30917,73,72,2005,54,33,21
30918,73,59,2005,0,0,0
30919,73,87,2005,0,0,0
30920,73,144,2005,167369,77582,89787
30921,73,125,2005,538,269,269
30922,73,150,2005,208,130,78
30923,73,8,2005,658,286,372
30924,73,101,2005,335,196,139
30925,73,162,2005,4937,1985,2952
30926,73,60,2005,58,24,34
30927,73,48,2005,2584,1519,1065
30928,73,21,2005,412,208,204
30929,73,9,2005,10752,4233,6519
30930,73,102,2005,242,122,120
30931,73,111,2005,168,108,60
30932,73,112,2005,2716,1789,927
30933,73,33,2005,24820,17154,7666
30934,73,61,2005,11980,5820,6160
30935,73,22,2005,35,20,15
30936,73,35,2005,6276,4006,2270
30937,73,36,2005,30602,19095,11507
30938,73,126,2005,1478,718,760
30939,73,90,2005,71,42,29
30940,73,91,2005,51,24,27
30941,73,92,2005,55,35,20
30942,73,62,2005,0,0,0
30943,73,140,2005,134,67,67
30944,73,23,2005,1074,516,558
30945,73,164,2005,852,285,567
30946,73,63,2005,50203,25274,24929
30947,73,127,2005,78,49,29
30948,73,165,2005,5578,1276,4302
30949,73,37,2005,106,46,60
30950,73,64,2005,36,15,21
30951,73,128,2005,14989,6793,8196
30952,73,115,2005,12189,6534,5655
30953,73,129,2005,0,0,0
30954,73,65,2005,18268,9267,9001
30955,73,10,2005,10188,4914,5274
30956,73,145,2005,5776,1733,4043
30957,73,113,2005,188714,102511,86203
30958,73,49,2005,3661,2188,1473
30959,73,74,2005,5919,3442,2477
30960,73,25,2005,6644,2919,3725
30961,73,169,2005,28,11,17
30962,73,166,2005,1276,378,898
30963,73,93,2005,514,326,188
30964,73,146,2005,4216,1426,2790
30965,73,26,2005,194591,93257,101334
30966,73,170,2005,0,0,0
30967,73,94,2005,0,0,0
30968,73,130,2005,867,413,454
30969,73,38,2005,425,209,216
30970,73,27,2005,424,194,230
30971,73,50,2005,47173,21182,25991
30972,73,131,2005,1311,666,645
30973,73,114,2005,605,292,313
30974,73,171,2005,3519,1712,1807
30975,73,1,2005,12081,6221,5860
30976,73,28,2005,401,146,255
30977,73,132,2005,953,501,452
30978,73,133,2005,1134,568,566
30979,101,2,2005,54,25,29
30980,101,141,2005,99,54,45
30981,101,76,2005,104,54,50
30982,101,103,2005,235,114,121
30983,101,66,2005,34,14,20
30984,101,78,2005,73,37,36
30985,101,67,2005,39,10,29
30986,101,105,2005,107,59,48
30987,101,95,2005,22,11,11
30988,101,30,2005,54,35,19
30989,101,106,2005,110,46,64
30990,101,172,2005,121,43,78
30991,101,107,2005,389,178,211
30992,101,137,2005,42,14,28
30993,101,96,2005,9343,4651,4692
30994,101,81,2005,817,315,502
30995,101,39,2005,46,16,30
30996,101,83,2005,60,29,31
30997,101,108,2005,97,39,58
30998,101,97,2005,2121,977,1144
30999,101,120,2005,72,28,44
31000,101,68,2005,130,52,78
31001,101,69,2005,261,96,165
31002,101,98,2005,1529,727,802
31003,101,85,2005,21,11,10
31004,101,99,2005,10745,5556,5189
31005,101,5,2005,22,11,11
31006,101,44,2005,22,6,16
31007,101,57,2005,166,39,127
31008,101,86,2005,18,6,12
31009,101,177,2005,36,13,23
31010,101,18,2005,24,10,14
31011,101,100,2005,735,409,326
31012,101,73,2005,232,128,104
31013,101,162,2005,22,14,8
31014,101,102,2005,352,156,196
31015,101,112,2005,199,84,115
31016,101,88,2005,51,24,27
31017,101,36,2005,169,103,66
31018,101,164,2005,164,94,70
31019,101,128,2005,34,28,6
31020,101,65,2005,400,176,224
31021,101,49,2005,29,12,17
31022,101,74,2005,73,20,53
31023,101,38,2005,69,40,29
31024,101,50,2005,62,22,40
31025,101,114,2005,34,21,13
31026,101,28,2005,27,19,8
31027,162,135,2005,21748,9085,12663
31028,162,136,2005,23593,9855,13738
31029,162,151,2005,284647,118911,165736
31030,162,156,2005,179834,75126,104708
31031,162,159,2005,16611,6939,9672
31032,162,160,2005,130172,54379,75793
31033,162,165,2005,3294,1375,1919
31034,162,166,2005,119442,49896,69546
31035,176,3,2005,118,74,44
31036,176,105,2005,2163,1095,1068
31037,176,10,2005,136,97,39
31038,176,172,2005,22740,10932,11808
31039,176,173,2005,128,45,83
31040,176,5,2005,274,132,142
31041,176,177,2005,179,81,98
31042,176,9,2005,131,64,67
31043,176,112,2005,401,203,198
31044,176,36,2005,102,49,53
31045,176,1,2005,682,300,382
31046,176,50,2005,249,107,142
31047,60,51,2005,69782,40705,29077
31048,60,53,2005,7828,4562,3266
31049,60,30,2005,964,562,402
31050,60,54,2005,1288,751,537
31051,60,31,2005,48,27,21
31052,60,69,2005,38,22,16
31053,60,56,2005,210,122,88
31054,60,32,2005,73,42,31
31055,60,57,2005,34,20,14
31056,60,59,2005,8292,4833,3459
31057,60,33,2005,90,52,38
31058,60,35,2005,21,12,9
31059,60,36,2005,194,114,80
31060,60,63,2005,16097,9383,6714
31061,60,37,2005,33,19,14
31062,60,64,2005,231,134,97
31063,60,26,2005,19250,11224,8026
31064,60,38,2005,58,33,25
31065,60,142,2005,1765,1028,737
31066,48,2,2005,5023,1970,3053
31067,48,51,2005,274,118,156
31068,48,141,2005,912,292,620
31069,48,52,2005,0,0,0
31070,48,134,2005,239,129,110
31071,48,76,2005,0,0,0
31072,48,103,2005,622,343,279
31073,48,11,2005,156,82,74
31074,48,77,2005,0,0,0
31075,48,66,2005,1063,518,545
31076,48,12,2005,187,107,80
31077,48,78,2005,8,4,4
31078,48,13,2005,21,10,11
31079,48,3,2005,553,308,245
31080,48,79,2005,21,10,11
31081,48,29,2005,396,288,108
31082,48,67,2005,986,502,484
31083,48,95,2005,0,0,0
31084,48,151,2005,8,4,4
31085,48,4,2005,22,3,19
31086,48,53,2005,12486,6296,6190
31087,48,147,2005,96,44,52
31088,48,105,2005,1967,1253,714
31089,48,30,2005,1082,617,465
31090,48,152,2005,15,3,12
31091,48,116,2005,440,219,221
31092,48,153,2005,251,109,142
31093,48,135,2005,365,151,214
31094,48,80,2005,0,0,0
31095,48,136,2005,16,3,13
31096,48,106,2005,5837,2749,3088
31097,48,172,2005,5938,4081,1857
31098,48,173,2005,910,419,491
31099,48,174,2005,61,21,40
31100,48,107,2005,4084,1854,2230
31101,48,117,2005,0,0,0
31102,48,137,2005,681,332,349
31103,48,96,2005,217,107,110
31104,48,54,2005,2540,1169,1371
31105,48,81,2005,488,331,157
31106,48,14,2005,113,32,81
31107,48,31,2005,881,505,376
31108,48,176,2005,27,13,14
31109,48,137,2005,144,62,82
31110,48,39,2005,21971,11039,10932
31111,48,118,2005,12,9,3
31112,48,82,2005,0,0,0
31113,48,83,2005,379,251,128
31114,48,108,2005,474,235,239
31115,48,142,2005,500,152,348
31116,48,97,2005,128,64,64
31117,48,138,2005,0,0,0
31118,48,119,2005,1780,829,951
31119,48,40,2005,626,464,162
31120,48,148,2005,0,0,0
31121,48,120,2005,3028,1362,1666
31122,48,41,2005,771,419,352
31123,48,42,2005,6476,3844,2632
31124,48,68,2005,3159,1449,1710
31125,48,139,2005,0,0,0
31126,48,155,2005,879,325,554
31127,48,15,2005,124,66,58
31128,48,69,2005,14000,7145,6855
31129,48,156,2005,1198,584,614
31130,48,55,2005,0,0,0
31131,48,56,2005,649,185,464
31132,48,84,2005,0,0,0
31133,48,98,2005,352,171,181
31134,48,157,2005,77,33,44
31135,48,158,2005,13,5,8
31136,48,110,2005,82,52,30
31137,48,85,2005,22,7,15
31138,48,99,2005,69,35,34
31139,48,32,2005,1500,691,809
31140,48,43,2005,3622,1854,1768
31141,48,5,2005,5806,3084,2722
31142,48,6,2005,11527,5043,6484
31143,48,16,2005,15274,6273,9001
31144,48,44,2005,500,244,256
31145,48,45,2005,0,0,0
31146,48,17,2005,608,240,368
31147,48,57,2005,1547,543,1004
31148,48,86,2005,115,65,50
31149,48,177,2005,953,612,341
31150,48,18,2005,147,64,83
31151,48,167,2005,290,195,95
31152,48,121,2005,1077,589,488
31153,48,19,2005,199,82,117
31154,48,168,2005,53,42,11
31155,48,46,2005,691,507,184
31156,48,20,2005,1400,610,790
31157,48,149,2005,0,0,0
31158,48,159,2005,846,445,401
31159,48,143,2005,196,52,144
31160,48,70,2005,4,0,4
31161,48,47,2005,1313,904,409
31162,48,71,2005,105,41,64
31163,48,122,2005,419,219,200
31164,48,123,2005,55,28,27
31165,48,7,2005,0,0,0
31166,48,160,2005,34,12,22
31167,48,58,2005,51,23,28
31168,48,161,2005,10,0,10
31169,48,124,2005,147,79,68
31170,48,100,2005,516,324,192
31171,48,72,2005,0,0,0
31172,48,59,2005,0,0,0
31173,48,87,2005,0,0,0
31174,48,144,2005,4309,1757,2552
31175,48,125,2005,102,63,39
31176,48,150,2005,72,42,30
31177,48,8,2005,325,142,183
31178,48,73,2005,4697,2217,2480
31179,48,101,2005,123,67,56
31180,48,162,2005,579,213,366
31181,48,60,2005,1831,832,999
31182,48,21,2005,26,9,17
31183,48,9,2005,15081,7199,7882
31184,48,102,2005,36,23,13
31185,48,111,2005,99,59,40
31186,48,112,2005,785,455,330
31187,48,33,2005,8224,4867,3357
31188,48,61,2005,741,333,408
31189,48,88,2005,16,9,7
31190,48,22,2005,21,11,10
31191,48,35,2005,1641,1079,562
31192,48,36,2005,8829,5886,2943
31193,48,126,2005,316,166,150
31194,48,90,2005,0,0,0
31195,48,91,2005,0,0,0
31196,48,92,2005,0,0,0
31197,48,62,2005,0,0,0
31198,48,140,2005,0,0,0
31199,48,23,2005,237,116,121
31200,48,164,2005,98,40,58
31201,48,63,2005,3438,1686,1752
31202,48,127,2005,0,0,0
31203,48,165,2005,372,166,206
31204,48,37,2005,486,239,247
31205,48,64,2005,109,57,52
31206,48,128,2005,12645,5694,6951
31207,48,115,2005,833,423,410
31208,48,129,2005,0,0,0
31209,48,65,2005,1824,812,1012
31210,48,10,2005,8157,3914,4243
31211,48,145,2005,659,269,390
31212,48,113,2005,21,12,9
31213,48,49,2005,32760,17033,15727
31214,48,74,2005,1541,800,741
31215,48,25,2005,969,432,537
31216,48,169,2005,52,29,23
31217,48,166,2005,67,29,38
31218,48,93,2005,297,163,134
31219,48,146,2005,644,163,481
31220,48,26,2005,9038,3910,5128
31221,48,170,2005,42,19,23
31222,48,94,2005,0,0,0
31223,48,130,2005,629,325,304
31224,48,38,2005,1110,846,264
31225,48,27,2005,131,64,67
31226,48,50,2005,14463,6211,8252
31227,48,131,2005,647,341,306
31228,48,114,2005,154,81,73
31229,48,171,2005,110,67,43
31230,48,1,2005,11993,6142,5851
31231,48,28,2005,68,33,35
31232,48,132,2005,252,136,116
31233,48,133,2005,180,89,91
31234,21,13,2005,366,173,193
31235,21,3,2005,92947,6939,86008
31236,21,10,2005,9913,5431,4482
31237,21,68,2005,972,302,670
31238,21,5,2005,373411,61420,311991
31239,21,16,2005,2983,1222,1761
31240,21,18,2005,8331,2935,5396
31241,21,19,2005,247,64,183
31242,21,73,2005,594,181,413
31243,21,9,2005,70569,8962,61607
31244,21,22,2005,127,42,85
31245,21,23,2005,714,198,516
31246,21,129,2005,0,0,0
31247,21,145,2005,7816,2960,4856
31248,21,27,2005,7711,3197,4514
31249,21,142,2005,27249,9681,17568
31250,21,50,2005,4061,1301,2760
31251,9,2,2005,1166210,542604,623606
31252,9,10,2005,384,174,210
31253,9,172,2005,347,146,201
31254,9,5,2005,1998814,917324,1081490
31255,9,6,2005,2381,1062,1319
31256,9,16,2005,289,138,151
31257,102,103,2005,1350,622,728
31258,102,66,2005,66,28,38
31259,102,3,2005,22,3,19
31260,102,79,2005,34,20,14
31261,102,67,2005,115,36,79
31262,102,105,2005,1139,638,501
31263,102,95,2005,72,30,42
31264,102,30,2005,58,21,37
31265,102,106,2005,1184,570,614
31266,102,172,2005,12365,5810,6555
31267,102,107,2005,31157,16618,14539
31268,102,96,2005,5121,2755,2366
31269,102,54,2005,60,11,49
31270,102,81,2005,1856,797,1059
31271,102,31,2005,27,15,12
31272,102,39,2005,76,18,58
31273,102,82,2005,33,21,12
31274,102,83,2005,5798,4049,1749
31275,102,108,2005,1897,851,1046
31276,102,97,2005,2173,1089,1084
31277,102,42,2005,23,11,12
31278,102,68,2005,522,218,304
31279,102,15,2005,22,2,20
31280,102,69,2005,606,247,359
31281,102,56,2005,230,53,177
31282,102,84,2005,11,5,6
31283,102,98,2005,894,408,486
31284,102,110,2005,34,14,20
31285,102,85,2005,346,184,162
31286,102,99,2005,963,514,449
31287,102,173,2005,277,134,143
31288,102,32,2005,32,14,18
31289,102,5,2005,2696,1053,1643
31290,102,6,2005,61,14,47
31291,102,44,2005,47,14,33
31292,102,17,2005,686,226,460
31293,102,57,2005,772,257,515
31294,102,86,2005,521,287,234
31295,102,177,2005,296,124,172
31296,102,18,2005,84,26,58
31297,102,20,2005,360,144,216
31298,102,143,2005,25,7,18
31299,102,47,2005,30,8,22
31300,102,100,2005,2935,1435,1500
31301,102,144,2005,52,18,34
31302,102,73,2005,236,79,157
31303,102,101,2005,7240,4233,3007
31304,102,162,2005,20,4,16
31305,102,48,2005,32,12,20
31306,102,9,2005,55,23,32
31307,102,111,2005,63,39,24
31308,102,112,2005,2888,1258,1630
31309,102,33,2005,112,40,72
31310,102,61,2005,161,52,109
31311,102,88,2005,432,158,274
31312,102,35,2005,102,32,70
31313,102,36,2005,571,248,323
31314,102,23,2005,36,10,26
31315,102,63,2005,25,5,20
31316,102,37,2005,16,9,7
31317,102,1,2005,27,11,16
31318,102,115,2005,28,14,14
31319,102,65,2005,2576,980,1596
31320,102,49,2005,106,29,77
31321,102,74,2005,217,74,143
31322,102,25,2005,177,69,108
31323,102,93,2005,67,30,37
31324,102,26,2005,62,16,46
31325,102,38,2005,253,56,197
31326,102,142,2005,47,22,25
31327,102,50,2005,931,329,602
31328,102,114,2005,415,175,240
31329,111,103,2005,61353,30406,30947
31330,111,105,2005,79266,37666,41600
31331,111,106,2005,2269,934,1335
31332,111,172,2005,840,369,471
31333,111,68,2005,662,261,401
31334,111,69,2005,1785,752,1033
31335,111,57,2005,943,362,581
31336,111,177,2005,2133,1017,1116
31337,111,100,2005,1727,857,870
31338,111,33,2005,939,440,499
31339,111,65,2005,950,400,550
31340,111,50,2005,188,85,103
31341,111,114,2005,3146,1352,1794
31342,112,141,2005,17,6,11
31343,112,134,2005,13,10,3
31344,112,103,2005,9729,4921,4808
31345,112,66,2005,169,77,92
31346,112,67,2005,527,251,276
31347,112,105,2005,4164,2317,1847
31348,112,30,2005,59,24,35
31349,112,106,2005,6155,3286,2869
31350,112,172,2005,3502,1572,1930
31351,112,107,2005,5087,2691,2396
31352,112,96,2005,289,150,139
31353,112,54,2005,79,18,61
31354,112,81,2005,776,314,462
31355,112,31,2005,78,36,42
31356,112,39,2005,208,94,114
31357,112,83,2005,155,80,75
31358,112,108,2005,3419,1957,1462
31359,112,97,2005,93,49,44
31360,112,40,2005,15,8,7
31361,112,42,2005,61,32,29
31362,112,68,2005,1979,912,1067
31363,112,109,2005,30,17,13
31364,112,69,2005,2507,1225,1282
31365,112,56,2005,51,15,36
31366,112,98,2005,140,72,68
31367,112,85,2005,43,26,17
31368,112,99,2005,142,88,54
31369,112,32,2005,56,29,27
31370,112,43,2005,13,3,10
31371,112,5,2005,177,69,108
31372,112,6,2005,50,16,34
31373,112,16,2005,17,4,13
31374,112,44,2005,181,90,91
31375,112,17,2005,434,170,264
31376,112,57,2005,2867,1281,1586
31377,112,177,2005,2874,1418,1456
31378,112,18,2005,35,10,25
31379,112,176,2005,75,34,41
31380,112,20,2005,60,25,35
31381,112,71,2005,13,6,7
31382,112,58,2005,19,1,18
31383,112,100,2005,1278,676,602
31384,112,144,2005,34,12,22
31385,112,73,2005,582,262,320
31386,112,101,2005,138,83,55
31387,112,48,2005,91,43,48
31388,112,9,2005,62,15,47
31389,112,102,2005,296,151,145
31390,112,111,2005,468,255,213
31391,112,33,2005,170,84,86
31392,112,61,2005,111,40,71
31393,112,88,2005,118,64,54
31394,112,35,2005,157,85,72
31395,112,36,2005,539,343,196
31396,112,92,2005,20,14,6
31397,112,23,2005,29,13,16
31398,112,64,2005,25,12,13
31399,112,115,2005,100,38,62
31400,112,65,2005,4349,2040,2309
31401,112,49,2005,242,114,128
31402,112,74,2005,668,307,361
31403,112,26,2005,46,17,29
31404,112,38,2005,206,136,70
31405,112,142,2005,18,4,14
31406,112,50,2005,1421,675,746
31407,112,114,2005,525,226,299
31408,33,2,2005,151,16,135
31409,33,51,2005,94,21,73
31410,33,141,2005,528,111,417
31411,33,134,2005,42,3,39
31412,33,103,2005,229,96,133
31413,33,11,2005,1499,590,909
31414,33,66,2005,4138,2134,2004
31415,33,12,2005,263,132,131
31416,33,3,2005,72,8,64
31417,33,29,2005,92167,56231,35936
31418,33,67,2005,4094,2042,2052
31419,33,53,2005,3440,2015,1425
31420,33,105,2005,240,122,118
31421,33,30,2005,1752,745,1007
31422,33,135,2005,23,3,20
31423,33,106,2005,41,17,24
31424,33,172,2005,932,511,421
31425,33,107,2005,92,43,49
31426,33,137,2005,78,27,51
31427,33,96,2005,28,2,26
31428,33,54,2005,812,400,412
31429,33,81,2005,209,70,139
31430,33,14,2005,128,46,82
31431,33,31,2005,5473,3124,2349
31432,33,39,2005,814,427,387
31433,33,83,2005,11,7,4
31434,33,108,2005,38,3,35
31435,33,142,2005,334,89,245
31436,33,119,2005,13,12,1
31437,33,40,2005,245,155,90
31438,33,120,2005,46,13,33
31439,33,42,2005,225,127,98
31440,33,68,2005,31040,17510,13530
31441,33,15,2005,331,182,149
31442,33,69,2005,90919,51307,39612
31443,33,156,2005,41,13,28
31444,33,56,2005,3009,1315,1694
31445,33,157,2005,34,6,28
31446,33,110,2005,19,6,13
31447,33,32,2005,1372,763,609
31448,33,43,2005,272,137,135
31449,33,5,2005,594,197,397
31450,33,6,2005,188,54,134
31451,33,16,2005,418,82,336
31452,33,44,2005,3912,1917,1995
31453,33,17,2005,371,128,243
31454,33,57,2005,7266,3386,3880
31455,33,177,2005,377,223,154
31456,33,18,2005,150,19,131
31457,33,167,2005,4071,2223,1848
31458,33,121,2005,58,26,32
31459,33,19,2005,167,53,114
31460,33,168,2005,102,42,60
31461,33,46,2005,1932,1180,752
31462,33,20,2005,363,71,292
31463,33,143,2005,278,101,177
31464,33,47,2005,66534,41046,25488
31465,33,71,2005,181,111,70
31466,33,160,2005,28,1,27
31467,33,100,2005,167,72,95
31468,33,72,2005,13,4,9
31469,33,59,2005,128,48,80
31470,33,144,2005,241,48,193
31471,33,125,2005,20,0,20
31472,33,8,2005,32,7,25
31473,33,73,2005,1815,715,1100
31474,33,162,2005,295,18,277
31475,33,60,2005,239,90,149
31476,33,48,2005,940,482,458
31477,33,9,2005,139,15,124
31478,33,102,2005,29,14,15
31479,33,112,2005,108,23,85
31480,33,61,2005,100,35,65
31481,33,22,2005,15,8,7
31482,33,35,2005,2977,1734,1243
31483,33,36,2005,47197,30641,16556
31484,33,23,2005,101,47,54
31485,33,164,2005,57,10,47
31486,33,63,2005,2236,1113,1123
31487,33,37,2005,1435,826,609
31488,33,64,2005,143,67,76
31489,33,115,2005,329,151,178
31490,33,65,2005,3029,1465,1564
31491,33,10,2005,56,26,30
31492,33,145,2005,89,16,73
31493,33,49,2005,1025,450,575
31494,33,74,2005,776,378,398
31495,33,25,2005,582,86,496
31496,33,169,2005,60,42,18
31497,33,146,2005,276,39,237
31498,33,26,2005,676,188,488
31499,33,170,2005,50,43,7
31500,33,130,2005,54,29,25
31501,33,38,2005,263473,162721,100752
31502,33,27,2005,106,52,54
31503,33,50,2005,18982,8995,9987
31504,33,131,2005,61,19,42
31505,33,114,2005,52,26,26
31506,33,171,2005,432,283,149
31507,33,1,2005,2268,898,1370
31508,33,28,2005,105,26,79
31509,33,132,2005,40,9,31
31510,33,133,2005,65,34,31
31511,61,51,2005,45,19,26
31512,61,141,2005,212,63,149
31513,61,52,2005,406,211,195
31514,61,134,2005,169591,89825,79766
31515,61,103,2005,1197,636,561
31516,61,11,2005,77,30,47
31517,61,66,2005,454,236,218
31518,61,12,2005,37,15,22
31519,61,3,2005,849,191,658
31520,61,29,2005,526,257,269
31521,61,67,2005,3205,1656,1549
31522,61,151,2005,29,2,27
31523,61,53,2005,44,28,16
31524,61,105,2005,91614,50407,41207
31525,61,30,2005,2831,1314,1517
31526,61,153,2005,53008,26943,26065
31527,61,135,2005,66,24,42
31528,61,106,2005,196,102,94
31529,61,172,2005,6280,2991,3289
31530,61,173,2005,112,67,45
31531,61,174,2005,2521,1389,1132
31532,61,107,2005,507,336,171
31533,61,137,2005,1216,719,497
31534,61,54,2005,89,40,49
31535,61,81,2005,996,719,277
31536,61,14,2005,24,12,12
31537,61,31,2005,189,121,68
31538,61,176,2005,38,22,16
31539,61,137,2005,1750,741,1009
31540,61,39,2005,390,193,197
31541,61,83,2005,51,34,17
31542,61,108,2005,335,169,166
31543,61,142,2005,256,51,205
31544,61,97,2005,53,43,10
31545,61,138,2005,135,116,19
31546,61,40,2005,182,112,70
31547,61,148,2005,368,162,206
31548,61,120,2005,21,10,11
31549,61,42,2005,329,195,134
31550,61,68,2005,95316,50763,44553
31551,61,139,2005,310,28,282
31552,61,155,2005,68,9,59
31553,61,15,2005,590,136,454
31554,61,69,2005,26104,13284,12820
31555,61,156,2005,121,30,91
31556,61,56,2005,157,74,83
31557,61,98,2005,28,17,11
31558,61,157,2005,2325,1036,1289
31559,61,158,2005,25289,10583,14706
31560,61,32,2005,309,204,105
31561,61,43,2005,31,16,15
31562,61,5,2005,7355,3245,4110
31563,61,6,2005,195,87,108
31564,61,16,2005,49,18,31
31565,61,44,2005,1039,531,508
31566,61,17,2005,215,37,178
31567,61,57,2005,2372,982,1390
31568,61,86,2005,26,12,14
31569,61,177,2005,300,168,132
31570,61,18,2005,19,5,14
31571,61,167,2005,469,211,258
31572,61,121,2005,130,71,59
31573,61,46,2005,137,86,51
31574,61,20,2005,67,27,40
31575,61,159,2005,29,2,27
31576,61,143,2005,19,3,16
31577,61,70,2005,99,0,99
31578,61,47,2005,247,128,119
31579,61,71,2005,3683,1863,1820
31580,61,122,2005,31,12,19
31581,61,123,2005,322,197,125
31582,61,160,2005,77,7,70
31583,61,58,2005,32,16,16
31584,61,161,2005,35,6,29
31585,61,100,2005,243,143,100
31586,61,59,2005,94,40,54
31587,61,144,2005,1680,587,1093
31588,61,125,2005,74985,39560,35425
31589,61,8,2005,272,77,195
31590,61,73,2005,3666,1805,1861
31591,61,162,2005,207,69,138
31592,61,60,2005,137,68,69
31593,61,48,2005,312,154,158
31594,61,9,2005,1395,359,1036
31595,61,102,2005,81,45,36
31596,61,111,2005,38,23,15
31597,61,112,2005,247,149,98
31598,61,33,2005,661,435,226
31599,61,35,2005,12468,5650,6818
31600,61,36,2005,3993,2130,1863
31601,61,140,2005,15388,8370,7018
31602,61,164,2005,1341,293,1048
31603,61,63,2005,111,22,89
31604,61,165,2005,49,6,43
31605,61,37,2005,60,43,17
31606,61,64,2005,43,26,17
31607,61,115,2005,11373,5964,5409
31608,61,65,2005,15191,8822,6369
31609,61,10,2005,19,7,12
31610,61,49,2005,787,429,358
31611,61,74,2005,14775,7287,7488
31612,61,25,2005,31,13,18
31613,61,166,2005,51,13,38
31614,61,146,2005,94,24,70
31615,61,26,2005,200,73,127
31616,61,130,2005,44,26,18
31617,61,38,2005,28315,10459,17856
31618,61,50,2005,14299,7097,7202
31619,61,131,2005,123,72,51
31620,61,114,2005,181,69,112
31621,61,171,2005,432,129,303
31622,61,1,2005,37,18,19
31623,61,133,2005,1283,460,823
31624,88,103,2005,1402,738,664
31625,88,105,2005,162,85,77
31626,88,106,2005,1007,530,477
31627,88,172,2005,1422,749,673
31628,88,107,2005,4482,2362,2120
31629,88,96,2005,601,316,285
31630,88,81,2005,17039,8962,8077
31631,88,82,2005,2030,1067,963
31632,88,83,2005,66983,35277,31706
31633,88,108,2005,949,500,449
31634,88,142,2005,60,31,29
31635,88,97,2005,970,512,458
31636,88,68,2005,243,128,115
31637,88,69,2005,860,451,409
31638,88,98,2005,563,296,267
31639,88,110,2005,86,45,41
31640,88,85,2005,299,157,142
31641,88,99,2005,338,177,161
31642,88,5,2005,84,44,40
31643,88,17,2005,76,39,37
31644,88,57,2005,325,171,154
31645,88,86,2005,73,38,35
31646,88,177,2005,142,75,67
31647,88,18,2005,153,80,73
31648,88,20,2005,30,15,15
31649,88,100,2005,3118,1642,1476
31650,88,73,2005,46,23,23
31651,88,101,2005,399,209,190
31652,88,102,2005,1104,580,524
31653,88,112,2005,925,486,439
31654,88,33,2005,31,16,15
31655,88,61,2005,59,31,28
31656,88,65,2005,3281,1725,1556
31657,88,93,2005,295,155,140
31658,88,26,2005,36,19,17
31659,88,50,2005,295,154,141
31660,88,1,2005,108,56,52
31661,22,2,2005,620,158,462
31662,22,13,2005,275,132,143
31663,22,3,2005,75689,8884,66805
31664,22,10,2005,12231,4291,7940
31665,22,136,2005,2582,1271,1311
31666,22,120,2005,982,256,726
31667,22,119,2005,1083,276,807
31668,22,68,2005,585,183,402
31669,22,5,2005,193404,35480,157924
31670,22,18,2005,14466,5610,8856
31671,22,19,2005,5450,1632,3818
31672,22,20,2005,3211,847,2364
31673,22,144,2005,976,262,714
31674,22,8,2005,23647,5826,17821
31675,22,73,2005,323,95,228
31676,22,162,2005,909,238,671
31677,22,9,2005,51773,9091,42682
31678,22,23,2005,7059,2364,4695
31679,22,128,2005,655,169,486
31680,22,129,2005,1155,321,834
31681,22,145,2005,9065,2516,6549
31682,22,25,2005,3279,814,2465
31683,22,27,2005,18041,6139,11902
31684,22,146,2005,423,108,315
31685,22,26,2005,3053,789,2264
31686,22,142,2005,48490,12679,35811
31687,22,50,2005,2433,729,1704
31688,22,28,2005,15725,4045,11680
31689,35,2,2005,0,0,0
31690,35,51,2005,690,361,329
31691,35,141,2005,8,0,8
31692,35,52,2005,0,0,0
31693,35,134,2005,0,0,0
31694,35,75,2005,0,0,0
31695,35,76,2005,0,0,0
31696,35,103,2005,6,3,3
31697,35,11,2005,1,0,1
31698,35,66,2005,626,289,337
31699,35,12,2005,0,0,0
31700,35,78,2005,0,0,0
31701,35,13,2005,0,0,0
31702,35,3,2005,8,0,8
31703,35,79,2005,0,0,0
31704,35,29,2005,32,16,16
31705,35,67,2005,583,276,307
31706,35,95,2005,0,0,0
31707,35,151,2005,0,0,0
31708,35,4,2005,0,0,0
31709,35,53,2005,89,45,44
31710,35,147,2005,0,0,0
31711,35,105,2005,4,0,4
31712,35,30,2005,18833,10606,8227
31713,35,152,2005,0,0,0
31714,35,116,2005,0,0,0
31715,35,153,2005,0,0,0
31716,35,135,2005,0,0,0
31717,35,80,2005,0,0,0
31718,35,136,2005,0,0,0
31719,35,106,2005,0,0,0
31720,35,172,2005,2101,873,1228
31721,35,107,2005,0,0,0
31722,35,117,2005,0,0,0
31723,35,137,2005,0,0,0
31724,35,96,2005,0,0,0
31725,35,54,2005,1128,551,577
31726,35,81,2005,1,0,1
31727,35,14,2005,56,31,25
31728,35,31,2005,561,338,223
31729,35,176,2005,0,0,0
31730,35,137,2005,0,0,0
31731,35,39,2005,67,31,36
31732,35,118,2005,0,0,0
31733,35,82,2005,0,0,0
31734,35,83,2005,0,0,0
31735,35,108,2005,0,0,0
31736,35,142,2005,23,7,16
31737,35,97,2005,0,0,0
31738,35,138,2005,0,0,0
31739,35,119,2005,0,0,0
31740,35,40,2005,0,0,0
31741,35,148,2005,0,0,0
31742,35,120,2005,0,0,0
31743,35,41,2005,0,0,0
31744,35,42,2005,74,47,27
31745,35,68,2005,1319,546,773
31746,35,139,2005,0,0,0
31747,35,155,2005,0,0,0
31748,35,15,2005,0,0,0
31749,35,69,2005,2580,1230,1350
31750,35,156,2005,0,0,0
31751,35,55,2005,0,0,0
31752,35,56,2005,4708,2196,2512
31753,35,84,2005,0,0,0
31754,35,98,2005,0,0,0
31755,35,157,2005,1,0,1
31756,35,158,2005,0,0,0
31757,35,110,2005,0,0,0
31758,35,85,2005,0,0,0
31759,35,99,2005,0,0,0
31760,35,32,2005,5868,3572,2296
31761,35,43,2005,0,0,0
31762,35,5,2005,0,0,0
31763,35,6,2005,937,149,788
31764,35,16,2005,1018,268,750
31765,35,44,2005,204,90,114
31766,35,45,2005,0,0,0
31767,35,17,2005,849,203,646
31768,35,57,2005,7152,2819,4333
31769,35,86,2005,0,0,0
31770,35,177,2005,28,13,15
31771,35,18,2005,858,176,682
31772,35,167,2005,0,0,0
31773,35,121,2005,0,0,0
31774,35,19,2005,0,0,0
31775,35,168,2005,0,0,0
31776,35,46,2005,0,0,0
31777,35,20,2005,1032,192,840
31778,35,159,2005,0,0,0
31779,35,143,2005,0,0,0
31780,35,70,2005,0,0,0
31781,35,47,2005,0,0,0
31782,35,71,2005,25,8,17
31783,35,122,2005,0,0,0
31784,35,123,2005,0,0,0
31785,35,7,2005,0,0,0
31786,35,160,2005,0,0,0
31787,35,58,2005,0,0,0
31788,35,161,2005,0,0,0
31789,35,124,2005,0,0,0
31790,35,100,2005,10,6,4
31791,35,72,2005,0,0,0
31792,35,59,2005,0,0,0
31793,35,144,2005,9,3,6
31794,35,125,2005,0,0,0
31795,35,150,2005,0,0,0
31796,35,8,2005,0,0,0
31797,35,73,2005,330,120,210
31798,35,101,2005,0,0,0
31799,35,162,2005,1,0,1
31800,35,60,2005,814,480,334
31801,35,48,2005,2,0,2
31802,35,21,2005,0,0,0
31803,35,9,2005,1,0,1
31804,35,102,2005,0,0,0
31805,35,111,2005,0,0,0
31806,35,112,2005,0,0,0
31807,35,33,2005,411,241,170
31808,35,61,2005,346,183,163
31809,35,22,2005,0,0,0
31810,35,36,2005,7475,4899,2576
31811,35,126,2005,0,0,0
31812,35,91,2005,0,0,0
31813,35,92,2005,0,0,0
31814,35,62,2005,0,0,0
31815,35,140,2005,0,0,0
31816,35,23,2005,4,0,4
31817,35,164,2005,0,0,0
31818,35,63,2005,1973,1005,968
31819,35,165,2005,0,0,0
31820,35,37,2005,202,115,87
31821,35,64,2005,0,0,0
31822,35,128,2005,0,0,0
31823,35,115,2005,0,0,0
31824,35,65,2005,3504,1668,1836
31825,35,10,2005,0,0,0
31826,35,145,2005,0,0,0
31827,35,113,2005,0,0,0
31828,35,49,2005,118,53,65
31829,35,74,2005,73,38,35
31830,35,25,2005,7254,2936,4318
31831,35,169,2005,0,0,0
31832,35,166,2005,0,0,0
31833,35,93,2005,0,0,0
31834,35,146,2005,4,0,4
31835,35,26,2005,2927,558,2369
31836,35,170,2005,0,0,0
31837,35,130,2005,0,0,0
31838,35,38,2005,13131,7724,5407
31839,35,27,2005,3,0,3
31840,35,50,2005,701,289,412
31841,35,131,2005,0,0,0
31842,35,114,2005,0,0,0
31843,35,171,2005,0,0,0
31844,35,1,2005,9,1,8
31845,35,28,2005,0,0,0
31846,35,132,2005,0,0,0
31847,35,133,2005,0,0,0
31848,36,2,2005,8328,1393,6935
31849,36,51,2005,578,241,337
31850,36,141,2005,907,294,613
31851,36,134,2005,457,117,340
31852,36,12,2005,805658,348414,457244
31853,36,103,2005,399,168,231
31854,36,66,2005,3430,1741,1689
31855,36,3,2005,614,76,538
31856,36,11,2005,503316,215716,287600
31857,36,67,2005,650,293,357
31858,36,53,2005,582,129,453
31859,36,147,2005,109,54,55
31860,36,105,2005,512,244,268
31861,36,30,2005,7315,2525,4790
31862,36,116,2005,141,42,99
31863,36,29,2005,849214,473157,376057
31864,36,135,2005,412,86,326
31865,36,153,2005,46,19,27
31866,36,10,2005,709,277,432
31867,36,136,2005,131,27,104
31868,36,106,2005,386,187,199
31869,36,172,2005,58247,24914,33333
31870,36,107,2005,228,68,160
31871,36,117,2005,50,23,27
31872,36,137,2005,459,115,344
31873,36,96,2005,32,14,18
31874,36,54,2005,284,73,211
31875,36,81,2005,2238,853,1385
31876,36,14,2005,575,269,306
31877,36,31,2005,12647,6252,6395
31878,36,151,2005,208,89,119
31879,36,39,2005,1405,701,704
31880,36,108,2005,260,90,170
31881,36,138,2005,70,29,41
31882,36,120,2005,282,66,216
31883,36,40,2005,63001,33059,29942
31884,36,42,2005,2103,1141,962
31885,36,68,2005,1997,900,1097
31886,36,15,2005,539318,246947,292371
31887,36,69,2005,145892,72962,72930
31888,36,156,2005,273,73,200
31889,36,56,2005,1918,840,1078
31890,36,157,2005,278,86,192
31891,36,173,2005,46,19,27
31892,36,32,2005,17727,8765,8962
31893,36,43,2005,50,25,25
31894,36,5,2005,5893,1216,4677
31895,36,6,2005,2240,775,1465
31896,36,16,2005,973,203,770
31897,36,44,2005,165,70,95
31898,36,17,2005,2993,1250,1743
31899,36,57,2005,1391,542,849
31900,36,177,2005,850,422,428
31901,36,167,2005,2568446,1364090,1204356
31902,36,18,2005,909,169,740
31903,36,121,2005,403,152,251
31904,36,176,2005,9538,2922,6616
31905,36,19,2005,128,35,93
31906,36,168,2005,526124,269148,256976
31907,36,20,2005,1098,139,959
31908,36,46,2005,95839,49971,45868
31909,36,143,2005,304,122,182
31910,36,47,2005,78560,40251,38309
31911,36,71,2005,61,26,35
31912,36,122,2005,107,40,67
31913,36,123,2005,17,6,11
31914,36,7,2005,77,33,44
31915,36,160,2005,102,18,84
31916,36,58,2005,347,183,164
31917,36,124,2005,139,44,95
31918,36,100,2005,182,88,94
31919,36,72,2005,142,84,58
31920,36,59,2005,406,161,245
31921,36,144,2005,1162,324,838
31922,36,125,2005,103,35,68
31923,36,21,2005,45,14,31
31924,36,150,2005,101,37,64
31925,36,8,2005,285,60,225
31926,36,73,2005,457,202,255
31927,36,101,2005,60,19,41
31928,36,162,2005,837,213,624
31929,36,48,2005,958,501,457
31930,36,9,2005,866,139,727
31931,36,102,2005,42,11,31
31932,36,111,2005,81,45,36
31933,36,112,2005,437,133,304
31934,36,33,2005,31362,16225,15137
31935,36,61,2005,174,76,98
31936,36,158,2005,198,62,136
31937,36,22,2005,61,24,37
31938,36,35,2005,4200,2310,1890
31939,36,126,2005,100,40,60
31940,36,75,2005,168,70,98
31941,36,62,2005,43,27,16
31942,36,23,2005,223,64,159
31943,36,164,2005,86,33,53
31944,36,37,2005,1431,686,745
31945,36,1,2005,18748,6048,12700
31946,36,64,2005,230,79,151
31947,36,128,2005,83,24,59
31948,36,115,2005,234,105,129
31949,36,133,2005,158,68,90
31950,36,65,2005,1110,517,593
31951,36,145,2005,310,40,270
31952,36,49,2005,399,186,213
31953,36,74,2005,497,245,252
31954,36,25,2005,3301,505,2796
31955,36,169,2005,423794,175453,248341
31956,36,27,2005,292,116,176
31957,36,146,2005,381,92,289
31958,36,26,2005,9602,2184,7418
31959,36,170,2005,180124,92429,87695
31960,36,130,2005,82,33,49
31961,36,38,2005,3293929,1736026,1557903
31962,36,60,2005,245,46,199
31963,36,142,2005,1245,488,757
31964,36,50,2005,1267,547,720
31965,36,131,2005,214,72,142
31966,36,152,2005,519,285,234
31967,36,114,2005,312,159,153
31968,36,171,2005,1030041,497620,532421
31969,36,28,2005,611,65,546
31970,36,132,2005,357,100,257
31971,126,116,2005,68762,32088,36674
31972,126,137,2005,197717,102386,95331
31973,126,121,2005,2617,1098,1519
31974,126,130,2005,93430,45025,48405
31975,126,131,2005,43346,21596,21750
31976,90,76,2005,363,188,175
31977,90,78,2005,19,8,11
31978,90,79,2005,87,48,39
31979,90,82,2005,180,84,96
31980,90,84,2005,52,25,27
31981,90,110,2005,697,329,368
31982,90,86,2005,128,66,62
31983,90,87,2005,386,191,195
31984,90,91,2005,93,35,58
31985,90,92,2005,152,74,78
31986,90,93,2005,239,103,136
31987,91,76,2005,95,47,48
31988,91,66,2005,11,5,6
31989,91,78,2005,11,3,8
31990,91,79,2005,540,268,272
31991,91,67,2005,10,4,6
31992,91,105,2005,9,3,6
31993,91,95,2005,1,0,1
31994,91,80,2005,7,1,6
31995,91,172,2005,48,24,24
31996,91,81,2005,54,31,23
31997,91,82,2005,234,113,121
31998,91,83,2005,40,23,17
31999,91,120,2005,3,2,1
32000,91,68,2005,59,18,41
32001,91,109,2005,199,127,72
32002,91,69,2005,57,35,22
32003,91,156,2005,19,7,12
32004,91,84,2005,156,63,93
32005,91,98,2005,4,1,3
32006,91,110,2005,1994,1121,873
32007,91,85,2005,28,13,15
32008,91,5,2005,165,66,99
32009,91,44,2005,19,8,11
32010,91,57,2005,14,7,7
32011,91,86,2005,286,176,110
32012,91,177,2005,16,13,3
32013,91,20,2005,4,2,2
32014,91,100,2005,14,12,2
32015,91,87,2005,29,15,14
32016,91,73,2005,15,4,11
32017,91,77,2005,23,15,8
32018,91,162,2005,43,31,12
32019,91,9,2005,8,4,4
32020,91,102,2005,15,6,9
32021,91,88,2005,11,2,9
32022,91,90,2005,37,21,16
32023,91,75,2005,18,9,9
32024,91,92,2005,345,197,148
32025,91,115,2005,7,2,5
32026,91,133,2005,0,0,0
32027,91,113,2005,29,16,13
32028,91,74,2005,10,4,6
32029,91,25,2005,86,19,67
32030,91,93,2005,598,315,283
32031,91,50,2005,820,434,386
32032,92,76,2005,56,24,32
32033,92,79,2005,339,148,191
32034,92,82,2005,82,46,36
32035,92,84,2005,422,243,179
32036,92,110,2005,236,129,107
32037,92,86,2005,122,60,62
32038,92,90,2005,37,26,11
32039,92,91,2005,230,134,96
32040,92,93,2005,935,469,466
32041,92,50,2005,770,372,398
32042,62,57,2005,3714,1567,2147
32043,62,51,2005,30,23,7
32044,62,33,2005,23,20,3
32045,62,35,2005,104,84,20
32046,62,38,2005,50,48,2
32047,62,36,2005,27,25,2
32048,62,68,2005,24,14,10
32049,62,103,2005,74,34,40
32050,62,105,2005,23,21,2
32051,140,134,2005,514,306,208
32052,140,153,2005,1956,1011,945
32053,140,138,2005,210,133,77
32054,140,139,2005,342,100,242
32055,140,125,2005,167,26,141
32056,140,61,2005,171,83,88
32057,23,2,2005,216261,67588,148673
32058,23,3,2005,623564,152700,470864
32059,23,10,2005,260909,81541,179368
32060,23,120,2005,79371,24805,54566
32061,23,5,2005,1216549,369942,846607
32062,23,16,2005,5363,2443,2920
32063,23,18,2005,117432,36701,80731
32064,23,20,2005,74411,23255,51156
32065,23,8,2005,231098,50557,180541
32066,23,9,2005,724160,212742,511418
32067,23,145,2005,232539,72675,159864
32068,23,25,2005,397826,161632,236194
32069,23,142,2005,465079,145351,319728
32070,23,28,2005,372063,122094,249969
32071,164,141,2005,3523,2302,1221
32072,164,105,2005,544,287,257
32073,164,135,2005,852,536,316
32074,164,137,2005,254,140,114
32075,164,151,2005,3034,1515,1519
32076,164,68,2005,11647,5953,5694
32077,164,155,2005,4335,2486,1849
32078,164,69,2005,733,372,361
32079,164,156,2005,1500,343,1157
32080,164,157,2005,43297,16270,27027
32081,164,20,2005,927,335,592
32082,164,159,2005,663,366,297
32083,164,160,2005,28788,13061,15727
32084,164,161,2005,53740,24816,28924
32085,164,144,2005,3463,1819,1644
32086,164,162,2005,712,192,520
32087,164,158,2005,24985,13282,11703
32088,164,126,2005,324,178,146
32089,164,23,2005,1232,642,590
32090,164,165,2005,12523,6356,6167
32091,164,166,2005,1405,481,924
32092,164,26,2005,0,0,0
32093,63,51,2005,489,398,91
32094,63,141,2005,56,21,35
32095,63,103,2005,52,35,17
32096,63,66,2005,7325,3764,3561
32097,63,11,2005,165,131,34
32098,63,67,2005,228,99,129
32099,63,53,2005,351671,194450,157221
32100,63,105,2005,89,56,33
32101,63,30,2005,1187,870,317
32102,63,29,2005,141,123,18
32103,63,172,2005,1845,842,1003
32104,63,54,2005,296465,161565,134900
32105,63,81,2005,30,15,15
32106,63,14,2005,181,83,98
32107,63,31,2005,538,377,161
32108,63,39,2005,192,98,94
32109,63,42,2005,35,20,15
32110,63,68,2005,5640,2950,2690
32111,63,15,2005,51,36,15
32112,63,69,2005,16834,8310,8524
32113,63,156,2005,30,11,19
32114,63,56,2005,957,484,473
32115,63,32,2005,1884,1267,617
32116,63,5,2005,308,178,130
32117,63,6,2005,68,7,61
32118,63,16,2005,185,64,121
32119,63,44,2005,55,26,29
32120,63,17,2005,114,56,58
32121,63,57,2005,2013,933,1080
32122,63,177,2005,40,23,17
32123,63,167,2005,102,82,20
32124,63,18,2005,104,23,81
32125,63,19,2005,70,28,42
32126,63,20,2005,48,21,27
32127,63,143,2005,391,166,225
32128,63,47,2005,29,22,7
32129,63,71,2005,95,37,58
32130,63,58,2005,56,27,29
32131,63,100,2005,27,16,11
32132,63,59,2005,74564,41524,33040
32133,63,144,2005,34,22,12
32134,63,73,2005,787,376,411
32135,63,48,2005,145,65,80
32136,63,112,2005,52,33,19
32137,63,33,2005,695,609,86
32138,63,61,2005,40,16,24
32139,63,35,2005,3776,3201,575
32140,63,36,2005,3081,2269,812
32141,63,37,2005,499,364,135
32142,63,64,2005,11448,6352,5096
32143,63,115,2005,148,80,68
32144,63,133,2005,29,17,12
32145,63,65,2005,165,74,91
32146,63,49,2005,1247,621,626
32147,63,74,2005,2989,1449,1540
32148,63,25,2005,128,25,103
32149,63,27,2005,25,13,12
32150,63,146,2005,41,11,30
32151,63,26,2005,406,133,273
32152,63,170,2005,30,24,6
32153,63,38,2005,1334,1142,192
32154,63,60,2005,48899,28651,20248
32155,63,142,2005,80,27,53
32156,63,50,2005,677,320,357
32157,63,171,2005,83,77,6
32158,63,132,2005,60,32,28
32159,127,3,2005,107,23,84
32160,127,67,2005,27,13,14
32161,127,10,2005,500,157,343
32162,127,172,2005,279,36,243
32163,127,81,2005,36,18,18
32164,127,68,2005,184,87,97
32165,127,69,2005,66,36,30
32166,127,5,2005,3907,1033,2874
32167,127,57,2005,73,29,44
32168,127,121,2005,348,235,113
32169,127,122,2005,620,315,305
32170,127,7,2005,17,7,10
32171,127,124,2005,502,160,342
32172,127,8,2005,98,24,74
32173,127,162,2005,81,51,30
32174,127,9,2005,16,6,10
32175,127,36,2005,48,30,18
32176,127,128,2005,36,12,24
32177,127,115,2005,297,82,215
32178,127,65,2005,16,12,4
32179,127,130,2005,15,9,6
32180,127,50,2005,216,98,118
32181,165,153,2005,1,1,0
32182,165,136,2005,1,0,1
32183,165,172,2005,221,5,216
32184,165,137,2005,8,3,5
32185,165,151,2005,5,3,2
32186,165,138,2005,3,1,2
32187,165,119,2005,0,0,0
32188,165,155,2005,2274,779,1495
32189,165,69,2005,46,12,34
32190,165,156,2005,1232,405,827
32191,165,157,2005,56539,25191,31348
32192,165,5,2005,341,37,304
32193,165,16,2005,0,0,0
32194,165,177,2005,2,0,2
32195,165,121,2005,0,0,0
32196,165,176,2005,3,1,2
32197,165,20,2005,749,289,460
32198,165,159,2005,79156,40993,38163
32199,165,160,2005,682,157,525
32200,165,161,2005,122,45,77
32201,165,162,2005,1922,489,1433
32202,165,9,2005,122,37,85
32203,165,158,2005,6,3,3
32204,165,36,2005,56,29,27
32205,165,126,2005,2,0,2
32206,165,164,2005,609,156,453
32207,165,1,2005,1,0,1
32208,165,115,2005,112,34,78
32209,165,145,2005,5,2,3
32210,165,166,2005,33,9,24
32211,165,50,2005,315,133,182
32212,165,152,2005,12,4,8
32213,165,132,2005,0,0,0
32214,37,2,2005,488,37,451
32215,37,51,2005,68,10,58
32216,37,141,2005,75,13,62
32217,37,52,2005,0,0,0
32218,37,134,2005,18,2,16
32219,37,103,2005,61,35,26
32220,37,11,2005,306,152,154
32221,37,77,2005,0,0,0
32222,37,66,2005,2322,1025,1297
32223,37,12,2005,26,17,9
32224,37,13,2005,0,0,0
32225,37,3,2005,0,0,0
32226,37,79,2005,0,0,0
32227,37,29,2005,158,118,40
32228,37,67,2005,594,237,357
32229,37,95,2005,0,0,0
32230,37,151,2005,0,0,0
32231,37,53,2005,289,92,197
32232,37,147,2005,0,0,0
32233,37,105,2005,75,48,27
32234,37,30,2005,1612,575,1037
32235,37,152,2005,0,0,0
32236,37,116,2005,0,0,0
32237,37,135,2005,0,0,0
32238,37,80,2005,0,0,0
32239,37,136,2005,103,65,38
32240,37,106,2005,20,8,12
32241,37,172,2005,764,393,371
32242,37,107,2005,39,10,29
32243,37,137,2005,16,6,10
32244,37,96,2005,0,0,0
32245,37,54,2005,592,220,372
32246,37,81,2005,101,29,72
32247,37,14,2005,78,35,43
32248,37,31,2005,65367,39395,25972
32249,37,176,2005,0,0,0
32250,37,137,2005,0,0,0
32251,37,39,2005,178,66,112
32252,37,82,2005,0,0,0
32253,37,83,2005,0,0,0
32254,37,108,2005,25,10,15
32255,37,142,2005,133,6,127
32256,37,97,2005,0,0,0
32257,37,40,2005,38,28,10
32258,37,148,2005,0,0,0
32259,37,120,2005,22,6,16
32260,37,41,2005,0,0,0
32261,37,42,2005,111,53,58
32262,37,68,2005,2189,1136,1053
32263,37,155,2005,0,0,0
32264,37,15,2005,120,52,68
32265,37,69,2005,3439,1245,2194
32266,37,156,2005,14,3,11
32267,37,56,2005,294,110,184
32268,37,84,2005,0,0,0
32269,37,98,2005,0,0,0
32270,37,157,2005,0,0,0
32271,37,158,2005,0,0,0
32272,37,85,2005,0,0,0
32273,37,99,2005,0,0,0
32274,37,32,2005,12768,7393,5375
32275,37,43,2005,34,19,15
32276,37,5,2005,401,56,345
32277,37,6,2005,206,38,168
32278,37,16,2005,55,9,46
32279,37,44,2005,595,296,299
32280,37,45,2005,0,0,0
32281,37,17,2005,133,45,88
32282,37,57,2005,1978,544,1434
32283,37,86,2005,0,0,0
32284,37,177,2005,99,62,37
32285,37,18,2005,41,7,34
32286,37,167,2005,178,101,77
32287,37,121,2005,18,10,8
32288,37,19,2005,53,16,37
32289,37,168,2005,17,9,8
32290,37,46,2005,99,62,37
32291,37,20,2005,77,11,66
32292,37,149,2005,0,0,0
32293,37,159,2005,0,0,0
32294,37,143,2005,40,9,31
32295,37,70,2005,0,0,0
32296,37,47,2005,98,65,33
32297,37,71,2005,36,19,17
32298,37,122,2005,0,0,0
32299,37,123,2005,0,0,0
32300,37,7,2005,0,0,0
32301,37,58,2005,16,6,10
32302,37,124,2005,0,0,0
32303,37,100,2005,60,20,40
32304,37,72,2005,0,0,0
32305,37,59,2005,28,10,18
32306,37,144,2005,38,6,32
32307,37,125,2005,0,0,0
32308,37,150,2005,0,0,0
32309,37,8,2005,0,0,0
32310,37,73,2005,404,128,276
32311,37,101,2005,0,0,0
32312,37,162,2005,78,5,73
32313,37,60,2005,531,182,349
32314,37,48,2005,502,296,206
32315,37,21,2005,0,0,0
32316,37,9,2005,125,23,102
32317,37,102,2005,0,0,0
32318,37,111,2005,0,0,0
32319,37,112,2005,40,14,26
32320,37,33,2005,4962,2970,1992
32321,37,61,2005,117,40,77
32322,37,22,2005,0,0,0
32323,37,35,2005,6003,2507,3496
32324,37,36,2005,2040,1451,589
32325,37,126,2005,0,0,0
32326,37,90,2005,0,0,0
32327,37,91,2005,0,0,0
32328,37,62,2005,0,0,0
32329,37,140,2005,0,0,0
32330,37,23,2005,25,1,24
32331,37,164,2005,0,0,0
32332,37,63,2005,1380,555,825
32333,37,127,2005,0,0,0
32334,37,165,2005,0,0,0
32335,37,64,2005,228,76,152
32336,37,128,2005,0,0,0
32337,37,115,2005,79,26,53
32338,37,65,2005,603,291,312
32339,37,10,2005,0,0,0
32340,37,145,2005,0,0,0
32341,37,49,2005,188,83,105
32342,37,74,2005,457,205,252
32343,37,25,2005,167,34,133
32344,37,169,2005,0,0,0
32345,37,166,2005,0,0,0
32346,37,93,2005,0,0,0
32347,37,146,2005,106,8,98
32348,37,26,2005,226,40,186
32349,37,170,2005,0,0,0
32350,37,130,2005,0,0,0
32351,37,38,2005,7325,4951,2374
32352,37,27,2005,49,19,30
32353,37,50,2005,3601,1698,1903
32354,37,131,2005,0,0,0
32355,37,114,2005,0,0,0
32356,37,171,2005,33,20,13
32357,37,1,2005,1546,672,874
32358,37,28,2005,25,4,21
32359,37,132,2005,0,0,0
32360,37,133,2005,0,0,0
32361,64,2,2005,0,0,0
32362,64,51,2005,49,30,19
32363,64,141,2005,27,6,21
32364,64,134,2005,2,2,0
32365,64,103,2005,328,157,171
32366,64,11,2005,0,0,0
32367,64,77,2005,0,0,0
32368,64,66,2005,5190,2858,2332
32369,64,12,2005,1,0,1
32370,64,78,2005,0,0,0
32371,64,3,2005,0,0,0
32372,64,79,2005,0,0,0
32373,64,29,2005,72,44,28
32374,64,67,2005,314,163,151
32375,64,95,2005,0,0,0
32376,64,151,2005,0,0,0
32377,64,53,2005,79262,33844,45418
32378,64,147,2005,0,0,0
32379,64,105,2005,33,22,11
32380,64,30,2005,130,62,68
32381,64,152,2005,0,0,0
32382,64,116,2005,0,0,0
32383,64,153,2005,0,0,0
32384,64,135,2005,1,0,1
32385,64,136,2005,1,0,1
32386,64,106,2005,17,9,8
32387,64,172,2005,323,146,177
32388,64,107,2005,12,7,5
32389,64,117,2005,0,0,0
32390,64,137,2005,0,0,0
32391,64,96,2005,0,0,0
32392,64,54,2005,56322,28274,28048
32393,64,81,2005,15,8,7
32394,64,14,2005,2,1,1
32395,64,31,2005,412,288,124
32396,64,176,2005,0,0,0
32397,64,137,2005,2,0,2
32398,64,39,2005,30,14,16
32399,64,82,2005,0,0,0
32400,64,83,2005,31,31,0
32401,64,108,2005,4,1,3
32402,64,142,2005,56,21,35
32403,64,97,2005,0,0,0
32404,64,119,2005,0,0,0
32405,64,40,2005,0,0,0
32406,64,120,2005,14,9,5
32407,64,42,2005,12,6,6
32408,64,68,2005,1549,858,691
32409,64,139,2005,1,0,1
32410,64,155,2005,0,0,0
32411,64,15,2005,8,3,5
32412,64,69,2005,11925,6118,5807
32413,64,156,2005,17,7,10
32414,64,56,2005,61,33,28
32415,64,98,2005,0,0,0
32416,64,157,2005,7,2,5
32417,64,158,2005,1,0,1
32418,64,110,2005,0,0,0
32419,64,85,2005,0,0,0
32420,64,99,2005,0,0,0
32421,64,32,2005,350,225,125
32422,64,43,2005,10,6,4
32423,64,5,2005,49,16,33
32424,64,6,2005,31,12,19
32425,64,16,2005,46,11,35
32426,64,44,2005,9,5,4
32427,64,17,2005,30,12,18
32428,64,57,2005,3956,2173,1783
32429,64,86,2005,5,0,5
32430,64,177,2005,36,20,16
32431,64,18,2005,64,14,50
32432,64,167,2005,11,10,1
32433,64,121,2005,19,11,8
32434,64,19,2005,3,0,3
32435,64,168,2005,3,2,1
32436,64,46,2005,5,5,0
32437,64,20,2005,20,3,17
32438,64,159,2005,0,0,0
32439,64,143,2005,35,16,19
32440,64,70,2005,15,8,7
32441,64,47,2005,7,5,2
32442,64,71,2005,29,17,12
32443,64,122,2005,1,1,0
32444,64,123,2005,1,1,0
32445,64,7,2005,0,0,0
32446,64,160,2005,2,1,1
32447,64,58,2005,2,1,1
32448,64,161,2005,0,0,0
32449,64,124,2005,0,0,0
32450,64,100,2005,17,10,7
32451,64,59,2005,0,0,0
32452,64,87,2005,0,0,0
32453,64,144,2005,11,1,10
32454,64,125,2005,0,0,0
32455,64,150,2005,0,0,0
32456,64,8,2005,9,2,7
32457,64,73,2005,312,154,158
32458,64,101,2005,0,0,0
32459,64,162,2005,15,5,10
32460,64,60,2005,8770,3156,5614
32461,64,48,2005,18,10,8
32462,64,21,2005,0,0,0
32463,64,9,2005,16,6,10
32464,64,102,2005,0,0,0
32465,64,111,2005,0,0,0
32466,64,112,2005,21,8,13
32467,64,33,2005,244,181,63
32468,64,61,2005,19,10,9
32469,64,22,2005,0,0,0
32470,64,35,2005,194,140,54
32471,64,36,2005,804,582,222
32472,64,126,2005,0,0,0
32473,64,62,2005,0,0,0
32474,64,140,2005,0,0,0
32475,64,23,2005,1,0,1
32476,64,164,2005,1,0,1
32477,64,63,2005,34154,14711,19443
32478,64,165,2005,0,0,0
32479,64,37,2005,59,37,22
32480,64,128,2005,0,0,0
32481,64,115,2005,28,18,10
32482,64,65,2005,43,24,19
32483,64,10,2005,6,0,6
32484,64,145,2005,14,5,9
32485,64,113,2005,0,0,0
32486,64,49,2005,387,198,189
32487,64,74,2005,1405,696,709
32488,64,25,2005,30,5,25
32489,64,169,2005,0,0,0
32490,64,166,2005,0,0,0
32491,64,93,2005,0,0,0
32492,64,146,2005,14,4,10
32493,64,26,2005,41,14,27
32494,64,170,2005,0,0,0
32495,64,130,2005,1,0,1
32496,64,38,2005,943,688,255
32497,64,27,2005,5,3,2
32498,64,50,2005,215,105,110
32499,64,131,2005,0,0,0
32500,64,114,2005,7,5,2
32501,64,171,2005,8,5,3
32502,64,1,2005,1,1,0
32503,64,28,2005,5,0,5
32504,64,132,2005,5,1,4
32505,64,133,2005,9,4,5
32506,128,120,2005,1148,540,608
32507,128,119,2005,18,8,10
32508,128,28,2005,0,0,0
32509,115,2,2005,52,22,30
32510,115,51,2005,90,52,38
32511,115,141,2005,247,63,184
32512,115,134,2005,21994,10589,11405
32513,115,103,2005,1310,694,616
32514,115,66,2005,2980,1298,1682
32515,115,13,2005,91,78,13
32516,115,3,2005,1400,326,1074
32517,115,79,2005,16,3,13
32518,115,29,2005,132,69,63
32519,115,67,2005,4394,2091,2303
32520,115,151,2005,107,37,70
32521,115,53,2005,112,67,45
32522,115,147,2005,23147,8670,14477
32523,115,105,2005,1622,872,750
32524,115,30,2005,2174,1048,1126
32525,115,116,2005,3622,1980,1642
32526,115,135,2005,1365,416,949
32527,115,106,2005,369,180,189
32528,115,172,2005,12947,5778,7169
32529,115,107,2005,328,212,116
32530,115,117,2005,108,15,93
32531,115,137,2005,10876,4533,6343
32532,115,54,2005,553,265,288
32533,115,81,2005,847,360,487
32534,115,14,2005,2716,1346,1370
32535,115,31,2005,1102,513,589
32536,115,176,2005,76,60,16
32537,115,137,2005,16849,10016,6833
32538,115,39,2005,1397,670,727
32539,115,142,2005,2553,1192,1361
32540,115,119,2005,316,135,181
32541,115,40,2005,80,15,65
32542,115,120,2005,1715,725,990
32543,115,42,2005,358,260,98
32544,115,68,2005,4186,2085,2101
32545,115,139,2005,172,75,97
32546,115,69,2005,31347,16017,15330
32547,115,156,2005,3686,1223,2463
32548,115,55,2005,30,7,23
32549,115,56,2005,4991,2283,2708
32550,115,98,2005,50,15,35
32551,115,157,2005,43,15,28
32552,115,158,2005,16,10,6
32553,115,110,2005,31,17,14
32554,115,173,2005,892,447,445
32555,115,43,2005,17,3,14
32556,115,5,2005,22261,10559,11702
32557,115,6,2005,389,191,198
32558,115,16,2005,91,23,68
32559,115,44,2005,6690,3755,2935
32560,115,17,2005,2470,1180,1290
32561,115,57,2005,12890,6010,6880
32562,115,86,2005,107,65,42
32563,115,177,2005,967,526,441
32564,115,18,2005,31,12,19
32565,115,121,2005,9085,5009,4076
32566,115,19,2005,50,14,36
32567,115,168,2005,20,12,8
32568,115,46,2005,232,76,156
32569,115,20,2005,512,239,273
32570,115,149,2005,149432,68328,81104
32571,115,159,2005,415,261,154
32572,115,143,2005,90,17,73
32573,115,47,2005,222,127,95
32574,115,71,2005,14,10,4
32575,115,122,2005,237,137,100
32576,115,123,2005,34248,6943,27305
32577,115,7,2005,31,10,21
32578,115,160,2005,59,28,31
32579,115,58,2005,188,128,60
32580,115,124,2005,4700,2295,2405
32581,115,100,2005,158,85,73
32582,115,72,2005,14,2,12
32583,115,144,2005,600,215,385
32584,115,125,2005,322964,93097,229867
32585,115,150,2005,58250,29613,28637
32586,115,8,2005,70,27,43
32587,115,73,2005,11117,5117,6000
32588,115,101,2005,60,38,22
32589,115,162,2005,9146,1683,7463
32590,115,48,2005,615,370,245
32591,115,21,2005,17,7,10
32592,115,9,2005,5528,1176,4352
32593,115,102,2005,32,15,17
32594,115,111,2005,65,33,32
32595,115,112,2005,112,51,61
32596,115,33,2005,5447,2709,2738
32597,115,61,2005,25060,11918,13142
32598,115,35,2005,894,473,421
32599,115,36,2005,1877,975,902
32600,115,126,2005,2611,1552,1059
32601,115,90,2005,14,5,9
32602,115,23,2005,342,158,184
32603,115,164,2005,1526,135,1391
32604,115,63,2005,2143,1058,1085
32605,115,127,2005,368,223,145
32606,115,165,2005,274,94,180
32607,115,37,2005,233,63,170
32608,115,128,2005,10324,5547,4777
32609,115,65,2005,805,392,413
32610,115,10,2005,545,262,283
32611,115,145,2005,1676,775,901
32612,115,148,2005,41770,18639,23131
32613,115,49,2005,133,59,74
32614,115,74,2005,1086,589,497
32615,115,25,2005,64,33,31
32616,115,60,2005,66,15,51
32617,115,93,2005,14,7,7
32618,115,146,2005,63,29,34
32619,115,26,2005,624,221,403
32620,115,130,2005,2681,1097,1584
32621,115,38,2005,2105,1156,949
32622,115,27,2005,99,50,49
32623,115,50,2005,165691,86054,79637
32624,115,131,2005,5296,1865,3431
32625,115,114,2005,63,17,46
32626,115,1,2005,89,52,37
32627,115,28,2005,45,22,23
32628,115,132,2005,30816,16189,14627
32629,115,133,2005,169894,73792,96102
32630,129,136,2005,0,0,0
32631,129,137,2005,0,0,0
32632,129,142,2005,0,0,0
32633,129,119,2005,0,0,0
32634,129,120,2005,0,0,0
32635,129,5,2005,0,0,0
32636,129,121,2005,0,0,0
32637,129,143,2005,0,0,0
32638,129,160,2005,0,0,0
32639,129,162,2005,0,0,0
32640,129,145,2005,0,0,0
32641,129,130,2005,0,0,0
32642,65,2,2005,219,63,156
32643,65,51,2005,1094,478,616
32644,65,141,2005,48283,12959,35324
32645,65,52,2005,4135,2133,2002
32646,65,134,2005,3438,1512,1926
32647,65,103,2005,244014,118173,125841
32648,65,11,2005,7216,3141,4075
32649,65,66,2005,6332,3310,3022
32650,65,12,2005,315,162,153
32651,65,78,2005,56,25,31
32652,65,13,2005,35,12,23
32653,65,3,2005,4383,685,3698
32654,65,79,2005,35,18,17
32655,65,29,2005,2626,1537,1089
32656,65,67,2005,37120,18665,18455
32657,65,95,2005,32,16,16
32658,65,151,2005,312,76,236
32659,65,53,2005,1888,907,981
32660,65,105,2005,68502,42303,26199
32661,65,30,2005,86226,38101,48125
32662,65,152,2005,537,101,436
32663,65,116,2005,50,19,31
32664,65,153,2005,3243,1891,1352
32665,65,135,2005,3321,1251,2070
32666,65,136,2005,68,21,47
32667,65,106,2005,49390,24838,24552
32668,65,172,2005,81322,38784,42538
32669,65,107,2005,270028,154254,115774
32670,65,137,2005,1694,564,1130
32671,65,96,2005,2116,1164,952
32672,65,54,2005,1532,718,814
32673,65,81,2005,71614,39527,32087
32674,65,14,2005,192,81,111
32675,65,31,2005,4368,2652,1716
32676,65,176,2005,161,74,87
32677,65,137,2005,1194,437,757
32678,65,39,2005,8358,4286,4072
32679,65,118,2005,20,6,14
32680,65,82,2005,753,518,235
32681,65,83,2005,73049,48098,24951
32682,65,108,2005,456379,236083,220296
32683,65,142,2005,3185,851,2334
32684,65,97,2005,4372,2702,1670
32685,65,138,2005,17628,10714,6914
32686,65,119,2005,62,23,39
32687,65,40,2005,575,333,242
32688,65,120,2005,754,348,406
32689,65,42,2005,8459,4697,3762
32690,65,68,2005,177040,92907,84133
32691,65,139,2005,200,99,101
32692,65,155,2005,11215,2393,8822
32693,65,15,2005,4926,1794,3132
32694,65,69,2005,180349,91134,89215
32695,65,156,2005,9730,1226,8504
32696,65,56,2005,2136,825,1311
32697,65,84,2005,527,251,276
32698,65,98,2005,3643,2204,1439
32699,65,157,2005,8269,2651,5618
32700,65,158,2005,4351,710,3641
32701,65,110,2005,81,47,34
32702,65,85,2005,339,153,186
32703,65,99,2005,7820,5006,2814
32704,65,32,2005,2869,1688,1181
32705,65,43,2005,682,360,322
32706,65,5,2005,18346,6042,12304
32707,65,6,2005,4212,1652,2560
32708,65,16,2005,1660,559,1101
32709,65,44,2005,9107,4525,4582
32710,65,17,2005,2184,788,1396
32711,65,57,2005,47475,17931,29544
32712,65,86,2005,182,103,79
32713,65,177,2005,5083,2895,2188
32714,65,18,2005,1976,472,1504
32715,65,167,2005,420,234,186
32716,65,121,2005,787,485,302
32717,65,19,2005,369,139,230
32718,65,168,2005,156,93,63
32719,65,46,2005,1318,758,560
32720,65,20,2005,2596,770,1826
32721,65,159,2005,1255,344,911
32722,65,143,2005,687,236,451
32723,65,70,2005,87,52,35
32724,65,47,2005,11395,5540,5855
32725,65,71,2005,1178,617,561
32726,65,122,2005,353,230,123
32727,65,123,2005,35,17,18
32728,65,160,2005,11131,634,10497
32729,65,58,2005,146,79,67
32730,65,161,2005,8638,1672,6966
32731,65,124,2005,173,78,95
32732,65,100,2005,35811,20209,15602
32733,65,72,2005,182,91,91
32734,65,59,2005,0,0,0
32735,65,144,2005,521940,182973,338967
32736,65,125,2005,892,463,429
32737,65,150,2005,73,42,31
32738,65,8,2005,680,236,444
32739,65,73,2005,34862,17154,17708
32740,65,101,2005,3156,1900,1256
32741,65,162,2005,24338,9100,15238
32742,65,60,2005,376,151,225
32743,65,48,2005,11673,5916,5757
32744,65,21,2005,20,9,11
32745,65,9,2005,30659,3057,27602
32746,65,102,2005,3120,1738,1382
32747,65,111,2005,16642,10456,6186
32748,65,112,2005,101295,55921,45374
32749,65,33,2005,33371,16536,16835
32750,65,61,2005,75768,34992,40776
32751,65,22,2005,48,20,28
32752,65,35,2005,292379,133131,159248
32753,65,36,2005,39783,24898,14885
32754,65,126,2005,214,70,144
32755,65,91,2005,39,21,18
32756,65,62,2005,19,8,11
32757,65,140,2005,131,66,65
32758,65,23,2005,458,168,290
32759,65,164,2005,26850,4518,22332
32760,65,63,2005,0,0,0
32761,65,127,2005,38,26,12
32762,65,165,2005,1691,650,1041
32763,65,37,2005,3279,1783,1496
32764,65,64,2005,451,233,218
32765,65,128,2005,168,49,119
32766,65,115,2005,1880,914,966
32767,65,10,2005,403,169,234
32768,65,145,2005,320,88,232
32769,65,113,2005,107,65,42
32770,65,49,2005,14768,8132,6636
32771,65,74,2005,56682,28513,28169
32772,65,25,2005,4433,1275,3158
32773,65,169,2005,20,11,9
32774,65,166,2005,343,82,261
32775,65,93,2005,122,73,49
32776,65,146,2005,1931,576,1355
32777,65,26,2005,1871,600,1271
32778,65,170,2005,13,11,2
32779,65,130,2005,103,52,51
32780,65,38,2005,61162,30403,30759
32781,65,27,2005,128,60,68
32782,65,50,2005,222431,111591,110840
32783,65,131,2005,253,118,135
32784,65,114,2005,65654,31904,33750
32785,65,171,2005,240,135,105
32786,65,1,2005,765,413,352
32787,65,28,2005,27,6,21
32788,65,132,2005,119,64,55
32789,65,133,2005,204,99,105
32790,10,2,2005,63,30,33
32791,10,13,2005,194,94,100
32792,10,3,2005,326,86,240
32793,10,4,2005,113,50,63
32794,10,172,2005,1153,142,1011
32795,10,14,2005,122,59,63
32796,10,42,2005,29,20,9
32797,10,68,2005,168,78,90
32798,10,69,2005,278,126,152
32799,10,56,2005,44,19,25
32800,10,85,2005,18,10,8
32801,10,5,2005,24499,11124,13375
32802,10,6,2005,51,19,32
32803,10,16,2005,19,9,10
32804,10,17,2005,26,9,17
32805,10,57,2005,2571,1283,1288
32806,10,177,2005,410,218,192
32807,10,18,2005,134,72,62
32808,10,19,2005,849,448,401
32809,10,20,2005,358,189,169
32810,10,143,2005,19,7,12
32811,10,7,2005,731,414,317
32812,10,21,2005,161,86,75
32813,10,8,2005,167,56,111
32814,10,48,2005,57,28,29
32815,10,9,2005,482,223,259
32816,10,61,2005,6,4,2
32817,10,22,2005,134,60,74
32818,10,36,2005,72,45,27
32819,10,23,2005,635,323,312
32820,10,127,2005,12,6,6
32821,10,115,2005,127,76,51
32822,10,65,2005,17,10,7
32823,10,49,2005,76,30,46
32824,10,74,2005,142,67,75
32825,10,25,2005,35,18,17
32826,10,27,2005,816,410,406
32827,10,26,2005,22,10,12
32828,10,142,2005,63,21,42
32829,10,50,2005,594,295,299
32830,145,136,2005,80942,39267,41675
32831,145,172,2005,1890,914,976
32832,145,137,2005,13625,6638,6987
32833,145,120,2005,107732,52417,55315
32834,145,119,2005,196564,98523,98041
32835,145,5,2005,2397,1163,1234
32836,145,121,2005,5860,2834,3026
32837,145,143,2005,2676,1297,1379
32838,145,160,2005,1171,566,605
32839,145,162,2005,25762,12467,13295
32840,145,128,2005,38,22,16
32841,145,129,2005,0,0,0
32842,145,130,2005,26103,12695,13408
32843,145,142,2005,23620,11427,12193
32844,113,105,2005,3921,1785,2136
32845,113,172,2005,3836,1746,2090
32846,113,110,2005,9548,4347,5201
32847,113,73,2005,2450,1115,1335
32848,49,2,2005,8255,3820,4435
32849,49,51,2005,684,305,379
32850,49,141,2005,1971,682,1289
32851,49,52,2005,1,1,0
32852,49,134,2005,547,298,249
32853,49,76,2005,8,3,5
32854,49,103,2005,2683,1330,1353
32855,49,11,2005,788,427,361
32856,49,66,2005,5803,2569,3234
32857,49,12,2005,706,414,292
32858,49,78,2005,26,7,19
32859,49,13,2005,54,20,34
32860,49,3,2005,3882,1701,2181
32861,49,79,2005,106,30,76
32862,49,29,2005,1088,690,398
32863,49,67,2005,1443,681,762
32864,49,95,2005,6,1,5
32865,49,151,2005,32,13,19
32866,49,4,2005,19,7,12
32867,49,53,2005,54222,27471,26751
32868,49,147,2005,61,39,22
32869,49,105,2005,4409,2796,1613
32870,49,30,2005,3920,2104,1816
32871,49,152,2005,49,21,28
32872,49,116,2005,1258,649,609
32873,49,153,2005,325,175,150
32874,49,135,2005,592,157,435
32875,49,136,2005,39,9,30
32876,49,106,2005,27511,13711,13800
32877,49,172,2005,13134,8460,4674
32878,49,173,2005,583,330,253
32879,49,107,2005,8800,4167,4633
32880,49,117,2005,6,3,3
32881,49,137,2005,344,166,178
32882,49,96,2005,271,143,128
32883,49,54,2005,5873,2916,2957
32884,49,81,2005,1813,807,1006
32885,49,14,2005,440,176,264
32886,49,31,2005,616,359,257
32887,49,176,2005,74,29,45
32888,49,137,2005,1346,623,723
32889,49,39,2005,42143,19747,22396
32890,49,118,2005,69,40,29
32891,49,82,2005,45,22,23
32892,49,83,2005,395,201,194
32893,49,108,2005,1376,673,703
32894,49,142,2005,2473,889,1584
32895,49,97,2005,2425,1186,1239
32896,49,138,2005,26,14,12
32897,49,119,2005,5314,2657,2657
32898,49,40,2005,9764,5799,3965
32899,49,148,2005,18,11,7
32900,49,120,2005,11100,5278,5822
32901,49,42,2005,181703,107052,74651
32902,49,68,2005,6460,2647,3813
32903,49,139,2005,3,0,3
32904,49,155,2005,2900,1223,1677
32905,49,15,2005,362,197,165
32906,49,69,2005,41136,22330,18806
32907,49,156,2005,1395,554,841
32908,49,55,2005,5,2,3
32909,49,56,2005,10633,4277,6356
32910,49,84,2005,42,7,35
32911,49,98,2005,688,325,363
32912,49,157,2005,169,61,108
32913,49,158,2005,93,34,59
32914,49,110,2005,118,77,41
32915,49,85,2005,115,52,63
32916,49,99,2005,272,138,134
32917,49,32,2005,13454,6776,6678
32918,49,43,2005,3835,1889,1946
32919,49,5,2005,13447,7310,6137
32920,49,6,2005,53882,25174,28708
32921,49,16,2005,71770,32761,39009
32922,49,44,2005,1453,515,938
32923,49,17,2005,1981,762,1219
32924,49,57,2005,6526,2157,4369
32925,49,86,2005,220,91,129
32926,49,177,2005,2583,1680,903
32927,49,18,2005,1540,681,859
32928,49,167,2005,599,378,221
32929,49,121,2005,1600,922,678
32930,49,19,2005,1028,445,583
32931,49,168,2005,242,149,93
32932,49,46,2005,2686,1707,979
32933,49,20,2005,21210,9541,11669
32934,49,149,2005,20,15,5
32935,49,159,2005,730,373,357
32936,49,143,2005,619,194,425
32937,49,70,2005,2,2,0
32938,49,47,2005,2291,1390,901
32939,49,71,2005,156,83,73
32940,49,122,2005,81,55,26
32941,49,123,2005,54,28,26
32942,49,7,2005,13,5,8
32943,49,160,2005,61,19,42
32944,49,58,2005,103,50,53
32945,49,161,2005,26,2,24
32946,49,124,2005,141,92,49
32947,49,100,2005,1510,786,724
32948,49,72,2005,22,5,17
32949,49,59,2005,0,0,0
32950,49,144,2005,5488,2391,3097
32951,49,125,2005,243,149,94
32952,49,150,2005,67,33,34
32953,49,8,2005,238,102,136
32954,49,73,2005,5859,2500,3359
32955,49,101,2005,490,279,211
32956,49,162,2005,1429,359,1070
32957,49,60,2005,3355,1633,1722
32958,49,48,2005,44290,25270,19020
32959,49,21,2005,20,13,7
32960,49,9,2005,4653,1794,2859
32961,49,102,2005,219,116,103
32962,49,111,2005,146,83,63
32963,49,112,2005,5455,2909,2546
32964,49,33,2005,45705,29214,16491
32965,49,61,2005,2562,1175,1387
32966,49,22,2005,46,24,22
32967,49,35,2005,12611,7071,5540
32968,49,36,2005,10833,7264,3569
32969,49,126,2005,240,116,124
32970,49,90,2005,2,1,1
32971,49,91,2005,25,6,19
32972,49,92,2005,12,2,10
32973,49,62,2005,5,2,3
32974,49,140,2005,10,3,7
32975,49,23,2005,1012,495,517
32976,49,164,2005,325,144,181
32977,49,63,2005,11953,5697,6256
32978,49,127,2005,57,42,15
32979,49,165,2005,509,243,266
32980,49,37,2005,531,336,195
32981,49,64,2005,813,397,416
32982,49,128,2005,15872,7732,8140
32983,49,115,2005,1551,667,884
32984,49,129,2005,0,0,0
32985,49,65,2005,5546,2358,3188
32986,49,10,2005,6161,3496,2665
32987,49,145,2005,1030,435,595
32988,49,113,2005,27,15,12
32989,49,74,2005,2592,1206,1386
32990,49,25,2005,16591,8364,8227
32991,49,169,2005,120,69,51
32992,49,166,2005,251,106,145
32993,49,93,2005,250,138,112
32994,49,146,2005,3173,1034,2139
32995,49,26,2005,35466,16635,18831
32996,49,170,2005,157,98,59
32997,49,130,2005,2489,1272,1217
32998,49,38,2005,2748,1950,798
32999,49,27,2005,479,230,249
33000,49,50,2005,16960,5827,11133
33001,49,131,2005,1062,559,503
33002,49,114,2005,2288,1119,1169
33003,49,171,2005,1154,616,538
33004,49,1,2005,12180,6482,5698
33005,49,28,2005,240,101,139
33006,49,132,2005,302,166,136
33007,49,133,2005,336,156,180
33008,74,2,2005,3300,1210,2090
33009,74,51,2005,1492,784,708
33010,74,141,2005,7336,2848,4488
33011,74,52,2005,38,13,25
33012,74,134,2005,5161,2422,2739
33013,74,76,2005,87,38,49
33014,74,103,2005,6709,3325,3384
33015,74,11,2005,539,294,245
33016,74,66,2005,49461,28927,20534
33017,74,12,2005,408,217,191
33018,74,78,2005,96,44,52
33019,74,13,2005,240,112,128
33020,74,3,2005,1576,460,1116
33021,74,79,2005,61,25,36
33022,74,29,2005,880,623,257
33023,74,67,2005,12166,6103,6063
33024,74,95,2005,50,24,26
33025,74,151,2005,426,153,273
33026,74,4,2005,58,26,32
33027,74,53,2005,43388,21279,22109
33028,74,147,2005,52,23,29
33029,74,105,2005,32111,22434,9677
33030,74,30,2005,4345,2799,1546
33031,74,152,2005,485,210,275
33032,74,116,2005,447,247,200
33033,74,153,2005,1638,784,854
33034,74,135,2005,5473,3340,2133
33035,74,136,2005,235,115,120
33036,74,106,2005,5860,2926,2934
33037,74,172,2005,13467,7792,5675
33038,74,107,2005,8954,5261,3693
33039,74,117,2005,23,8,15
33040,74,137,2005,991,455,536
33041,74,96,2005,691,388,303
33042,74,54,2005,16545,8689,7856
33043,74,81,2005,2433,1322,1111
33044,74,14,2005,290,119,171
33045,74,31,2005,10681,5951,4730
33046,74,176,2005,389,244,145
33047,74,137,2005,5070,2422,2648
33048,74,39,2005,4521,2463,2058
33049,74,118,2005,76,37,39
33050,74,82,2005,251,170,81
33051,74,83,2005,8107,5510,2597
33052,74,108,2005,3720,2160,1560
33053,74,142,2005,4875,1694,3181
33054,74,97,2005,555,309,246
33055,74,138,2005,30,16,14
33056,74,119,2005,5967,2338,3629
33057,74,40,2005,419,283,136
33058,74,148,2005,81,50,31
33059,74,120,2005,3828,1989,1839
33060,74,42,2005,4186,2828,1358
33061,74,68,2005,113647,56954,56693
33062,74,139,2005,206,119,87
33063,74,155,2005,539,63,476
33064,74,15,2005,513,288,225
33065,74,69,2005,272239,130993,141246
33066,74,156,2005,2114,1023,1091
33067,74,56,2005,6754,2967,3787
33068,74,84,2005,36,19,17
33069,74,98,2005,769,423,346
33070,74,157,2005,904,257,647
33071,74,158,2005,246,75,171
33072,74,110,2005,106,67,39
33073,74,85,2005,1398,873,525
33074,74,99,2005,425,268,157
33075,74,32,2005,12894,6685,6209
33076,74,43,2005,280,134,146
33077,74,5,2005,14300,6515,7785
33078,74,6,2005,6952,3033,3919
33079,74,16,2005,5619,1885,3734
33080,74,44,2005,2696,1298,1398
33081,74,17,2005,2872,1238,1634
33082,74,57,2005,198917,84150,114767
33083,74,86,2005,612,328,284
33084,74,177,2005,5673,3721,1952
33085,74,18,2005,515,196,319
33086,74,167,2005,1689,946,743
33087,74,121,2005,2581,1438,1143
33088,74,19,2005,346,150,196
33089,74,168,2005,359,225,134
33090,74,46,2005,1204,859,345
33091,74,20,2005,4695,1590,3105
33092,74,149,2005,62,35,27
33093,74,159,2005,336,142,194
33094,74,143,2005,826,329,497
33095,74,70,2005,1899,1106,793
33096,74,47,2005,885,598,287
33097,74,71,2005,1819,923,896
33098,74,122,2005,1341,793,548
33099,74,123,2005,84,39,45
33100,74,7,2005,50,11,39
33101,74,160,2005,329,136,193
33102,74,58,2005,225,120,105
33103,74,161,2005,96,33,63
33104,74,124,2005,2210,1512,698
33105,74,100,2005,4915,2892,2023
33106,74,72,2005,202,100,102
33107,74,59,2005,2163,1039,1124
33108,74,144,2005,13263,7176,6087
33109,74,125,2005,985,494,491
33110,74,150,2005,233,107,126
33111,74,8,2005,725,290,435
33112,74,73,2005,21256,11010,10246
33113,74,101,2005,464,275,189
33114,74,162,2005,2627,774,1853
33115,74,60,2005,44141,20205,23936
33116,74,48,2005,1835,964,871
33117,74,21,2005,64,27,37
33118,74,9,2005,3334,1155,2179
33119,74,102,2005,364,202,162
33120,74,111,2005,761,434,327
33121,74,112,2005,7333,4563,2770
33122,74,33,2005,19168,10807,8361
33123,74,61,2005,151305,65727,85578
33124,74,22,2005,53,21,32
33125,74,35,2005,10868,6648,4220
33126,74,36,2005,14170,8914,5256
33127,74,126,2005,820,430,390
33128,74,90,2005,0,0,0
33129,74,91,2005,46,19,27
33130,74,92,2005,0,0,0
33131,74,62,2005,0,0,0
33132,74,140,2005,44,24,20
33133,74,23,2005,733,328,405
33134,74,164,2005,1759,678,1081
33135,74,63,2005,112102,53896,58206
33136,74,127,2005,181,122,59
33137,74,165,2005,261,101,160
33138,74,37,2005,8101,4998,3103
33139,74,64,2005,2918,1649,1269
33140,74,128,2005,3924,1575,2349
33141,74,115,2005,5792,2954,2838
33142,74,129,2005,0,0,0
33143,74,65,2005,46554,22102,24452
33144,74,10,2005,28472,13146,15326
33145,74,145,2005,812,333,479
33146,74,113,2005,83,49,34
33147,74,49,2005,7740,4084,3656
33148,74,25,2005,2613,1003,1610
33149,74,169,2005,129,75,54
33150,74,166,2005,1395,591,804
33151,74,93,2005,257,142,115
33152,74,146,2005,8390,2712,5678
33153,74,26,2005,64016,28373,35643
33154,74,170,2005,64,43,21
33155,74,130,2005,600,326,274
33156,74,38,2005,5401,3910,1491
33157,74,27,2005,313,140,173
33158,74,50,2005,35652,15892,19760
33159,74,131,2005,682,348,334
33160,74,114,2005,1300,657,643
33161,74,171,2005,535,326,209
33162,74,1,2005,9147,4862,4285
33163,74,28,2005,338,143,195
33164,74,132,2005,287,146,141
33165,74,133,2005,818,419,399
33166,25,2,2005,629,308,321
33167,25,16,2005,337785,164991,172794
33168,25,128,2005,1458,712,746
33169,25,145,2005,222,109,113
33170,169,2,2005,12636,6949,5687
33171,169,141,2005,133,73,60
33172,169,12,2005,173,108,65
33173,169,66,2005,66,36,30
33174,169,11,2005,199,122,77
33175,169,29,2005,694,411,283
33176,169,172,2005,50,19,31
33177,169,39,2005,134,53,81
33178,169,15,2005,678,325,353
33179,169,69,2005,137,61,76
33180,169,5,2005,630,236,394
33181,169,6,2005,1221,577,644
33182,169,16,2005,65,30,35
33183,169,167,2005,857,447,410
33184,169,176,2005,159,64,95
33185,169,168,2005,11502,5627,5875
33186,169,21,2005,38,20,18
33187,169,73,2005,52,34,18
33188,169,9,2005,108,53,55
33189,169,33,2005,39,20,19
33190,169,36,2005,238699,137686,101013
33191,169,74,2005,54,25,29
33192,169,26,2005,792,368,424
33193,169,170,2005,456,234,222
33194,169,38,2005,1233,481,752
33195,169,50,2005,321,84,237
33196,169,171,2005,7688,3962,3726
33197,169,132,2005,25,13,12
33198,131,134,2005,1153,465,688
33199,131,147,2005,132,41,91
33200,131,116,2005,461225,156976,304249
33201,131,117,2005,551,219,332
33202,131,137,2005,23777,12034,11743
33203,131,137,2005,150345,47859,102486
33204,131,69,2005,901,382,519
33205,131,5,2005,7198,3087,4111
33206,131,57,2005,536,226,310
33207,131,121,2005,29010,16595,12415
33208,131,149,2005,134,41,93
33209,131,123,2005,7048,3226,3822
33210,131,124,2005,181,68,113
33211,131,125,2005,36267,17854,18413
33212,131,150,2005,571,233,338
33213,131,9,2005,617,252,365
33214,131,126,2005,13231,6451,6780
33215,131,127,2005,345,137,208
33216,131,128,2005,3424,1145,2279
33217,131,115,2005,659,259,400
33218,131,148,2005,83,26,57
33219,131,130,2005,9484,4522,4962
33220,131,50,2005,1015,422,593
33221,131,132,2005,11845,6330,5515
33222,131,133,2005,753,314,439
33223,166,67,2005,37,11,26
33224,166,135,2005,476,181,295
33225,166,153,2005,25,11,14
33226,166,136,2005,487,165,322
33227,166,172,2005,352,67,285
33228,166,137,2005,174,70,104
33229,166,137,2005,515,279,236
33230,166,151,2005,51174,24372,26802
33231,166,138,2005,71,27,44
33232,166,68,2005,1071,504,567
33233,166,139,2005,613,286,327
33234,166,155,2005,727,333,394
33235,166,69,2005,117,67,50
33236,166,156,2005,32848,17532,15316
33237,166,157,2005,2219,1055,1164
33238,166,159,2005,114,58,56
33239,166,160,2005,3674,1886,1788
33240,166,161,2005,95,56,39
33241,166,162,2005,26919,12723,14196
33242,166,158,2005,86,50,36
33243,166,126,2005,1409,771,638
33244,166,140,2005,26,13,13
33245,166,164,2005,689,318,371
33246,166,165,2005,70,37,33
33247,166,152,2005,11391,5257,6134
33248,93,79,2005,1688,836,852
33249,93,172,2005,494,237,257
33250,93,81,2005,42,19,23
33251,93,69,2005,144,75,69
33252,93,84,2005,11973,6628,5345
33253,93,110,2005,5649,3358,2291
33254,93,5,2005,665,295,370
33255,93,86,2005,856,436,420
33256,93,162,2005,286,109,177
33257,93,91,2005,1047,534,513
33258,93,92,2005,8998,5016,3982
33259,93,50,2005,2243,1076,1167
33260,146,141,2005,9577,4656,4921
33261,146,135,2005,0,0,0
33262,146,68,2005,4577,2229,2348
33263,146,69,2005,992,483,509
33264,146,16,2005,8,3,5
33265,146,57,2005,1548,754,794
33266,146,143,2005,1725,840,885
33267,146,160,2005,220,107,113
33268,146,161,2005,414,202,212
33269,146,144,2005,6315,3075,3240
33270,146,162,2005,128,62,66
33271,146,164,2005,357,174,183
33272,146,25,2005,418,203,215
33273,146,142,2005,667,325,342
33274,26,2,2005,9360,4105,5255
33275,26,51,2005,3192,1609,1583
33276,26,141,2005,624,174,450
33277,26,12,2005,16174,7975,8199
33278,26,103,2005,135,69,66
33279,26,66,2005,13812,7087,6725
33280,26,3,2005,318,27,291
33281,26,11,2005,765,489,276
33282,26,67,2005,8432,4522,3910
33283,26,53,2005,2294,1180,1114
33284,26,105,2005,331,207,124
33285,26,30,2005,463279,247792,215487
33286,26,29,2005,290,225,65
33287,26,10,2005,38,7,31
33288,26,106,2005,43,29,14
33289,26,172,2005,1702,876,826
33290,26,107,2005,46,31,15
33291,26,137,2005,31,9,22
33292,26,96,2005,53,26,27
33293,26,54,2005,214,124,90
33294,26,81,2005,42,21,21
33295,26,14,2005,10011,5488,4523
33296,26,31,2005,1093,556,537
33297,26,39,2005,3242,1713,1529
33298,26,120,2005,60,37,23
33299,26,40,2005,109,70,39
33300,26,42,2005,1610,882,728
33301,26,68,2005,15392,8010,7382
33302,26,15,2005,6273,3687,2586
33303,26,69,2005,263557,138001,125556
33304,26,156,2005,139,17,122
33305,26,56,2005,57056,31654,25402
33306,26,173,2005,56,30,26
33307,26,32,2005,501,298,203
33308,26,43,2005,42,23,19
33309,26,5,2005,501,191,310
33310,26,6,2005,14451,5655,8796
33311,26,16,2005,8690,3567,5123
33312,26,44,2005,518,268,250
33313,26,17,2005,2620,1287,1333
33314,26,57,2005,2739,1224,1515
33315,26,177,2005,1929,1083,846
33316,26,167,2005,4813,2710,2103
33317,26,18,2005,867,318,549
33318,26,121,2005,167,62,105
33319,26,176,2005,29,14,15
33320,26,19,2005,276,99,177
33321,26,168,2005,1692,750,942
33322,26,20,2005,1091,558,533
33323,26,46,2005,63,43,20
33324,26,143,2005,2959,1299,1660
33325,26,47,2005,251,155,96
33326,26,71,2005,44,25,19
33327,26,58,2005,42,28,14
33328,26,100,2005,148,78,70
33329,26,144,2005,459,188,271
33330,26,21,2005,25,15,10
33331,26,73,2005,21027,10849,10178
33332,26,162,2005,282,39,243
33333,26,48,2005,3423,1782,1641
33334,26,9,2005,1097,448,649
33335,26,112,2005,52,32,20
33336,26,33,2005,3291,1767,1524
33337,26,61,2005,216,114,102
33338,26,22,2005,31,12,19
33339,26,35,2005,19979,12127,7852
33340,26,36,2005,19132,11868,7264
33341,26,23,2005,4234,2045,2189
33342,26,164,2005,65,26,39
33343,26,37,2005,303,164,139
33344,26,1,2005,30,18,12
33345,26,64,2005,141,76,65
33346,26,128,2005,90,31,59
33347,26,115,2005,285,140,145
33348,26,65,2005,1165,623,542
33349,26,145,2005,225,58,167
33350,26,148,2005,74,49,25
33351,26,49,2005,5139,2803,2336
33352,26,74,2005,9990,5332,4658
33353,26,25,2005,5178,2761,2417
33354,26,169,2005,256,64,192
33355,26,27,2005,43,16,27
33356,26,146,2005,491,195,296
33357,26,170,2005,1961,558,1403
33358,26,38,2005,4026,2871,1155
33359,26,60,2005,138686,73540,65146
33360,26,142,2005,744,312,432
33361,26,50,2005,18224,9919,8305
33362,26,131,2005,214,24,190
33363,26,114,2005,43,21,22
33364,26,171,2005,7644,4034,3610
33365,26,28,2005,67,28,39
33366,170,2,2005,808,459,349
33367,170,12,2005,7745,3967,3778
33368,170,11,2005,7391,3734,3657
33369,170,29,2005,2140,749,1391
33370,170,69,2005,1028,596,432
33371,170,6,2005,1771,889,882
33372,170,167,2005,20410,10406,10004
33373,170,36,2005,78008,42100,35908
33374,170,169,2005,12089,6877,5212
33375,170,38,2005,8325,4046,4279
33376,170,171,2005,70180,36457,33723
33377,94,78,2005,346,163,183
33378,94,83,2005,722,321,401
33379,94,85,2005,5652,2835,2817
33380,94,50,2005,398,182,216
33381,130,141,2005,0,0,0
33382,130,3,2005,126,106,20
33383,130,67,2005,38,19,19
33384,130,116,2005,15440,6561,8879
33385,130,172,2005,362,131,231
33386,130,137,2005,93208,49985,43223
33387,130,81,2005,16,1,15
33388,130,39,2005,154,78,76
33389,130,120,2005,337,166,171
33390,130,119,2005,143,71,72
33391,130,68,2005,220,84,136
33392,130,155,2005,0,0,0
33393,130,69,2005,207,100,107
33394,130,156,2005,0,0,0
33395,130,56,2005,35,19,16
33396,130,32,2005,8,8,0
33397,130,5,2005,3476,1276,2200
33398,130,57,2005,358,33,325
33399,130,177,2005,181,63,118
33400,130,121,2005,36105,20402,15703
33401,130,176,2005,131,31,100
33402,130,143,2005,0,0,0
33403,130,123,2005,6,1,5
33404,130,161,2005,0,0,0
33405,130,125,2005,26,12,14
33406,130,73,2005,189,97,92
33407,130,162,2005,3,0,3
33408,130,48,2005,7,0,7
33409,130,9,2005,572,131,441
33410,130,36,2005,270,157,113
33411,130,126,2005,75091,37514,37577
33412,130,164,2005,0,0,0
33413,130,128,2005,2387,1187,1200
33414,130,133,2005,2,0,2
33415,130,65,2005,53,36,17
33416,130,129,2005,0,0,0
33417,130,145,2005,337681,169695,167986
33418,130,49,2005,25,0,25
33419,130,166,2005,3,0,3
33420,130,142,2005,0,0,0
33421,130,50,2005,1061,490,571
33422,130,131,2005,21648,10920,10728
33423,130,132,2005,6,2,4
33424,38,2,2005,2207,494,1713
33425,38,12,2005,85967,38144,47823
33426,38,11,2005,49416,20836,28580
33427,38,30,2005,1811,587,1224
33428,38,29,2005,256474,151405,105069
33429,38,172,2005,6854,2470,4384
33430,38,40,2005,10678,5339,5339
33431,38,15,2005,67270,30804,36466
33432,38,69,2005,1132,523,609
33433,38,5,2005,3987,781,3206
33434,38,6,2005,2232,415,1817
33435,38,17,2005,3920,1910,2010
33436,38,167,2005,232148,127843,104305
33437,38,18,2005,3880,88,3792
33438,38,168,2005,27921,15129,12792
33439,38,20,2005,1844,102,1742
33440,38,46,2005,20366,10181,10185
33441,38,47,2005,25507,12752,12755
33442,38,144,2005,1816,513,1303
33443,38,33,2005,3216,1741,1475
33444,38,36,2005,3422713,2020067,1402646
33445,38,1,2005,12943,5510,7433
33446,38,25,2005,3887,152,3735
33447,38,169,2005,30677,15478,15199
33448,38,26,2005,1416,201,1215
33449,38,170,2005,23610,12584,11026
33450,38,171,2005,229608,115762,113846
33451,27,2,2005,3208,989,2219
33452,27,13,2005,831,502,329
33453,27,3,2005,408976,58037,350939
33454,27,10,2005,49194,23136,26058
33455,27,136,2005,2094,646,1448
33456,27,120,2005,4607,1417,3190
33457,27,119,2005,7570,2334,5236
33458,27,68,2005,5745,2167,3578
33459,27,5,2005,1286993,308969,978024
33460,27,18,2005,63626,22470,41156
33461,27,19,2005,26337,8195,18142
33462,27,20,2005,14856,4601,10255
33463,27,144,2005,3594,1107,2487
33464,27,8,2005,8818,2744,6074
33465,27,73,2005,1378,565,813
33466,27,162,2005,5207,1617,3590
33467,27,9,2005,383831,88672,295159
33468,27,22,2005,824,532,292
33469,27,23,2005,2395,757,1638
33470,27,128,2005,4165,1280,2885
33471,27,129,2005,6751,2388,4363
33472,27,145,2005,55931,19784,36147
33473,27,25,2005,22332,6869,15463
33474,27,146,2005,2303,709,1594
33475,27,26,2005,16152,4967,11185
33476,27,142,2005,341789,114095,227694
33477,27,50,2005,13007,4610,8397
33478,27,28,2005,82490,25423,57067
33479,50,2,2005,36020,13699,22321
33480,50,51,2005,7335,2691,4644
33481,50,141,2005,16393,5312,11081
33482,50,52,2005,39,18,21
33483,50,134,2005,9446,5004,4442
33484,50,75,2005,568,296,272
33485,50,76,2005,3510,1934,1576
33486,50,103,2005,7984,4524,3460
33487,50,11,2005,1038,566,472
33488,50,77,2005,659,373,286
33489,50,66,2005,18296,12334,5962
33490,50,12,2005,1595,854,741
33491,50,78,2005,1716,915,801
33492,50,13,2005,4611,2264,2347
33493,50,3,2005,169747,82077,87670
33494,50,79,2005,18665,9663,9002
33495,50,29,2005,2552,1673,879
33496,50,67,2005,22475,12777,9698
33497,50,95,2005,1191,823,368
33498,50,151,2005,398,188,210
33499,50,4,2005,239,84,155
33500,50,53,2005,6717,3739,2978
33501,50,147,2005,2446,1251,1195
33502,50,105,2005,30972,17526,13446
33503,50,30,2005,24618,12700,11918
33504,50,152,2005,147,65,82
33505,50,116,2005,2993,1669,1324
33506,50,153,2005,699,398,301
33507,50,135,2005,6197,3168,3029
33508,50,80,2005,891,504,387
33509,50,136,2005,245,88,157
33510,50,106,2005,5655,3101,2554
33511,50,172,2005,146994,75966,71028
33512,50,173,2005,87020,42476,44544
33513,50,107,2005,17530,10401,7129
33514,50,117,2005,95,54,41
33515,50,137,2005,5596,3171,2425
33516,50,96,2005,502,274,228
33517,50,54,2005,7093,4147,2946
33518,50,81,2005,1638,859,779
33519,50,14,2005,72192,36079,36113
33520,50,31,2005,23419,14569,8850
33521,50,176,2005,7984,4623,3361
33522,50,137,2005,12919,6934,5985
33523,50,39,2005,19297,11629,7668
33524,50,118,2005,319,180,139
33525,50,82,2005,6048,3222,2826
33526,50,83,2005,876,424,452
33527,50,108,2005,5428,2958,2470
33528,50,142,2005,25824,11383,14441
33529,50,97,2005,678,412,266
33530,50,138,2005,159,103,56
33531,50,119,2005,11158,5790,5368
33532,50,40,2005,4927,3018,1909
33533,50,148,2005,1078,590,488
33534,50,120,2005,10714,5833,4881
33535,50,41,2005,310,189,121
33536,50,42,2005,11359,8358,3001
33537,50,68,2005,108012,61860,46152
33538,50,139,2005,229,131,98
33539,50,155,2005,7024,3227,3797
33540,50,15,2005,1704,890,814
33541,50,69,2005,260849,151582,109267
33542,50,156,2005,69890,36478,33412
33543,50,55,2005,8697,4451,4246
33544,50,56,2005,33243,15265,17978
33545,50,84,2005,8806,4753,4053
33546,50,98,2005,678,410,268
33547,50,157,2005,1202,550,652
33548,50,158,2005,1277,654,623
33549,50,110,2005,19685,11529,8156
33550,50,85,2005,220,125,95
33551,50,99,2005,489,305,184
33552,50,32,2005,30066,15188,14878
33553,50,43,2005,1665,920,745
33554,50,5,2005,548130,276771,271359
33555,50,6,2005,58564,24190,34374
33556,50,16,2005,49476,18605,30871
33557,50,44,2005,461897,259447,202450
33558,50,45,2005,7702,3938,3764
33559,50,17,2005,13882,6655,7227
33560,50,57,2005,114477,55737,58740
33561,50,86,2005,141608,77981,63627
33562,50,177,2005,34522,21736,12786
33563,50,18,2005,4136,1586,2550
33564,50,167,2005,2725,1711,1014
33565,50,121,2005,124549,63355,61194
33566,50,19,2005,8721,3749,4972
33567,50,168,2005,545,359,186
33568,50,46,2005,30163,16361,13802
33569,50,20,2005,12153,5163,6990
33570,50,149,2005,516,311,205
33571,50,159,2005,2371,1026,1345
33572,50,143,2005,11782,5079,6703
33573,50,70,2005,26,19,7
33574,50,47,2005,51886,28077,23809
33575,50,71,2005,1457,768,689
33576,50,122,2005,846,561,285
33577,50,123,2005,13347,6881,6466
33578,50,7,2005,263,130,133
33579,50,160,2005,232,99,133
33580,50,58,2005,27539,14474,13065
33581,50,161,2005,113,45,68
33582,50,124,2005,31806,15904,15902
33583,50,100,2005,6821,3785,3036
33584,50,72,2005,287,126,161
33585,50,59,2005,818,410,408
33586,50,87,2005,7624,4334,3290
33587,50,144,2005,15760,7458,8302
33588,50,125,2005,4273,2303,1970
33589,50,150,2005,1704,907,797
33590,50,8,2005,26091,11287,14804
33591,50,73,2005,47969,25817,22152
33592,50,101,2005,279,171,108
33593,50,162,2005,133246,65726,67520
33594,50,60,2005,1948,1137,811
33595,50,48,2005,14181,8413,5768
33596,50,21,2005,2401,1038,1363
33597,50,9,2005,379494,184643,194851
33598,50,102,2005,556,326,230
33599,50,111,2005,581,322,259
33600,50,112,2005,5209,3279,1930
33601,50,33,2005,328135,167457,160678
33602,50,61,2005,59174,30183,28991
33603,50,22,2005,1647,666,981
33604,50,35,2005,41686,20905,20781
33605,50,36,2005,25383,16681,8702
33606,50,126,2005,3141,1749,1392
33607,50,90,2005,5610,3014,2596
33608,50,91,2005,8029,4420,3609
33609,50,92,2005,6704,3491,3213
33610,50,140,2005,480,305,175
33611,50,23,2005,19498,8382,11116
33612,50,164,2005,1247,545,702
33613,50,63,2005,19717,10691,9026
33614,50,127,2005,3002,1818,1184
33615,50,165,2005,18691,10203,8488
33616,50,37,2005,31366,17683,13683
33617,50,64,2005,1552,952,600
33618,50,128,2005,67445,37798,29647
33619,50,115,2005,158876,83048,75828
33620,50,65,2005,64159,36491,27668
33621,50,10,2005,90699,41449,49250
33622,50,145,2005,13378,5781,7597
33623,50,113,2005,326,197,129
33624,50,49,2005,25396,16141,9255
33625,50,74,2005,16582,9972,6610
33626,50,25,2005,6178,2421,3757
33627,50,169,2005,241,133,108
33628,50,166,2005,998,429,569
33629,50,93,2005,20689,12759,7930
33630,50,146,2005,4242,1367,2875
33631,50,26,2005,68149,30613,37536
33632,50,170,2005,379,233,146
33633,50,94,2005,108,56,52
33634,50,130,2005,53515,27247,26268
33635,50,38,2005,15510,8378,7132
33636,50,27,2005,7760,3373,4387
33637,50,131,2005,31636,15895,15741
33638,50,114,2005,1077,582,495
33639,50,171,2005,1465,773,692
33640,50,1,2005,24657,13444,11213
33641,50,28,2005,14073,6293,7780
33642,50,132,2005,23164,12573,10591
33643,50,133,2005,79684,43766,35918
33644,114,103,2005,25992,14501,11491
33645,114,105,2005,12923,7662,5261
33646,114,106,2005,1347,699,648
33647,114,68,2005,493,255,238
33648,114,69,2005,1447,782,665
33649,114,57,2005,8155,3682,4473
33650,114,100,2005,557,308,249
33651,114,111,2005,1074,726,348
33652,114,112,2005,96,30,66
33653,114,33,2005,1220,682,538
33654,114,61,2005,586,281,305
33655,114,35,2005,639,333,306
33656,114,65,2005,18858,10219,8639
33657,114,50,2005,475,273,202
33658,171,12,2005,22504,11126,11378
33659,171,11,2005,7039,3560,3479
33660,171,29,2005,28636,15254,13382
33661,171,69,2005,9362,5156,4206
33662,171,167,2005,18166,10384,7782
33663,171,168,2005,5201,2953,2248
33664,171,36,2005,980674,551109,429565
33665,171,169,2005,42216,24018,18198
33666,171,170,2005,810,344,466
33667,171,38,2005,132963,73270,59693
33668,1,3,2005,4129,1730,2399
33669,1,10,2005,151,60,91
33670,1,172,2005,2661,1057,1604
33671,1,68,2005,145,40,105
33672,1,5,2005,1143,448,695
33673,1,177,2005,809,271,538
33674,1,176,2005,867,352,515
33675,1,8,2005,1375,589,786
33676,1,9,2005,338,141,197
33677,1,50,2005,2803,1193,1610
33678,28,120,2005,1916,802,1114
33679,28,119,2005,789,298,491
33680,28,6,2005,0,0,0
33681,28,16,2005,6731,3078,3653
33682,28,1,2005,0,0,0
33683,28,128,2005,92022,35655,56367
33684,28,129,2005,0,0,0
33685,28,145,2005,21394,10047,11347
33686,28,25,2005,2578,1216,1362
33687,28,142,2005,9808,4667,5141
33688,132,134,2005,98687,49293,49394
33689,132,147,2005,319,198,121
33690,132,116,2005,3825,1884,1941
33691,132,135,2005,66,11,55
33692,132,172,2005,408,113,295
33693,132,137,2005,5632,3634,1998
33694,132,137,2005,73742,35947,37795
33695,132,68,2005,62,22,40
33696,132,69,2005,209,91,118
33697,132,156,2005,170,50,120
33698,132,5,2005,4007,1967,2040
33699,132,177,2005,113,35,78
33700,132,121,2005,364,131,233
33701,132,123,2005,9665,3711,5954
33702,132,160,2005,205,49,156
33703,132,125,2005,842,432,410
33704,132,150,2005,251,114,137
33705,132,162,2005,263,76,187
33706,132,126,2005,6873,3356,3517
33707,132,164,2005,153,21,132
33708,132,115,2005,2170,1053,1117
33709,132,133,2005,12444,6334,6110
33710,132,130,2005,355,137,218
33711,132,142,2005,116,48,68
33712,132,50,2005,1154,520,634
33713,132,131,2005,5057,2458,2599
33714,133,147,2005,4134,1776,2358
33715,133,123,2005,102211,44086,58125
33716,133,125,2005,145402,62449,82953
33717,133,115,2005,19010,8168,10842
33718,133,50,2005,19394,8333,11061
33719,133,132,2005,29759,12589,17170
33720,2,9,2010,47984,20902,27082
33721,2,169,2010,23991,10450,13541
33722,2,171,2010,1199,522,677
33723,51,56,2010,32054,16671,15383
33724,51,57,2010,9025,4174,4851
33725,51,26,2010,1990,625,1365
33726,51,60,2010,542,276,266
33727,141,68,2010,482,275,207
33728,141,69,2010,675,450,225
33729,141,16,2010,6584,3449,3135
33730,141,57,2010,642,396,246
33731,141,18,2010,1961,929,1032
33732,141,19,2010,1039,359,680
33733,141,20,2010,1063,653,410
33734,141,143,2010,2019,959,1060
33735,141,36,2010,696,408,288
33736,141,23,2010,3409,1317,2092
33737,141,128,2010,10050,4533,5517
33738,141,145,2010,1386,653,733
33739,141,25,2010,2669,1264,1405
33740,141,50,2010,694,404,290
33741,141,28,2010,2054,871,1183
33742,52,103,2010,819,387,432
33743,52,67,2010,231,109,122
33744,52,106,2010,230,109,121
33745,52,39,2010,121,57,64
33746,52,68,2010,4796,2263,2533
33747,52,69,2010,392,185,207
33748,52,57,2010,527,249,278
33749,52,144,2010,556,263,293
33750,52,73,2010,257,122,135
33751,52,61,2010,13686,6459,7227
33752,52,65,2010,25929,12237,13692
33753,52,49,2010,53,25,28
33754,52,74,2010,87,41,46
33755,52,50,2010,1125,531,594
33756,52,114,2010,122,57,65
33757,134,153,2010,7558,3909,3649
33758,134,136,2010,27,16,11
33759,134,137,2010,870,523,347
33760,134,137,2010,31210,16544,14666
33761,134,157,2010,277,162,115
33762,134,125,2010,205,106,99
33763,134,150,2010,732,387,345
33764,134,61,2010,6384,3193,3191
33765,134,126,2010,879,511,368
33766,134,140,2010,6593,3563,3030
33767,134,115,2010,5162,2736,2426
33768,134,132,2010,254,164,90
33769,75,83,2010,610,218,392
33770,75,110,2010,357,147,210
33771,75,86,2010,433,186,247
33772,75,87,2010,266,79,187
33773,75,90,2010,843,295,548
33774,75,50,2010,390,257,133
33775,76,78,2010,2,1,1
33776,76,79,2010,284,117,167
33777,76,95,2010,13,6,7
33778,76,172,2010,126,65,61
33779,76,81,2010,19,10,9
33780,76,82,2010,4462,2496,1966
33781,76,83,2010,1678,1046,632
33782,76,120,2010,85,46,39
33783,76,68,2010,39,21,18
33784,76,109,2010,5,2,3
33785,76,69,2010,78,40,38
33786,76,156,2010,29,15,14
33787,76,84,2010,181,80,101
33788,76,110,2010,6086,3365,2721
33789,76,85,2010,31,16,15
33790,76,99,2010,7,3,4
33791,76,5,2010,74,38,36
33792,76,57,2010,68,34,34
33793,76,86,2010,3752,2499,1253
33794,76,177,2010,19,10,9
33795,76,20,2010,52,26,26
33796,76,100,2010,5,2,3
33797,76,87,2010,1070,532,538
33798,76,73,2010,15,8,7
33799,76,77,2010,5,2,3
33800,76,162,2010,38,21,17
33801,76,9,2010,0,0,0
33802,76,88,2010,50,25,25
33803,76,90,2010,448,239,209
33804,76,75,2010,37,19,18
33805,76,91,2010,636,361,275
33806,76,92,2010,863,348,515
33807,76,115,2010,42,23,19
33808,76,65,2010,11,6,5
33809,76,113,2010,42,23,19
33810,76,25,2010,229,118,111
33811,76,93,2010,677,350,327
33812,76,94,2010,6,3,3
33813,76,142,2010,9,5,4
33814,76,50,2010,935,476,459
33815,103,2,2010,9,7,2
33816,103,51,2010,66,27,39
33817,103,141,2010,104,40,64
33818,103,52,2010,1,0,1
33819,103,134,2010,9,6,3
33820,103,66,2010,1019,549,470
33821,103,13,2010,12,4,8
33822,103,11,2010,559,268,291
33823,103,79,2010,7,6,1
33824,103,67,2010,535,269,266
33825,103,105,2010,42283,24446,17837
33826,103,95,2010,6,5,1
33827,103,30,2010,294,156,138
33828,103,29,2010,303,162,141
33829,103,153,2010,24,14,10
33830,103,10,2010,2,0,2
33831,103,106,2010,184687,99504,85183
33832,103,172,2010,12476,5792,6684
33833,103,107,2010,1722,858,864
33834,103,137,2010,42,20,22
33835,103,96,2010,123,55,68
33836,103,54,2010,983,482,501
33837,103,81,2010,1102,509,593
33838,103,14,2010,47,24,23
33839,103,31,2010,1787,1068,719
33840,103,39,2010,244,125,119
33841,103,82,2010,4,4,0
33842,103,83,2010,682,497,185
33843,103,108,2010,952,474,478
33844,103,97,2010,73,36,37
33845,103,120,2010,32,17,15
33846,103,40,2010,49,31,18
33847,103,42,2010,70,48,22
33848,103,68,2010,7071,3501,3570
33849,103,69,2010,8009,4286,3723
33850,103,55,2010,14,9,5
33851,103,56,2010,1014,508,506
33852,103,84,2010,11,10,1
33853,103,98,2010,96,48,48
33854,103,157,2010,1,1,0
33855,103,85,2010,41,11,30
33856,103,99,2010,66,34,32
33857,103,173,2010,4,0,4
33858,103,32,2010,813,438,375
33859,103,43,2010,8,7,1
33860,103,5,2010,97,52,45
33861,103,6,2010,137,63,74
33862,103,16,2010,37,20,17
33863,103,44,2010,64,29,35
33864,103,17,2010,555,268,287
33865,103,57,2010,132014,74987,57027
33866,103,86,2010,11,0,11
33867,103,177,2010,3859,2010,1849
33868,103,18,2010,73,24,49
33869,103,121,2010,2,2,0
33870,103,176,2010,14,0,14
33871,103,20,2010,788,425,363
33872,103,46,2010,124,77,47
33873,103,143,2010,51,18,33
33874,103,70,2010,78,27,51
33875,103,47,2010,391,236,155
33876,103,71,2010,96,67,29
33877,103,122,2010,7,5,2
33878,103,58,2010,2,2,0
33879,103,100,2010,1445,693,752
33880,103,72,2010,10,9,1
33881,103,144,2010,211,119,92
33882,103,125,2010,11,10,1
33883,103,150,2010,2,0,2
33884,103,73,2010,386,169,217
33885,103,77,2010,1,1,0
33886,103,101,2010,91,43,48
33887,103,162,2010,43,29,14
33888,103,48,2010,58,13,45
33889,103,9,2010,5,0,5
33890,103,102,2010,160,68,92
33891,103,111,2010,588452,326431,262021
33892,103,112,2010,169262,92398,76864
33893,103,33,2010,6339,3507,2832
33894,103,61,2010,4299,2072,2227
33895,103,88,2010,75,41,34
33896,103,35,2010,1074,572,502
33897,103,36,2010,1878,987,891
33898,103,62,2010,16,2,14
33899,103,23,2010,80,29,51
33900,103,1,2010,5,2,3
33901,103,64,2010,807,401,406
33902,103,128,2010,2,0,2
33903,103,115,2010,126,64,62
33904,103,133,2010,2,2,0
33905,103,65,2010,84969,48618,36351
33906,103,145,2010,8,0,8
33907,103,113,2010,5,5,0
33908,103,49,2010,203,98,105
33909,103,74,2010,791,372,419
33910,103,25,2010,1121,531,590
33911,103,93,2010,34,11,23
33912,103,146,2010,45,14,31
33913,103,26,2010,633,311,322
33914,103,130,2010,1,1,0
33915,103,38,2010,3820,1943,1877
33916,103,60,2010,1484,796,688
33917,103,142,2010,237,103,134
33918,103,50,2010,940,470,470
33919,103,131,2010,1,0,1
33920,103,152,2010,11,9,2
33921,103,114,2010,115039,60542,54497
33922,103,132,2010,1,0,1
33923,11,12,2010,130855,76693,54162
33924,11,29,2010,410,252,158
33925,11,15,2010,25767,15828,9939
33926,11,69,2010,422,212,210
33927,11,56,2010,1143,634,509
33928,11,6,2010,6172,3171,3001
33929,11,16,2010,888,519,369
33930,11,167,2010,503,341,162
33931,11,20,2010,722,386,336
33932,11,36,2010,11216,7594,3622
33933,11,25,2010,2062,1080,982
33934,11,26,2010,1250,814,436
33935,11,170,2010,525,328,197
33936,11,38,2010,1657,1228,429
33937,11,171,2010,736,484,252
33938,77,172,2010,1072,521,551
33939,77,107,2010,9280,5699,3581
33940,77,82,2010,103,71,32
33941,77,83,2010,4114,2569,1545
33942,77,84,2010,246,183,63
33943,77,110,2010,276,145,131
33944,77,85,2010,1552,986,566
33945,77,5,2010,315,107,208
33946,77,86,2010,710,478,232
33947,77,73,2010,4359,2106,2253
33948,77,101,2010,103,55,48
33949,77,112,2010,1079,529,550
33950,77,61,2010,157,78,79
33951,77,92,2010,108,83,25
33952,77,113,2010,1272,674,598
33953,77,26,2010,11,3,8
33954,66,2,2010,10055,3338,6717
33955,66,51,2010,2681,1367,1314
33956,66,141,2010,1100,267,833
33957,66,52,2010,1,0,1
33958,66,134,2010,291,134,157
33959,66,76,2010,5,5,0
33960,66,103,2010,1297,653,644
33961,66,11,2010,2600,1301,1299
33962,66,77,2010,0,0,0
33963,66,12,2010,916,449,467
33964,66,78,2010,18,9,9
33965,66,13,2010,17,9,8
33966,66,3,2010,2332,787,1545
33967,66,79,2010,17,9,8
33968,66,29,2010,1420,1066,354
33969,66,67,2010,2194,1161,1033
33970,66,95,2010,34,18,16
33971,66,151,2010,67,22,45
33972,66,4,2010,20,9,11
33973,66,53,2010,132222,65529,66693
33974,66,147,2010,21,13,8
33975,66,105,2010,4419,2904,1515
33976,66,30,2010,13407,7663,5744
33977,66,152,2010,103,46,57
33978,66,116,2010,82,34,48
33979,66,153,2010,34,21,13
33980,66,135,2010,557,210,347
33981,66,80,2010,0,0,0
33982,66,136,2010,10,4,6
33983,66,106,2010,1072,578,494
33984,66,172,2010,15095,8476,6619
33985,66,173,2010,239,124,115
33986,66,174,2010,13,9,4
33987,66,107,2010,1337,816,521
33988,66,117,2010,0,0,0
33989,66,137,2010,390,175,215
33990,66,96,2010,152,97,55
33991,66,54,2010,34090,18147,15943
33992,66,81,2010,750,531,219
33993,66,14,2010,276,131,145
33994,66,31,2010,46865,29275,17590
33995,66,176,2010,2397,1519,878
33996,66,137,2010,597,271,326
33997,66,39,2010,1208,696,512
33998,66,118,2010,5,2,3
33999,66,82,2010,42,32,10
34000,66,83,2010,2663,1919,744
34001,66,108,2010,563,321,242
34002,66,142,2010,12690,4717,7973
34003,66,97,2010,57,34,23
34004,66,138,2010,8,4,4
34005,66,119,2010,88,50,38
34006,66,40,2010,318,238,80
34007,66,148,2010,19,13,6
34008,66,120,2010,1088,647,441
34009,66,41,2010,0,0,0
34010,66,42,2010,1361,1002,359
34011,66,68,2010,7639,4245,3394
34012,66,139,2010,20,8,12
34013,66,155,2010,536,56,480
34014,66,15,2010,2825,1379,1446
34015,66,69,2010,190769,104412,86357
34016,66,156,2010,2108,907,1201
34017,66,55,2010,0,0,0
34018,66,56,2010,3411,1248,2163
34019,66,84,2010,12,8,4
34020,66,98,2010,318,159,159
34021,66,157,2010,257,55,202
34022,66,158,2010,57,7,50
34023,66,110,2010,15,13,2
34024,66,85,2010,53,31,22
34025,66,99,2010,83,50,33
34026,66,32,2010,37893,20897,16996
34027,66,43,2010,160,90,70
34028,66,5,2010,11569,4884,6685
34029,66,6,2010,13205,5824,7381
34030,66,16,2010,4707,1799,2908
34031,66,44,2010,840,379,461
34032,66,17,2010,2184,969,1215
34033,66,57,2010,25341,12600,12741
34034,66,86,2010,177,103,74
34035,66,177,2010,2530,1810,720
34036,66,18,2010,638,198,440
34037,66,167,2010,940,594,346
34038,66,121,2010,837,575,262
34039,66,19,2010,215,79,136
34040,66,168,2010,552,371,181
34041,66,46,2010,688,483,205
34042,66,20,2010,1570,637,933
34043,66,149,2010,3,3,0
34044,66,159,2010,233,38,195
34045,66,143,2010,392,162,230
34046,66,70,2010,322,200,122
34047,66,47,2010,775,521,254
34048,66,71,2010,650,308,342
34049,66,122,2010,63,47,16
34050,66,123,2010,32,16,16
34051,66,7,2010,7,2,5
34052,66,160,2010,84,23,61
34053,66,58,2010,92,53,39
34054,66,161,2010,28,2,26
34055,66,124,2010,97,52,45
34056,66,100,2010,1287,759,528
34057,66,72,2010,20,12,8
34058,66,59,2010,18613,9601,9012
34059,66,144,2010,1641,753,888
34060,66,125,2010,56,32,24
34061,66,150,2010,156,96,60
34062,66,8,2010,500,183,317
34063,66,73,2010,7222,3751,3471
34064,66,101,2010,177,108,69
34065,66,162,2010,7229,2253,4976
34066,66,60,2010,18680,8562,10118
34067,66,48,2010,824,511,313
34068,66,21,2010,26,13,13
34069,66,9,2010,4102,1441,2661
34070,66,102,2010,52,33,19
34071,66,111,2010,194,113,81
34072,66,112,2010,1438,974,464
34073,66,33,2010,56232,30631,25601
34074,66,61,2010,1468,616,852
34075,66,88,2010,4,3,1
34076,66,22,2010,21,9,12
34077,66,35,2010,59878,33606,26272
34078,66,36,2010,26393,15027,11366
34079,66,126,2010,180,83,97
34080,66,90,2010,1,1,0
34081,66,91,2010,11,4,7
34082,66,92,2010,8,4,4
34083,66,62,2010,0,0,0
34084,66,140,2010,1,1,0
34085,66,23,2010,406,171,235
34086,66,164,2010,285,95,190
34087,66,63,2010,166318,86078,80240
34088,66,127,2010,36,22,14
34089,66,165,2010,228,54,174
34090,66,37,2010,23153,15116,8037
34091,66,64,2010,15259,8609,6650
34092,66,128,2010,1500,601,899
34093,66,115,2010,2380,1349,1031
34094,66,65,2010,3512,1930,1582
34095,66,10,2010,836,386,450
34096,66,145,2010,541,145,396
34097,66,113,2010,16,8,8
34098,66,49,2010,3026,1793,1233
34099,66,74,2010,13466,7380,6086
34100,66,25,2010,2828,1072,1756
34101,66,169,2010,242,138,104
34102,66,166,2010,186,71,115
34103,66,93,2010,58,36,22
34104,66,146,2010,3145,962,2183
34105,66,26,2010,157450,73621,83829
34106,66,170,2010,119,80,39
34107,66,130,2010,233,112,121
34108,66,38,2010,7014,5021,1993
34109,66,27,2010,149,81,68
34110,66,50,2010,9384,4430,4954
34111,66,131,2010,133,66,67
34112,66,114,2010,240,133,107
34113,66,171,2010,643,362,281
34114,66,1,2010,2849,1539,1310
34115,66,28,2010,80,33,47
34116,66,132,2010,96,57,39
34117,66,133,2010,254,131,123
34118,12,2,2010,195,57,138
34119,12,11,2010,155685,78311,77374
34120,12,29,2010,481,373,108
34121,12,40,2010,509,273,236
34122,12,15,2010,53614,28296,25318
34123,12,69,2010,299,170,129
34124,12,6,2010,1604,600,1004
34125,12,167,2010,3797,2258,1539
34126,12,168,2010,2680,1412,1268
34127,12,36,2010,30151,20746,9405
34128,12,169,2010,261,158,103
34129,12,26,2010,2224,582,1642
34130,12,170,2010,1808,1031,777
34131,12,38,2010,2953,2200,753
34132,12,171,2010,17853,9441,8412
34133,78,76,2010,13,7,6
34134,78,103,2010,102,35,67
34135,78,66,2010,37,18,19
34136,78,79,2010,220,79,141
34137,78,67,2010,28,11,17
34138,78,147,2010,13,5,8
34139,78,105,2010,112,58,54
34140,78,95,2010,41,27,14
34141,78,30,2010,19,5,14
34142,78,80,2010,21,9,12
34143,78,10,2010,36,16,20
34144,78,106,2010,32,18,14
34145,78,172,2010,159,67,92
34146,78,107,2010,178,72,106
34147,78,96,2010,50,30,20
34148,78,81,2010,370,253,117
34149,78,39,2010,15,8,7
34150,78,82,2010,69,37,32
34151,78,83,2010,269,109,160
34152,78,108,2010,40,14,26
34153,78,97,2010,67,5,62
34154,78,40,2010,15,9,6
34155,78,68,2010,132,47,85
34156,78,69,2010,267,137,130
34157,78,156,2010,44,8,36
34158,78,56,2010,84,29,55
34159,78,84,2010,30,17,13
34160,78,98,2010,32,17,15
34161,78,110,2010,1232,691,541
34162,78,85,2010,25465,10948,14517
34163,78,99,2010,40,8,32
34164,78,173,2010,24,13,11
34165,78,5,2010,552,240,312
34166,78,44,2010,54,25,29
34167,78,57,2010,146,49,97
34168,78,86,2010,6925,4789,2136
34169,78,177,2010,32,25,7
34170,78,121,2010,19,12,7
34171,78,100,2010,124,45,79
34172,78,73,2010,50,21,29
34173,78,101,2010,9,4,5
34174,78,162,2010,148,71,77
34175,78,48,2010,11,7,4
34176,78,9,2010,0,0,0
34177,78,102,2010,48,32,16
34178,78,112,2010,290,161,129
34179,78,33,2010,18,12,6
34180,78,61,2010,15,3,12
34181,78,35,2010,94,4,90
34182,78,36,2010,52,42,10
34183,78,90,2010,31,19,12
34184,78,91,2010,72,36,36
34185,78,92,2010,37,10,27
34186,78,115,2010,96,45,51
34187,78,133,2010,14,7,7
34188,78,65,2010,102,21,81
34189,78,148,2010,11,6,5
34190,78,49,2010,27,14,13
34191,78,74,2010,283,195,88
34192,78,93,2010,360,193,167
34193,78,94,2010,1426,846,580
34194,78,130,2010,11,8,3
34195,78,38,2010,17,13,4
34196,78,142,2010,29,12,17
34197,78,50,2010,1839,773,1066
34198,78,114,2010,16,7,9
34199,13,2,2010,613,199,414
34200,13,3,2010,81920,11174,70746
34201,13,10,2010,9019,4187,4832
34202,13,136,2010,401,129,272
34203,13,120,2010,826,269,557
34204,13,119,2010,1448,470,978
34205,13,68,2010,1361,525,836
34206,13,5,2010,259915,62917,196998
34207,13,18,2010,12651,4591,8060
34208,13,19,2010,5054,1657,3397
34209,13,20,2010,3142,1022,2120
34210,13,144,2010,669,218,451
34211,13,8,2010,2095,680,1415
34212,13,73,2010,236,95,141
34213,13,162,2010,1179,385,794
34214,13,9,2010,74535,17296,57239
34215,13,22,2010,201,132,69
34216,13,23,2010,492,156,336
34217,13,128,2010,727,237,490
34218,13,129,2010,1190,433,757
34219,13,145,2010,9955,3626,6329
34220,13,25,2010,3954,1287,2667
34221,13,27,2010,5663,2708,2955
34222,13,146,2010,440,143,297
34223,13,26,2010,2853,929,1924
34224,13,142,2010,67374,23313,44061
34225,13,50,2010,2181,773,1408
34226,13,28,2010,15381,5003,10378
34227,3,13,2010,28471,13096,15375
34228,3,105,2010,14083,6478,7605
34229,3,172,2010,160252,73715,86537
34230,3,5,2010,32301,14858,17443
34231,3,177,2010,13041,5998,7043
34232,3,8,2010,33308,15321,17987
34233,3,48,2010,13509,6214,7295
34234,3,1,2010,25830,11881,13949
34235,3,50,2010,31619,14544,17075
34236,79,76,2010,185,107,78
34237,79,78,2010,47,27,20
34238,79,95,2010,21,11,10
34239,79,172,2010,41,18,23
34240,79,81,2010,56,28,28
34241,79,82,2010,321,214,107
34242,79,84,2010,371,238,133
34243,79,110,2010,6277,3332,2945
34244,79,85,2010,32,22,10
34245,79,5,2010,441,226,215
34246,79,86,2010,947,619,328
34247,79,90,2010,104,58,46
34248,79,91,2010,2073,1250,823
34249,79,92,2010,2964,1772,1192
34250,79,113,2010,45,34,11
34251,79,93,2010,1419,900,519
34252,79,50,2010,2389,1349,1040
34253,29,2,2010,270,85,185
34254,29,141,2010,50,9,41
34255,29,12,2010,13611,5765,7846
34256,29,103,2010,99,63,36
34257,29,66,2010,56,40,16
34258,29,11,2010,5779,2315,3464
34259,29,67,2010,35,14,21
34260,29,105,2010,89,65,24
34261,29,30,2010,58,27,31
34262,29,81,2010,43,3,40
34263,29,31,2010,91,63,28
34264,29,39,2010,190,77,113
34265,29,120,2010,23,1,22
34266,29,40,2010,3099,2045,1054
34267,29,42,2010,2017,1082,935
34268,29,15,2010,8583,3629,4954
34269,29,69,2010,62,29,33
34270,29,56,2010,104,70,34
34271,29,32,2010,327,204,123
34272,29,5,2010,46,9,37
34273,29,6,2010,47,10,37
34274,29,44,2010,21,16,5
34275,29,17,2010,370,198,172
34276,29,57,2010,21,3,18
34277,29,167,2010,70573,36553,34020
34278,29,18,2010,28,1,27
34279,29,176,2010,57,40,17
34280,29,168,2010,5279,2727,2552
34281,29,20,2010,61,0,61
34282,29,46,2010,10019,7073,2946
34283,29,47,2010,16612,12228,4384
34284,29,48,2010,58,25,33
34285,29,9,2010,45,0,45
34286,29,33,2010,456,246,210
34287,29,35,2010,20,13,7
34288,29,36,2010,688372,380692,307680
34289,29,63,2010,34,13,21
34290,29,37,2010,25,16,9
34291,29,1,2010,351,184,167
34292,29,65,2010,34,17,17
34293,29,49,2010,324,155,169
34294,29,74,2010,27,16,11
34295,29,25,2010,79,0,79
34296,29,169,2010,5729,2801,2928
34297,29,27,2010,20,11,9
34298,29,26,2010,23,1,22
34299,29,170,2010,5513,2823,2690
34300,29,38,2010,227722,117586,110136
34301,29,50,2010,441,277,164
34302,29,114,2010,26,22,4
34303,29,171,2010,14919,7707,7212
34304,29,28,2010,30,6,24
34305,67,2,2010,4242,1676,2566
34306,67,51,2010,6129,3019,3110
34307,67,141,2010,22372,9833,12539
34308,67,52,2010,39,19,20
34309,67,134,2010,4804,2328,2476
34310,67,76,2010,2,1,1
34311,67,103,2010,1969,1043,926
34312,67,11,2010,846,386,460
34313,67,66,2010,3250,1901,1349
34314,67,12,2010,122,53,69
34315,67,78,2010,13,5,8
34316,67,13,2010,55,24,31
34317,67,3,2010,1961,762,1199
34318,67,79,2010,24,15,9
34319,67,29,2010,366,168,198
34320,67,95,2010,10,5,5
34321,67,151,2010,900,366,534
34322,67,4,2010,272,78,194
34323,67,53,2010,267,118,149
34324,67,147,2010,30,13,17
34325,67,105,2010,9222,5520,3702
34326,67,30,2010,14355,7316,7039
34327,67,152,2010,868,418,450
34328,67,116,2010,5827,3234,2593
34329,67,153,2010,582,325,257
34330,67,135,2010,9675,5019,4656
34331,67,80,2010,0,0,0
34332,67,136,2010,362,158,204
34333,67,106,2010,4002,2082,1920
34334,67,172,2010,15591,9176,6415
34335,67,107,2010,4836,2842,1994
34336,67,117,2010,69,42,27
34337,67,137,2010,4151,2165,1986
34338,67,96,2010,232,132,100
34339,67,54,2010,109,62,47
34340,67,81,2010,1397,885,512
34341,67,14,2010,382,185,197
34342,67,31,2010,347,172,175
34343,67,176,2010,73,39,34
34344,67,137,2010,76139,40546,35593
34345,67,39,2010,2617,1416,1201
34346,67,118,2010,687,338,349
34347,67,82,2010,101,71,30
34348,67,83,2010,2005,1285,720
34349,67,108,2010,4356,2609,1747
34350,67,142,2010,3194,987,2207
34351,67,97,2010,386,220,166
34352,67,138,2010,39,28,11
34353,67,119,2010,13,8,5
34354,67,40,2010,511,362,149
34355,67,148,2010,58,37,21
34356,67,120,2010,2561,1279,1282
34357,67,42,2010,2816,1822,994
34358,67,68,2010,171198,95265,75933
34359,67,139,2010,545,277,268
34360,67,155,2010,435,176,259
34361,67,15,2010,262,129,133
34362,67,69,2010,84012,46286,37726
34363,67,156,2010,6263,3011,3252
34364,67,55,2010,9,3,6
34365,67,56,2010,14217,7139,7078
34366,67,84,2010,3,1,2
34367,67,98,2010,745,392,353
34368,67,157,2010,5147,2213,2934
34369,67,158,2010,171,76,95
34370,67,110,2010,79,47,32
34371,67,85,2010,1821,1025,796
34372,67,99,2010,173,116,57
34373,67,32,2010,6738,3667,3071
34374,67,43,2010,175,99,76
34375,67,5,2010,15220,7428,7792
34376,67,6,2010,8564,3760,4804
34377,67,16,2010,5144,1905,3239
34378,67,44,2010,2982,1550,1432
34379,67,17,2010,3426,1444,1982
34380,67,57,2010,120395,58491,61904
34381,67,86,2010,338,216,122
34382,67,177,2010,4829,2648,2181
34383,67,18,2010,788,281,507
34384,67,167,2010,773,384,389
34385,67,121,2010,1095,673,422
34386,67,19,2010,175,60,115
34387,67,168,2010,223,101,122
34388,67,46,2010,676,455,221
34389,67,20,2010,5218,2002,3216
34390,67,149,2010,16,13,3
34391,67,159,2010,692,232,460
34392,67,143,2010,461,200,261
34393,67,70,2010,11,6,5
34394,67,47,2010,989,649,340
34395,67,71,2010,12315,6668,5647
34396,67,122,2010,1772,1282,490
34397,67,123,2010,62,30,32
34398,67,7,2010,4,2,2
34399,67,160,2010,617,287,330
34400,67,58,2010,360,197,163
34401,67,161,2010,1348,260,1088
34402,67,124,2010,3091,2377,714
34403,67,100,2010,1869,1146,723
34404,67,72,2010,124,71,53
34405,67,59,2010,1,0,1
34406,67,144,2010,178785,85265,93520
34407,67,125,2010,351,187,164
34408,67,150,2010,46,29,17
34409,67,8,2010,1864,789,1075
34410,67,73,2010,124731,62748,61983
34411,67,101,2010,243,125,118
34412,67,162,2010,3947,2055,1892
34413,67,60,2010,488,241,247
34414,67,48,2010,1296,701,595
34415,67,21,2010,21,7,14
34416,67,9,2010,8705,3226,5479
34417,67,102,2010,140,93,47
34418,67,111,2010,358,221,137
34419,67,112,2010,3072,1964,1108
34420,67,33,2010,51711,29431,22280
34421,67,61,2010,27515,13488,14027
34422,67,22,2010,26,10,16
34423,67,35,2010,30622,15379,15243
34424,67,36,2010,4576,2159,2417
34425,67,126,2010,11993,6597,5396
34426,67,90,2010,0,0,0
34427,67,91,2010,13,8,5
34428,67,92,2010,5,2,3
34429,67,62,2010,16,10,6
34430,67,140,2010,40,22,18
34431,67,23,2010,280,135,145
34432,67,164,2010,3226,1461,1765
34433,67,63,2010,1040,552,488
34434,67,127,2010,87,55,32
34435,67,165,2010,1245,431,814
34436,67,37,2010,697,338,359
34437,67,64,2010,101,50,51
34438,67,128,2010,1658,793,865
34439,67,115,2010,3369,1769,1600
34440,67,65,2010,36970,20188,16782
34441,67,10,2010,1196,580,616
34442,67,145,2010,645,215,430
34443,67,113,2010,1111,640,471
34444,67,49,2010,3871,2121,1750
34445,67,74,2010,4844,2668,2176
34446,67,25,2010,4407,1775,2632
34447,67,169,2010,31,12,19
34448,67,166,2010,3725,1525,2200
34449,67,93,2010,82,51,31
34450,67,146,2010,11453,4059,7394
34451,67,26,2010,93502,45275,48227
34452,67,170,2010,3,1,2
34453,67,130,2010,522,267,255
34454,67,38,2010,688,312,376
34455,67,27,2010,218,111,107
34456,67,50,2010,23737,11394,12343
34457,67,131,2010,450,226,224
34458,67,114,2010,432,217,215
34459,67,171,2010,343,172,171
34460,67,1,2010,7904,4366,3538
34461,67,28,2010,98,32,66
34462,67,132,2010,325,184,141
34463,67,133,2010,457,228,229
34464,95,172,2010,1737,779,958
34465,95,97,2010,7486,3627,3859
34466,95,69,2010,58,21,37
34467,95,98,2010,19995,10272,9723
34468,95,85,2010,46,21,25
34469,95,99,2010,7313,3620,3693
34470,95,173,2010,61,29,32
34471,95,5,2010,502,225,277
34472,95,86,2010,421,164,257
34473,95,20,2010,46,13,33
34474,95,100,2010,2988,1402,1586
34475,95,162,2010,38,6,32
34476,95,50,2010,347,134,213
34477,151,136,2010,780,308,472
34478,151,137,2010,2942,1458,1484
34479,151,68,2010,1161,587,574
34480,151,156,2010,12065,7000,5065
34481,151,160,2010,2490,1024,1466
34482,151,162,2010,67553,33624,33929
34483,151,166,2010,85781,56501,29280
34484,151,152,2010,10751,4749,6002
34485,4,3,2010,49,16,33
34486,4,10,2010,31,15,16
34487,4,172,2010,858,410,448
34488,4,39,2010,36,12,24
34489,4,68,2010,29,15,14
34490,4,69,2010,25,11,14
34491,4,5,2010,42383,7322,35061
34492,4,57,2010,12,4,8
34493,4,177,2010,120,44,76
34494,4,8,2010,679,238,441
34495,4,73,2010,19,6,13
34496,4,9,2010,20,0,20
34497,4,49,2010,22,10,12
34498,4,74,2010,23,5,18
34499,4,50,2010,34,19,15
34500,53,66,2010,211,110,101
34501,53,54,2010,12849,6567,6282
34502,53,68,2010,175,93,82
34503,53,69,2010,558,293,265
34504,53,32,2010,161,110,51
34505,53,57,2010,117,68,49
34506,53,59,2010,4423,2266,2157
34507,53,35,2010,409,321,88
34508,53,36,2010,179,135,44
34509,53,63,2010,10280,5253,5027
34510,53,37,2010,3409,1726,1683
34511,53,64,2010,1973,1191,782
34512,53,60,2010,3097,1639,1458
34513,147,134,2010,672,351,321
34514,147,10,2010,853,412,441
34515,147,172,2010,4111,833,3278
34516,147,137,2010,973,392,581
34517,147,39,2010,298,144,154
34518,147,69,2010,291,161,130
34519,147,5,2010,4863,2026,2837
34520,147,44,2010,541,249,292
34521,147,57,2010,472,169,303
34522,147,121,2010,1043,341,702
34523,147,149,2010,241,171,70
34524,147,122,2010,484,204,280
34525,147,123,2010,1274,482,792
34526,147,124,2010,201,101,100
34527,147,125,2010,522,221,301
34528,147,150,2010,853,261,592
34529,147,73,2010,550,225,325
34530,147,162,2010,1063,512,551
34531,147,48,2010,338,149,189
34532,147,9,2010,402,191,211
34533,147,61,2010,402,158,244
34534,147,127,2010,11,0,11
34535,147,115,2010,4933,2267,2666
34536,147,133,2010,55306,23555,31751
34537,147,148,2010,526,190,336
34538,147,49,2010,377,148,229
34539,147,130,2010,281,111,170
34540,147,50,2010,1133,412,721
34541,147,131,2010,702,311,391
34542,147,132,2010,3800,1685,2115
34543,105,2,2010,58,21,37
34544,105,141,2010,183,91,92
34545,105,52,2010,11,0,11
34546,105,134,2010,6390,3111,3279
34547,105,103,2010,28819,12052,16767
34548,105,66,2010,2319,1272,1047
34549,105,78,2010,16,11,5
34550,105,13,2010,27,0,27
34551,105,3,2010,46,0,46
34552,105,11,2010,53,10,43
34553,105,79,2010,28,21,7
34554,105,67,2010,1680,477,1203
34555,105,53,2010,69,38,31
34556,105,95,2010,6,6,0
34557,105,30,2010,237,118,119
34558,105,116,2010,22,0,22
34559,105,29,2010,9,0,9
34560,105,135,2010,139,59,80
34561,105,153,2010,1185,659,526
34562,105,106,2010,15300,6153,9147
34563,105,172,2010,19232,8822,10410
34564,105,107,2010,6793,3374,3419
34565,105,137,2010,80,9,71
34566,105,137,2010,97,27,70
34567,105,96,2010,384,153,231
34568,105,54,2010,568,350,218
34569,105,81,2010,2060,840,1220
34570,105,31,2010,444,200,244
34571,105,151,2010,27,9,18
34572,105,39,2010,490,159,331
34573,105,82,2010,22,12,10
34574,105,83,2010,310,241,69
34575,105,108,2010,1716,848,868
34576,105,97,2010,227,61,166
34577,105,138,2010,56,42,14
34578,105,120,2010,11,11,0
34579,105,40,2010,181,129,52
34580,105,42,2010,513,241,272
34581,105,68,2010,9478,3492,5986
34582,105,109,2010,702,289,413
34583,105,139,2010,31,0,31
34584,105,15,2010,64,43,21
34585,105,69,2010,16103,6711,9392
34586,105,156,2010,62,20,42
34587,105,56,2010,1528,677,851
34588,105,84,2010,27,5,22
34589,105,98,2010,290,137,153
34590,105,157,2010,58,26,32
34591,105,110,2010,1881,976,905
34592,105,85,2010,55,37,18
34593,105,99,2010,126,51,75
34594,105,32,2010,1513,788,725
34595,105,43,2010,479,160,319
34596,105,5,2010,875,309,566
34597,105,6,2010,531,251,280
34598,105,16,2010,507,183,324
34599,105,44,2010,171,37,134
34600,105,17,2010,1995,785,1210
34601,105,57,2010,36848,15163,21685
34602,105,86,2010,138,22,116
34603,105,177,2010,48639,23790,24849
34604,105,167,2010,25,25,0
34605,105,18,2010,1046,292,754
34606,105,121,2010,46,43,3
34607,105,176,2010,144,57,87
34608,105,19,2010,21,21,0
34609,105,20,2010,12231,4483,7748
34610,105,46,2010,141,112,29
34611,105,159,2010,35,16,19
34612,105,143,2010,96,46,50
34613,105,70,2010,17,0,17
34614,105,47,2010,627,481,146
34615,105,71,2010,54,15,39
34616,105,122,2010,36,32,4
34617,105,123,2010,10,0,10
34618,105,7,2010,10,10,0
34619,105,160,2010,7,0,7
34620,105,58,2010,28,0,28
34621,105,100,2010,2657,1232,1425
34622,105,72,2010,126,80,46
34623,105,59,2010,23,13,10
34624,105,144,2010,504,194,310
34625,105,125,2010,1414,797,617
34626,105,21,2010,20,9,11
34627,105,150,2010,49,10,39
34628,105,8,2010,51,0,51
34629,105,73,2010,3296,960,2336
34630,105,101,2010,365,173,192
34631,105,162,2010,1110,287,823
34632,105,48,2010,570,155,415
34633,105,9,2010,256,107,149
34634,105,102,2010,517,181,336
34635,105,111,2010,38916,20981,17935
34636,105,112,2010,14892,5850,9042
34637,105,33,2010,3453,1785,1668
34638,105,61,2010,136792,67497,69295
34639,105,158,2010,938,315,623
34640,105,35,2010,1692,958,734
34641,105,36,2010,1376,849,527
34642,105,126,2010,14,0,14
34643,105,90,2010,31,5,26
34644,105,91,2010,145,97,48
34645,105,92,2010,30,30,0
34646,105,62,2010,35,35,0
34647,105,140,2010,59,46,13
34648,105,23,2010,326,90,236
34649,105,164,2010,185,22,163
34650,105,63,2010,430,279,151
34651,105,127,2010,30,0,30
34652,105,165,2010,7,0,7
34653,105,37,2010,211,110,101
34654,105,1,2010,127,45,82
34655,105,64,2010,176,80,96
34656,105,115,2010,1574,453,1121
34657,105,133,2010,102,44,58
34658,105,65,2010,30473,13781,16692
34659,105,113,2010,271,114,157
34660,105,49,2010,630,205,425
34661,105,74,2010,2960,964,1996
34662,105,25,2010,2045,870,1175
34663,105,169,2010,8,0,8
34664,105,166,2010,10,0,10
34665,105,93,2010,187,103,84
34666,105,27,2010,33,0,33
34667,105,146,2010,80,13,67
34668,105,26,2010,360,117,243
34669,105,170,2010,22,16,6
34670,105,130,2010,65,29,36
34671,105,38,2010,728,417,311
34672,105,60,2010,39,15,24
34673,105,142,2010,3090,1441,1649
34674,105,50,2010,4905,1892,3013
34675,105,131,2010,88,37,51
34676,105,152,2010,26,15,11
34677,105,114,2010,23843,11605,12238
34678,105,171,2010,27,26,1
34679,30,2,2010,2450,505,1945
34680,30,51,2010,1028,490,538
34681,30,141,2010,350,163,187
34682,30,52,2010,1,0,1
34683,30,134,2010,6,4,2
34684,30,75,2010,35,13,22
34685,30,76,2010,5,1,4
34686,30,103,2010,107,59,48
34687,30,11,2010,1334,700,634
34688,30,77,2010,5,1,4
34689,30,66,2010,184,75,109
34690,30,12,2010,1953,1077,876
34691,30,78,2010,4,4,0
34692,30,13,2010,8,4,4
34693,30,3,2010,571,282,289
34694,30,79,2010,4,3,1
34695,30,29,2010,571,456,115
34696,30,67,2010,372,152,220
34697,30,95,2010,2,2,0
34698,30,151,2010,30,13,17
34699,30,4,2010,27,12,15
34700,30,53,2010,98,35,63
34701,30,147,2010,26,10,16
34702,30,105,2010,83,49,34
34703,30,152,2010,11,4,7
34704,30,116,2010,15,8,7
34705,30,153,2010,7,2,5
34706,30,135,2010,8,0,8
34707,30,80,2010,2,1,1
34708,30,136,2010,5,1,4
34709,30,106,2010,19,8,11
34710,30,172,2010,780,369,411
34711,30,107,2010,21,8,13
34712,30,137,2010,9,5,4
34713,30,96,2010,5,0,5
34714,30,54,2010,76,37,39
34715,30,81,2010,234,94,140
34716,30,14,2010,222,90,132
34717,30,31,2010,838,500,338
34718,30,176,2010,33,17,16
34719,30,137,2010,14,2,12
34720,30,39,2010,57,16,41
34721,30,118,2010,3,0,3
34722,30,82,2010,1,0,1
34723,30,83,2010,19,12,7
34724,30,108,2010,12,8,4
34725,30,142,2010,120,27,93
34726,30,97,2010,7,2,5
34727,30,119,2010,3,1,2
34728,30,40,2010,54,39,15
34729,30,148,2010,3,3,0
34730,30,120,2010,49,8,41
34731,30,42,2010,51,24,27
34732,30,68,2010,509,208,301
34733,30,139,2010,11,7,4
34734,30,155,2010,10,5,5
34735,30,15,2010,264,156,108
34736,30,69,2010,1889,880,1009
34737,30,156,2010,10,6,4
34738,30,55,2010,8,6,2
34739,30,56,2010,4469,2260,2209
34740,30,98,2010,6,5,1
34741,30,157,2010,10,2,8
34742,30,158,2010,5,2,3
34743,30,110,2010,4,1,3
34744,30,85,2010,5,1,4
34745,30,99,2010,2,1,1
34746,30,32,2010,306,189,117
34747,30,43,2010,140,62,78
34748,30,5,2010,138,37,101
34749,30,6,2010,239,57,182
34750,30,16,2010,2549,547,2002
34751,30,44,2010,10,4,6
34752,30,45,2010,0,0,0
34753,30,17,2010,306,123,183
34754,30,57,2010,982,349,633
34755,30,86,2010,6,3,3
34756,30,177,2010,105,52,53
34757,30,18,2010,148,23,125
34758,30,167,2010,879,619,260
34759,30,121,2010,11,6,5
34760,30,19,2010,92,24,68
34761,30,168,2010,78,49,29
34762,30,46,2010,115,88,27
34763,30,20,2010,560,131,429
34764,30,159,2010,5,2,3
34765,30,143,2010,179,87,92
34766,30,70,2010,3,1,2
34767,30,47,2010,98,87,11
34768,30,71,2010,8,3,5
34769,30,122,2010,2,0,2
34770,30,123,2010,0,0,0
34771,30,7,2010,2,1,1
34772,30,160,2010,1,1,0
34773,30,58,2010,33,15,18
34774,30,161,2010,3,0,3
34775,30,124,2010,1,1,0
34776,30,100,2010,23,13,10
34777,30,72,2010,4,2,2
34778,30,59,2010,25,11,14
34779,30,144,2010,70,31,39
34780,30,125,2010,24,10,14
34781,30,150,2010,3,1,2
34782,30,8,2010,5,0,5
34783,30,73,2010,271,94,177
34784,30,101,2010,27,3,24
34785,30,162,2010,68,11,57
34786,30,60,2010,2200,1035,1165
34787,30,48,2010,88,38,50
34788,30,21,2010,2,0,2
34789,30,9,2010,37,6,31
34790,30,102,2010,6,0,6
34791,30,111,2010,2,0,2
34792,30,112,2010,19,7,12
34793,30,33,2010,1085,754,331
34794,30,61,2010,90,42,48
34795,30,22,2010,8,2,6
34796,30,35,2010,5479,3307,2172
34797,30,36,2010,16970,13106,3864
34798,30,126,2010,2,1,1
34799,30,62,2010,4,3,1
34800,30,23,2010,31,13,18
34801,30,164,2010,9,4,5
34802,30,63,2010,2022,1081,941
34803,30,127,2010,0,0,0
34804,30,165,2010,1,0,1
34805,30,37,2010,263,196,67
34806,30,64,2010,33,16,17
34807,30,128,2010,3,0,3
34808,30,115,2010,121,65,56
34809,30,65,2010,1417,661,756
34810,30,10,2010,9,3,6
34811,30,145,2010,34,6,28
34812,30,113,2010,1,0,1
34813,30,49,2010,111,46,65
34814,30,74,2010,148,62,86
34815,30,25,2010,1134,204,930
34816,30,169,2010,109,60,49
34817,30,166,2010,0,0,0
34818,30,93,2010,0,0,0
34819,30,146,2010,72,20,52
34820,30,26,2010,3587,1004,2583
34821,30,170,2010,239,156,83
34822,30,94,2010,3,0,3
34823,30,130,2010,5,1,4
34824,30,38,2010,5327,4142,1185
34825,30,27,2010,55,24,31
34826,30,50,2010,2757,1229,1528
34827,30,131,2010,13,0,13
34828,30,114,2010,16,6,10
34829,30,171,2010,619,408,211
34830,30,1,2010,566,186,380
34831,30,28,2010,43,9,34
34832,30,132,2010,11,6,5
34833,30,133,2010,27,8,19
34834,152,151,2010,3996,1964,2032
34835,152,156,2010,30810,19895,10915
34836,152,160,2010,41902,24575,17327
34837,152,162,2010,4944,2648,2296
34838,152,164,2010,3857,1758,2099
34839,152,166,2010,14721,9436,5285
34840,116,67,2010,497,261,236
34841,116,137,2010,147611,72512,75099
34842,116,68,2010,248,129,119
34843,116,121,2010,847,370,477
34844,116,126,2010,54794,30008,24786
34845,116,130,2010,731,305,426
34846,116,131,2010,22974,12289,10685
34847,153,134,2010,356,187,169
34848,153,103,2010,4,3,1
34849,153,67,2010,10,4,6
34850,153,105,2010,275,145,130
34851,153,172,2010,22,12,10
34852,153,81,2010,82,43,39
34853,153,68,2010,194,103,91
34854,153,139,2010,8,3,5
34855,153,155,2010,5,3,2
34856,153,69,2010,65,30,35
34857,153,156,2010,40,21,19
34858,153,157,2010,398,208,190
34859,153,57,2010,392,180,212
34860,153,177,2010,1,0,1
34861,153,71,2010,4,3,1
34862,153,160,2010,7,3,4
34863,153,100,2010,3,0,3
34864,153,125,2010,25,14,11
34865,153,73,2010,36,17,19
34866,153,162,2010,645,342,303
34867,153,112,2010,3,0,3
34868,153,61,2010,1116,582,534
34869,153,158,2010,4829,2145,2684
34870,153,36,2010,672,363,309
34871,153,140,2010,1649,923,726
34872,153,164,2010,1423,673,750
34873,153,165,2010,14,8,6
34874,153,65,2010,138,73,65
34875,153,74,2010,13,7,6
34876,153,38,2010,21,10,11
34877,153,50,2010,50,25,25
34878,135,134,2010,2046,1008,1038
34879,135,136,2010,49629,23345,26284
34880,135,137,2010,2365,1138,1227
34881,135,137,2010,3265,1493,1772
34882,135,151,2010,1921,810,1111
34883,135,138,2010,2688,1350,1338
34884,135,68,2010,3695,1660,2035
34885,135,139,2010,845,400,445
34886,135,69,2010,236,111,125
34887,135,56,2010,153,49,104
34888,135,157,2010,3665,1811,1854
34889,135,57,2010,407,166,241
34890,135,159,2010,3407,1700,1707
34891,135,160,2010,6567,1893,4674
34892,135,73,2010,127,49,78
34893,135,162,2010,82748,33254,49494
34894,135,164,2010,2524,464,2060
34895,135,50,2010,204,81,123
34896,80,103,2010,12,8,4
34897,80,66,2010,47,10,37
34898,80,78,2010,171,81,90
34899,80,79,2010,169,60,109
34900,80,67,2010,12,6,6
34901,80,105,2010,66,35,31
34902,80,95,2010,323,145,178
34903,80,107,2010,385,205,180
34904,80,96,2010,120,36,84
34905,80,81,2010,695,360,335
34906,80,39,2010,18,7,11
34907,80,83,2010,61,14,47
34908,80,42,2010,10,6,4
34909,80,68,2010,36,14,22
34910,80,69,2010,126,41,85
34911,80,84,2010,16,7,9
34912,80,110,2010,308,126,182
34913,80,85,2010,18,7,11
34914,80,99,2010,1682,1059,623
34915,80,5,2010,535,123,412
34916,80,6,2010,10,4,6
34917,80,44,2010,213,114,99
34918,80,17,2010,12,10,2
34919,80,57,2010,85,11,74
34920,80,86,2010,9472,4703,4769
34921,80,177,2010,20,6,14
34922,80,121,2010,34,25,9
34923,80,100,2010,38,20,18
34924,80,73,2010,36,6,30
34925,80,101,2010,364,216,148
34926,80,162,2010,10,0,10
34927,80,9,2010,102,37,65
34928,80,102,2010,126,58,68
34929,80,112,2010,15,10,5
34930,80,88,2010,45,25,20
34931,80,91,2010,10,6,4
34932,80,92,2010,30,8,22
34933,80,115,2010,36,18,18
34934,80,133,2010,18,6,12
34935,80,65,2010,28,16,12
34936,80,74,2010,75,18,57
34937,80,93,2010,289,152,137
34938,80,50,2010,1969,927,1042
34939,80,131,2010,15,13,2
34940,80,132,2010,10,4,6
34941,136,135,2010,29798,16450,13348
34942,136,137,2010,688,381,307
34943,136,137,2010,248,137,111
34944,136,68,2010,853,471,382
34945,136,139,2010,282,156,126
34946,136,143,2010,1055,583,472
34947,136,162,2010,2402,1327,1075
34948,136,145,2010,293205,161855,131350
34949,106,103,2010,55685,27284,28401
34950,106,105,2010,10065,5196,4869
34951,106,172,2010,5208,2309,2899
34952,106,107,2010,14401,7769,6632
34953,106,81,2010,5973,2785,3188
34954,106,83,2010,542,286,256
34955,106,108,2010,17966,9739,8227
34956,106,68,2010,6207,2941,3266
34957,106,69,2010,10727,5321,5406
34958,106,85,2010,90,39,51
34959,106,57,2010,7404,3287,4117
34960,106,100,2010,3403,1664,1739
34961,106,111,2010,2398,1224,1174
34962,106,112,2010,124672,74108,50564
34963,106,65,2010,11286,5321,5965
34964,106,114,2010,4480,2104,2376
34965,172,3,2010,2323,1116,1207
34966,172,105,2010,42931,16051,26880
34967,172,10,2010,3142,1711,1431
34968,172,173,2010,156173,61769,94404
34969,172,5,2010,5183,1814,3369
34970,172,177,2010,3946,1304,2642
34971,172,174,2010,14100,6271,7829
34972,172,9,2010,2546,880,1666
34973,172,112,2010,7792,2914,4878
34974,172,36,2010,1713,629,1084
34975,172,1,2010,300897,121831,179066
34976,172,50,2010,5264,1660,3604
34977,107,103,2010,3386,1431,1955
34978,107,105,2010,2570,1416,1154
34979,107,106,2010,2344,1035,1309
34980,107,172,2010,1632,696,936
34981,107,96,2010,1106,564,542
34982,107,81,2010,1772,673,1099
34983,107,83,2010,469,233,236
34984,107,108,2010,13707,6650,7057
34985,107,97,2010,425,190,235
34986,107,68,2010,2077,907,1170
34987,107,69,2010,1997,835,1162
34988,107,98,2010,494,243,251
34989,107,99,2010,384,197,187
34990,107,57,2010,2563,892,1671
34991,107,177,2010,619,263,356
34992,107,100,2010,3125,1457,1668
34993,107,73,2010,374,128,246
34994,107,102,2010,2068,1068,1000
34995,107,112,2010,4575,1869,2706
34996,107,36,2010,578,364,214
34997,107,65,2010,7935,3587,4348
34998,107,74,2010,621,224,397
34999,107,50,2010,1201,479,722
35000,107,114,2010,436,157,279
35001,117,68,2010,486,208,278
35002,117,121,2010,77,43,34
35003,117,122,2010,9689,5168,4521
35004,117,131,2010,146,75,71
35005,137,134,2010,31028,14277,16751
35006,137,135,2010,8502,3300,5202
35007,137,136,2010,7949,2626,5323
35008,137,172,2010,695,52,643
35009,137,137,2010,252142,123384,128758
35010,137,81,2010,403,266,137
35011,137,151,2010,11432,5187,6245
35012,137,138,2010,1190,520,670
35013,137,68,2010,7765,3375,4390
35014,137,139,2010,2380,1168,1212
35015,137,69,2010,436,224,212
35016,137,20,2010,878,318,560
35017,137,160,2010,25520,8093,17427
35018,137,161,2010,2369,522,1847
35019,137,61,2010,1084,439,645
35020,137,36,2010,1938,1124,814
35021,137,126,2010,18900,7846,11054
35022,137,164,2010,9981,2241,7740
35023,137,166,2010,1834,945,889
35024,137,134,2010,259584,134154,125430
35025,137,116,2010,37626,21353,16273
35026,137,137,2010,1549,784,765
35027,137,126,2010,123871,64244,59627
35028,137,129,2010,4465,2260,2205
35029,137,145,2010,2506,1269,1237
35030,137,130,2010,33,16,17
35031,96,2,2010,5,4,1
35032,96,51,2010,5,0,5
35033,96,141,2010,13,8,5
35034,96,134,2010,4,2,2
35035,96,12,2010,4,2,2
35036,96,103,2010,1448,748,700
35037,96,66,2010,128,37,91
35038,96,78,2010,13,4,9
35039,96,13,2010,2,0,2
35040,96,3,2010,4,0,4
35041,96,11,2010,8,4,4
35042,96,79,2010,12,5,7
35043,96,67,2010,289,120,169
35044,96,4,2010,5,2,3
35045,96,105,2010,537,273,264
35046,96,95,2010,138,56,82
35047,96,30,2010,71,40,31
35048,96,29,2010,6,4,2
35049,96,135,2010,10,6,4
35050,96,80,2010,9,2,7
35051,96,10,2010,2,0,2
35052,96,106,2010,1715,837,878
35053,96,172,2010,288,108,180
35054,96,107,2010,20965,10629,10336
35055,96,137,2010,9,4,5
35056,96,137,2010,4,4,0
35057,96,54,2010,25,12,13
35058,96,81,2010,5675,2686,2989
35059,96,14,2010,4,0,4
35060,96,151,2010,2,2,0
35061,96,39,2010,64,28,36
35062,96,82,2010,6,6,0
35063,96,83,2010,1084,719,365
35064,96,108,2010,1255,570,685
35065,96,97,2010,13701,7583,6118
35066,96,120,2010,2,0,2
35067,96,40,2010,4,4,0
35068,96,42,2010,23,16,7
35069,96,68,2010,861,383,478
35070,96,109,2010,13,8,5
35071,96,139,2010,2,2,0
35072,96,15,2010,13,8,5
35073,96,69,2010,1840,780,1060
35074,96,156,2010,2,0,2
35075,96,55,2010,5,5,0
35076,96,56,2010,34,12,22
35077,96,84,2010,9,4,5
35078,96,98,2010,2623,1279,1344
35079,96,110,2010,29,13,16
35080,96,85,2010,71,30,41
35081,96,99,2010,3869,2204,1665
35082,96,173,2010,3238,1512,1726
35083,96,32,2010,74,34,40
35084,96,43,2010,2,2,0
35085,96,5,2010,55,22,33
35086,96,6,2010,100,20,80
35087,96,16,2010,16,6,10
35088,96,44,2010,30,16,14
35089,96,17,2010,169,61,108
35090,96,57,2010,2102,801,1301
35091,96,86,2010,215,124,91
35092,96,177,2010,280,120,160
35093,96,167,2010,6,6,0
35094,96,18,2010,12,4,8
35095,96,121,2010,9,0,9
35096,96,176,2010,37,20,17
35097,96,20,2010,88,30,58
35098,96,46,2010,2,2,0
35099,96,143,2010,12,6,6
35100,96,70,2010,5,2,3
35101,96,47,2010,10,5,5
35102,96,71,2010,16,12,4
35103,96,174,2010,2,0,2
35104,96,122,2010,4,4,0
35105,96,7,2010,2,2,0
35106,96,100,2010,3056,1644,1412
35107,96,72,2010,2,0,2
35108,96,87,2010,5,4,1
35109,96,144,2010,5,4,1
35110,96,125,2010,5,4,1
35111,96,21,2010,4,0,4
35112,96,8,2010,9,2,7
35113,96,73,2010,579,234,345
35114,96,77,2010,33,12,21
35115,96,101,2010,288033,151788,136245
35116,96,162,2010,4,4,0
35117,96,48,2010,76,30,46
35118,96,9,2010,10,0,10
35119,96,102,2010,11261,5483,5778
35120,96,111,2010,83,58,25
35121,96,112,2010,3730,1805,1925
35122,96,33,2010,299,170,129
35123,96,61,2010,78,33,45
35124,96,88,2010,352,139,213
35125,96,22,2010,4,2,2
35126,96,35,2010,99,52,47
35127,96,36,2010,591,388,203
35128,96,126,2010,2,2,0
35129,96,90,2010,2,2,0
35130,96,91,2010,2,2,0
35131,96,92,2010,2,0,2
35132,96,23,2010,14,5,9
35133,96,164,2010,2,2,0
35134,96,37,2010,23,9,14
35135,96,1,2010,2,0,2
35136,96,128,2010,2,2,0
35137,96,115,2010,58,33,25
35138,96,133,2010,2,0,2
35139,96,65,2010,2132,937,1195
35140,96,145,2010,2,0,2
35141,96,113,2010,21,10,11
35142,96,148,2010,2,0,2
35143,96,49,2010,136,61,75
35144,96,74,2010,663,293,370
35145,96,25,2010,12,2,10
35146,96,93,2010,35,25,10
35147,96,146,2010,5,4,1
35148,96,26,2010,9,5,4
35149,96,130,2010,10,4,6
35150,96,38,2010,154,100,54
35151,96,60,2010,27,13,14
35152,96,142,2010,12,2,10
35153,96,50,2010,513,213,300
35154,96,131,2010,5,4,1
35155,96,114,2010,310,150,160
35156,96,171,2010,2,2,0
35157,54,51,2010,172,96,76
35158,54,141,2010,56,29,27
35159,54,103,2010,199,123,76
35160,54,66,2010,5115,2527,2588
35161,54,29,2010,93,77,16
35162,54,67,2010,373,197,176
35163,54,53,2010,402318,211973,190345
35164,54,105,2010,192,125,67
35165,54,30,2010,303,205,98
35166,54,106,2010,125,76,49
35167,54,172,2010,443,225,218
35168,54,107,2010,45,29,16
35169,54,31,2010,943,691,252
35170,54,39,2010,101,50,51
35171,54,142,2010,245,133,112
35172,54,40,2010,20,13,7
35173,54,42,2010,39,25,14
35174,54,68,2010,1749,910,839
35175,54,69,2010,33561,16709,16852
35176,54,56,2010,146,75,71
35177,54,32,2010,1037,707,330
35178,54,5,2010,67,26,41
35179,54,6,2010,48,21,27
35180,54,16,2010,81,18,63
35181,54,44,2010,53,28,25
35182,54,17,2010,55,18,37
35183,54,57,2010,3120,1522,1598
35184,54,177,2010,56,42,14
35185,54,18,2010,68,8,60
35186,54,167,2010,67,54,13
35187,54,46,2010,27,24,3
35188,54,20,2010,65,15,50
35189,54,143,2010,149,72,77
35190,54,47,2010,26,21,5
35191,54,71,2010,31,19,12
35192,54,100,2010,39,23,16
35193,54,59,2010,6142,3265,2877
35194,54,144,2010,29,18,11
35195,54,73,2010,804,427,377
35196,54,162,2010,29,12,17
35197,54,60,2010,9992,5096,4896
35198,54,48,2010,112,55,57
35199,54,112,2010,85,53,32
35200,54,33,2010,732,584,148
35201,54,61,2010,50,23,27
35202,54,35,2010,496,328,168
35203,54,36,2010,1303,1058,245
35204,54,63,2010,51856,29042,22814
35205,54,37,2010,640,493,147
35206,54,64,2010,19463,12321,7142
35207,54,115,2010,202,108,94
35208,54,65,2010,187,107,80
35209,54,145,2010,66,17,49
35210,54,49,2010,624,329,295
35211,54,74,2010,2990,1472,1518
35212,54,25,2010,179,23,156
35213,54,26,2010,85,34,51
35214,54,38,2010,753,591,162
35215,54,50,2010,666,309,357
35216,54,132,2010,46,19,27
35217,81,51,2010,6,2,4
35218,81,141,2010,22,13,9
35219,81,134,2010,63,36,27
35220,81,103,2010,90,55,35
35221,81,30,2010,52,39,13
35222,81,106,2010,123,53,70
35223,81,172,2010,134,44,90
35224,81,107,2010,95,51,44
35225,81,31,2010,80,54,26
35226,81,83,2010,49,37,12
35227,81,108,2010,58,34,24
35228,81,68,2010,113,55,58
35229,81,69,2010,217,116,101
35230,81,84,2010,0,0,0
35231,81,98,2010,41,23,18
35232,81,85,2010,284,120,164
35233,81,32,2010,28,16,12
35234,81,57,2010,295,105,190
35235,81,86,2010,129,72,57
35236,81,20,2010,26,9,17
35237,81,100,2010,237,129,108
35238,81,101,2010,160,103,57
35239,81,102,2010,37,26,11
35240,81,112,2010,65,38,27
35241,81,33,2010,40,30,10
35242,81,88,2010,44,28,16
35243,81,35,2010,69,50,19
35244,81,36,2010,989,702,287
35245,81,65,2010,1908,1034,874
35246,81,38,2010,332,245,87
35247,81,50,2010,43,22,21
35248,14,2,2010,8,2,6
35249,14,51,2010,291,125,166
35250,14,141,2010,38,18,20
35251,14,103,2010,88,39,49
35252,14,11,2010,1232,594,638
35253,14,66,2010,372,218,154
35254,14,12,2010,38,23,15
35255,14,13,2010,112,53,59
35256,14,3,2010,683,13,670
35257,14,29,2010,356,281,75
35258,14,67,2010,273,147,126
35259,14,151,2010,8,0,8
35260,14,53,2010,70,39,31
35261,14,147,2010,8,3,5
35262,14,105,2010,60,39,21
35263,14,30,2010,6459,4612,1847
35264,14,116,2010,3,0,3
35265,14,135,2010,59,28,31
35266,14,106,2010,50,31,19
35267,14,172,2010,1679,868,811
35268,14,107,2010,132,100,32
35269,14,96,2010,3,3,0
35270,14,54,2010,88,53,35
35271,14,81,2010,38,18,20
35272,14,31,2010,707,476,231
35273,14,176,2010,35,23,12
35274,14,137,2010,717,399,318
35275,14,39,2010,176,103,73
35276,14,118,2010,3,3,0
35277,14,83,2010,10,8,2
35278,14,108,2010,8,3,5
35279,14,142,2010,5441,2310,3131
35280,14,97,2010,10,3,7
35281,14,119,2010,3,3,0
35282,14,40,2010,30,23,7
35283,14,120,2010,85,53,32
35284,14,42,2010,518,394,124
35285,14,68,2010,961,585,376
35286,14,15,2010,16037,7700,8337
35287,14,69,2010,2725,1578,1147
35288,14,156,2010,88,44,44
35289,14,55,2010,3,0,3
35290,14,56,2010,24875,11134,13741
35291,14,85,2010,3,3,0
35292,14,99,2010,3,0,3
35293,14,32,2010,362,223,139
35294,14,43,2010,35,28,7
35295,14,5,2010,2885,1208,1677
35296,14,6,2010,1262,492,770
35297,14,16,2010,1059,344,715
35298,14,44,2010,815,551,264
35299,14,17,2010,401,184,217
35300,14,57,2010,505,265,240
35301,14,86,2010,15,8,7
35302,14,177,2010,88,53,35
35303,14,18,2010,463,175,288
35304,14,167,2010,248,156,92
35305,14,121,2010,88,44,44
35306,14,19,2010,244,108,136
35307,14,168,2010,25,13,12
35308,14,46,2010,171,125,46
35309,14,20,2010,2888,1335,1553
35310,14,143,2010,239,103,136
35311,14,47,2010,98,79,19
35312,14,71,2010,10,8,2
35313,14,122,2010,8,3,5
35314,14,123,2010,8,3,5
35315,14,58,2010,35,13,22
35316,14,124,2010,10,3,7
35317,14,100,2010,65,44,21
35318,14,144,2010,65,31,34
35319,14,125,2010,10,8,2
35320,14,150,2010,3,0,3
35321,14,8,2010,59,8,51
35322,14,73,2010,505,305,200
35323,14,101,2010,10,3,7
35324,14,162,2010,320,143,177
35325,14,60,2010,20,13,7
35326,14,48,2010,209,138,71
35327,14,21,2010,65,28,37
35328,14,9,2010,544,39,505
35329,14,102,2010,20,3,17
35330,14,111,2010,8,8,0
35331,14,112,2010,35,23,12
35332,14,33,2010,742,569,173
35333,14,61,2010,65,49,16
35334,14,88,2010,3,0,3
35335,14,22,2010,10,3,7
35336,14,35,2010,5673,4128,1545
35337,14,36,2010,13644,8186,5458
35338,14,23,2010,244,114,130
35339,14,164,2010,8,3,5
35340,14,63,2010,2657,1463,1194
35341,14,127,2010,8,3,5
35342,14,165,2010,3,0,3
35343,14,37,2010,144,90,54
35344,14,64,2010,15,8,7
35345,14,128,2010,10,3,7
35346,14,115,2010,5210,2909,2301
35347,14,65,2010,163,120,43
35348,14,10,2010,10361,8503,1858
35349,14,145,2010,544,281,263
35350,14,113,2010,3,3,0
35351,14,49,2010,957,642,315
35352,14,74,2010,395,262,133
35353,14,25,2010,3418,842,2576
35354,14,169,2010,8,3,5
35355,14,93,2010,15,13,2
35356,14,146,2010,38,13,25
35357,14,26,2010,641,346,295
35358,14,170,2010,10,8,2
35359,14,130,2010,20,3,17
35360,14,38,2010,3437,2363,1074
35361,14,27,2010,159,65,94
35362,14,50,2010,38224,21045,17179
35363,14,131,2010,152,79,73
35364,14,114,2010,3,3,0
35365,14,171,2010,77,44,33
35366,14,1,2010,65,57,8
35367,14,28,2010,15,8,7
35368,14,132,2010,144,95,49
35369,14,133,2010,320,191,129
35370,31,2,2010,317,121,196
35371,31,51,2010,262,82,180
35372,31,141,2010,616,57,559
35373,31,52,2010,0,0,0
35374,31,134,2010,178,28,150
35375,31,76,2010,0,0,0
35376,31,103,2010,102,41,61
35377,31,11,2010,2031,911,1120
35378,31,77,2010,1,0,1
35379,31,66,2010,2192,339,1853
35380,31,12,2010,681,300,381
35381,31,78,2010,2,1,1
35382,31,13,2010,16,2,14
35383,31,3,2010,117,13,104
35384,31,79,2010,1,0,1
35385,31,29,2010,3816,2171,1645
35386,31,67,2010,427,103,324
35387,31,95,2010,0,0,0
35388,31,151,2010,41,7,34
35389,31,4,2010,3,2,1
35390,31,53,2010,2550,839,1711
35391,31,147,2010,74,30,44
35392,31,105,2010,301,129,172
35393,31,30,2010,6113,2197,3916
35394,31,152,2010,12,5,7
35395,31,116,2010,4,0,4
35396,31,153,2010,11,4,7
35397,31,135,2010,81,16,65
35398,31,80,2010,0,0,0
35399,31,136,2010,7,1,6
35400,31,106,2010,85,32,53
35401,31,172,2010,4558,2015,2543
35402,31,173,2010,0,0,0
35403,31,107,2010,152,74,78
35404,31,117,2010,1,0,1
35405,31,137,2010,50,18,32
35406,31,96,2010,28,10,18
35407,31,54,2010,1383,415,968
35408,31,81,2010,363,108,255
35409,31,14,2010,79,14,65
35410,31,176,2010,25,2,23
35411,31,137,2010,54,16,38
35412,31,39,2010,264,60,204
35413,31,118,2010,3,2,1
35414,31,82,2010,2,0,2
35415,31,83,2010,32,13,19
35416,31,108,2010,76,29,47
35417,31,142,2010,474,37,437
35418,31,97,2010,11,7,4
35419,31,138,2010,0,0,0
35420,31,119,2010,3,1,2
35421,31,40,2010,128,71,57
35422,31,148,2010,0,0,0
35423,31,120,2010,71,16,55
35424,31,42,2010,218,91,127
35425,31,68,2010,1993,582,1411
35426,31,139,2010,2,0,2
35427,31,155,2010,11,1,10
35428,31,15,2010,979,404,575
35429,31,69,2010,11052,2210,8842
35430,31,156,2010,113,19,94
35431,31,55,2010,3,2,1
35432,31,56,2010,483,154,329
35433,31,84,2010,1,0,1
35434,31,98,2010,30,17,13
35435,31,157,2010,70,18,52
35436,31,158,2010,20,3,17
35437,31,110,2010,7,1,6
35438,31,85,2010,4,2,2
35439,31,99,2010,10,4,6
35440,31,32,2010,771,308,463
35441,31,43,2010,27,10,17
35442,31,5,2010,921,225,696
35443,31,6,2010,310,89,221
35444,31,16,2010,436,137,299
35445,31,44,2010,466,104,362
35446,31,17,2010,411,100,311
35447,31,57,2010,2283,303,1980
35448,31,86,2010,11,4,7
35449,31,177,2010,1346,651,695
35450,31,18,2010,148,22,126
35451,31,167,2010,4627,2324,2303
35452,31,121,2010,77,23,54
35453,31,19,2010,86,15,71
35454,31,168,2010,714,372,342
35455,31,46,2010,226,141,85
35456,31,20,2010,319,59,260
35457,31,149,2010,2,0,2
35458,31,159,2010,9,3,6
35459,31,143,2010,146,33,113
35460,31,70,2010,1,0,1
35461,31,47,2010,462,242,220
35462,31,71,2010,17,5,12
35463,31,122,2010,27,10,17
35464,31,123,2010,0,0,0
35465,31,7,2010,3,1,2
35466,31,160,2010,28,9,19
35467,31,58,2010,17,6,11
35468,31,161,2010,4,0,4
35469,31,124,2010,27,12,15
35470,31,100,2010,240,94,146
35471,31,72,2010,3,0,3
35472,31,59,2010,32,8,24
35473,31,144,2010,243,33,210
35474,31,125,2010,5,1,4
35475,31,150,2010,22,11,11
35476,31,8,2010,105,20,85
35477,31,73,2010,2258,658,1600
35478,31,101,2010,11,2,9
35479,31,162,2010,490,70,420
35480,31,60,2010,1934,388,1546
35481,31,48,2010,112,24,88
35482,31,21,2010,1,0,1
35483,31,9,2010,376,70,306
35484,31,102,2010,24,7,17
35485,31,111,2010,31,8,23
35486,31,112,2010,166,65,101
35487,31,33,2010,18409,9226,9183
35488,31,61,2010,129,39,90
35489,31,22,2010,6,3,3
35490,31,35,2010,3872,1374,2498
35491,31,36,2010,28453,15306,13147
35492,31,126,2010,5,0,5
35493,31,90,2010,0,0,0
35494,31,91,2010,3,1,2
35495,31,92,2010,1,0,1
35496,31,62,2010,1,1,0
35497,31,140,2010,2,0,2
35498,31,23,2010,61,5,56
35499,31,164,2010,51,1,50
35500,31,63,2010,774,201,573
35501,31,127,2010,0,0,0
35502,31,165,2010,11,2,9
35503,31,37,2010,69630,30209,39421
35504,31,64,2010,220,72,148
35505,31,128,2010,35,15,20
35506,31,115,2010,279,113,166
35507,31,65,2010,498,155,343
35508,31,10,2010,96,27,69
35509,31,145,2010,60,9,51
35510,31,113,2010,7,2,5
35511,31,49,2010,345,84,261
35512,31,74,2010,444,126,318
35513,31,25,2010,540,133,407
35514,31,169,2010,291,89,202
35515,31,166,2010,13,5,8
35516,31,93,2010,4,1,3
35517,31,146,2010,550,43,507
35518,31,26,2010,915,186,729
35519,31,170,2010,151,84,67
35520,31,130,2010,23,11,12
35521,31,38,2010,124172,51122,73050
35522,31,27,2010,33,7,26
35523,31,50,2010,3833,794,3039
35524,31,131,2010,21,6,15
35525,31,114,2010,19,9,10
35526,31,171,2010,2197,536,1661
35527,31,1,2010,52748,20607,32141
35528,31,28,2010,177,52,125
35529,31,132,2010,51,17,34
35530,31,133,2010,37,15,22
35531,39,2,2010,9817,4531,5286
35532,39,51,2010,249,136,113
35533,39,141,2010,892,332,560
35534,39,52,2010,0,0,0
35535,39,134,2010,145,77,68
35536,39,76,2010,3,2,1
35537,39,103,2010,1063,541,522
35538,39,11,2010,596,319,277
35539,39,77,2010,0,0,0
35540,39,66,2010,1690,854,836
35541,39,12,2010,264,147,117
35542,39,78,2010,13,8,5
35543,39,13,2010,77,38,39
35544,39,3,2010,672,328,344
35545,39,79,2010,33,12,21
35546,39,29,2010,615,398,217
35547,39,67,2010,1679,817,862
35548,39,95,2010,10,6,4
35549,39,151,2010,52,17,35
35550,39,4,2010,271,136,135
35551,39,53,2010,17934,8955,8979
35552,39,147,2010,68,40,28
35553,39,105,2010,2864,1888,976
35554,39,30,2010,2709,1330,1379
35555,39,152,2010,54,26,28
35556,39,116,2010,503,289,214
35557,39,153,2010,23,13,10
35558,39,135,2010,530,205,325
35559,39,136,2010,14,4,10
35560,39,106,2010,1405,719,686
35561,39,172,2010,10328,6405,3923
35562,39,173,2010,0,0,0
35563,39,174,2010,0,0,0
35564,39,107,2010,2852,1363,1489
35565,39,117,2010,17,10,7
35566,39,137,2010,637,327,310
35567,39,96,2010,138,57,81
35568,39,54,2010,714,355,359
35569,39,81,2010,411,230,181
35570,39,14,2010,151,85,66
35571,39,31,2010,854,479,375
35572,39,176,2010,336,184,152
35573,39,137,2010,590,288,302
35574,39,118,2010,21,13,8
35575,39,82,2010,11,7,4
35576,39,83,2010,123,85,38
35577,39,108,2010,518,285,233
35578,39,142,2010,1469,488,981
35579,39,97,2010,71,41,30
35580,39,138,2010,1,0,1
35581,39,119,2010,210,111,99
35582,39,40,2010,1035,734,301
35583,39,148,2010,45,18,27
35584,39,120,2010,1601,694,907
35585,39,41,2010,10594,6289,4305
35586,39,42,2010,3587,2452,1135
35587,39,68,2010,5908,2619,3289
35588,39,109,2010,0,0,0
35589,39,139,2010,6,4,2
35590,39,155,2010,582,253,329
35591,39,15,2010,194,110,84
35592,39,69,2010,33648,17116,16532
35593,39,156,2010,1597,703,894
35594,39,56,2010,1381,455,926
35595,39,84,2010,9,4,5
35596,39,98,2010,220,115,105
35597,39,157,2010,87,40,47
35598,39,158,2010,45,9,36
35599,39,110,2010,95,65,30
35600,39,85,2010,143,57,86
35601,39,99,2010,107,68,39
35602,39,32,2010,2618,1332,1286
35603,39,43,2010,8349,4334,4015
35604,39,5,2010,7901,3972,3929
35605,39,6,2010,11938,5026,6912
35606,39,16,2010,21174,9462,11712
35607,39,44,2010,1348,524,824
35608,39,17,2010,1610,595,1015
35609,39,57,2010,4810,1608,3202
35610,39,86,2010,148,79,69
35611,39,177,2010,1638,1110,528
35612,39,18,2010,1085,466,619
35613,39,167,2010,141,94,47
35614,39,121,2010,1338,764,574
35615,39,19,2010,1289,551,738
35616,39,168,2010,31,23,8
35617,39,46,2010,2574,1510,1064
35618,39,20,2010,12100,5501,6599
35619,39,149,2010,42,28,14
35620,39,159,2010,146,81,65
35621,39,143,2010,208,76,132
35622,39,70,2010,20,13,7
35623,39,47,2010,5092,2642,2450
35624,39,71,2010,420,210,210
35625,39,122,2010,51,33,18
35626,39,123,2010,76,38,38
35627,39,7,2010,7,5,2
35628,39,160,2010,0,0,0
35629,39,58,2010,95,34,61
35630,39,161,2010,29,16,13
35631,39,124,2010,139,76,63
35632,39,100,2010,880,494,386
35633,39,72,2010,14,6,8
35634,39,59,2010,77,40,37
35635,39,144,2010,5157,2445,2712
35636,39,125,2010,179,113,66
35637,39,150,2010,56,32,24
35638,39,8,2010,1446,458,988
35639,39,73,2010,6222,2644,3578
35640,39,101,2010,175,100,75
35641,39,162,2010,1062,424,638
35642,39,60,2010,2497,1161,1336
35643,39,48,2010,18462,11294,7168
35644,39,21,2010,17,10,7
35645,39,9,2010,10959,5086,5873
35646,39,102,2010,65,33,32
35647,39,111,2010,63,36,27
35648,39,112,2010,941,618,323
35649,39,33,2010,25693,12866,12827
35650,39,61,2010,1144,504,640
35651,39,88,2010,0,0,0
35652,39,22,2010,65,42,23
35653,39,35,2010,6146,3067,3079
35654,39,36,2010,4720,3326,1394
35655,39,126,2010,308,175,133
35656,39,90,2010,0,0,0
35657,39,91,2010,7,4,3
35658,39,92,2010,4,1,3
35659,39,62,2010,1,1,0
35660,39,140,2010,0,0,0
35661,39,23,2010,237,113,124
35662,39,164,2010,126,56,70
35663,39,63,2010,2394,1255,1139
35664,39,127,2010,17,13,4
35665,39,165,2010,314,155,159
35666,39,37,2010,841,395,446
35667,39,64,2010,228,118,110
35668,39,128,2010,9919,4667,5252
35669,39,115,2010,1556,738,818
35670,39,129,2010,0,0,0
35671,39,65,2010,4313,2078,2235
35672,39,10,2010,7653,3871,3782
35673,39,145,2010,639,254,385
35674,39,113,2010,28,13,15
35675,39,49,2010,20519,11827,8692
35676,39,74,2010,2386,1150,1236
35677,39,25,2010,2017,1044,973
35678,39,169,2010,24,17,7
35679,39,166,2010,135,50,85
35680,39,93,2010,154,87,67
35681,39,146,2010,842,269,573
35682,39,26,2010,32051,15307,16744
35683,39,170,2010,15,13,2
35684,39,130,2010,1307,808,499
35685,39,38,2010,6178,2714,3464
35686,39,27,2010,308,148,160
35687,39,50,2010,16085,6183,9902
35688,39,131,2010,961,561,400
35689,39,114,2010,211,102,109
35690,39,171,2010,240,127,113
35691,39,1,2010,9448,4994,4454
35692,39,28,2010,146,74,72
35693,39,132,2010,513,321,192
35694,39,133,2010,334,179,155
35695,118,120,2010,11222,6287,4935
35696,118,128,2010,84725,39512,45213
35697,118,28,2010,242,125,117
35698,82,76,2010,379,197,182
35699,82,78,2010,10,6,4
35700,82,79,2010,143,65,78
35701,82,172,2010,33,11,22
35702,82,81,2010,10,8,2
35703,82,68,2010,69,23,46
35704,82,109,2010,20,15,5
35705,82,69,2010,26,15,11
35706,82,110,2010,163,73,90
35707,82,85,2010,3071,1535,1536
35708,82,5,2010,24,10,14
35709,82,86,2010,111,73,38
35710,82,20,2010,29,6,23
35711,82,87,2010,139,65,74
35712,82,73,2010,9,4,5
35713,82,77,2010,40,26,14
35714,82,162,2010,43,26,17
35715,82,88,2010,14,1,13
35716,82,90,2010,54,32,22
35717,82,75,2010,16,4,12
35718,82,91,2010,241,119,122
35719,82,92,2010,107,47,60
35720,82,113,2010,16,6,10
35721,82,25,2010,14,4,10
35722,82,93,2010,262,106,156
35723,82,50,2010,543,261,282
35724,83,76,2010,171,81,90
35725,83,103,2010,1020,448,572
35726,83,66,2010,198,72,126
35727,83,78,2010,38,10,28
35728,83,13,2010,21,4,17
35729,83,67,2010,245,95,150
35730,83,4,2010,9,0,9
35731,83,53,2010,6,0,6
35732,83,105,2010,614,310,304
35733,83,30,2010,71,30,41
35734,83,116,2010,4,4,0
35735,83,135,2010,23,12,11
35736,83,153,2010,4,4,0
35737,83,136,2010,4,0,4
35738,83,106,2010,603,268,335
35739,83,172,2010,1413,620,793
35740,83,107,2010,3432,1693,1739
35741,83,96,2010,293,137,156
35742,83,81,2010,3656,1631,2025
35743,83,31,2010,29,14,15
35744,83,39,2010,25,10,15
35745,83,82,2010,15,9,6
35746,83,108,2010,554,270,284
35747,83,97,2010,255,134,121
35748,83,42,2010,27,17,10
35749,83,68,2010,1945,766,1179
35750,83,69,2010,1582,530,1052
35751,83,56,2010,61,18,43
35752,83,98,2010,408,188,220
35753,83,110,2010,23,7,16
35754,83,85,2010,313363,119172,194191
35755,83,99,2010,404,210,194
35756,83,32,2010,21,7,14
35757,83,5,2010,91,24,67
35758,83,6,2010,30,7,23
35759,83,16,2010,27,9,18
35760,83,44,2010,32,13,19
35761,83,17,2010,59,18,41
35762,83,57,2010,3612,1039,2573
35763,83,86,2010,127,35,92
35764,83,177,2010,329,163,166
35765,83,167,2010,11,6,5
35766,83,20,2010,143,47,96
35767,83,58,2010,25,12,13
35768,83,100,2010,1426,683,743
35769,83,144,2010,33,9,24
35770,83,73,2010,565,199,366
35771,83,77,2010,153,60,93
35772,83,101,2010,279,158,121
35773,83,162,2010,25,6,19
35774,83,48,2010,53,23,30
35775,83,9,2010,76,20,56
35776,83,102,2010,721,346,375
35777,83,111,2010,25,12,13
35778,83,112,2010,1360,532,828
35779,83,33,2010,43,15,28
35780,83,61,2010,102,41,61
35781,83,88,2010,5789,2668,3121
35782,83,35,2010,42,24,18
35783,83,36,2010,460,271,189
35784,83,90,2010,131,53,78
35785,83,75,2010,33,13,20
35786,83,23,2010,18,4,14
35787,83,63,2010,70,39,31
35788,83,115,2010,11,8,3
35789,83,65,2010,6721,2621,4100
35790,83,113,2010,27,11,16
35791,83,49,2010,71,30,41
35792,83,74,2010,995,338,657
35793,83,25,2010,25,10,15
35794,83,93,2010,23,10,13
35795,83,26,2010,30,10,20
35796,83,94,2010,34,20,14
35797,83,38,2010,73,49,24
35798,83,60,2010,26,11,15
35799,83,50,2010,460,215,245
35800,83,114,2010,174,86,88
35801,108,2,2010,44,17,27
35802,108,51,2010,57,27,30
35803,108,141,2010,38,10,28
35804,108,134,2010,34,21,13
35805,108,103,2010,4266,1766,2500
35806,108,66,2010,433,189,244
35807,108,78,2010,38,17,21
35808,108,11,2010,30,15,15
35809,108,67,2010,676,333,343
35810,108,105,2010,2097,1133,964
35811,108,30,2010,154,84,70
35812,108,135,2010,36,11,25
35813,108,106,2010,8959,4075,4884
35814,108,172,2010,2313,937,1376
35815,108,107,2010,221534,110312,111222
35816,108,96,2010,742,399,343
35817,108,54,2010,65,22,43
35818,108,81,2010,3772,1690,2082
35819,108,31,2010,250,68,182
35820,108,39,2010,145,45,100
35821,108,83,2010,280,157,123
35822,108,97,2010,413,218,195
35823,108,42,2010,100,63,37
35824,108,68,2010,1789,888,901
35825,108,155,2010,27,5,22
35826,108,69,2010,3481,1752,1729
35827,108,156,2010,30,10,20
35828,108,56,2010,57,11,46
35829,108,98,2010,341,176,165
35830,108,85,2010,76,22,54
35831,108,99,2010,372,205,167
35832,108,173,2010,77,33,44
35833,108,32,2010,172,105,67
35834,108,5,2010,181,59,122
35835,108,6,2010,152,44,108
35836,108,16,2010,28,2,26
35837,108,44,2010,158,67,91
35838,108,17,2010,412,159,253
35839,108,57,2010,3038,1242,1796
35840,108,86,2010,30,17,13
35841,108,177,2010,581,245,336
35842,108,18,2010,57,11,46
35843,108,176,2010,384,174,210
35844,108,20,2010,351,125,226
35845,108,100,2010,1785,966,819
35846,108,144,2010,38,15,23
35847,108,73,2010,655,291,364
35848,108,101,2010,311,153,158
35849,108,162,2010,40,2,38
35850,108,48,2010,187,96,91
35851,108,9,2010,42,4,38
35852,108,102,2010,762,373,389
35853,108,111,2010,192,90,102
35854,108,112,2010,10826,4442,6384
35855,108,33,2010,248,125,123
35856,108,61,2010,290,109,181
35857,108,88,2010,396,194,202
35858,108,35,2010,239,134,105
35859,108,36,2010,1182,756,426
35860,108,23,2010,71,27,44
35861,108,37,2010,40,21,19
35862,108,1,2010,38,17,21
35863,108,115,2010,97,28,69
35864,108,65,2010,5904,2908,2996
35865,108,49,2010,276,130,146
35866,108,74,2010,1551,528,1023
35867,108,25,2010,51,15,36
35868,108,93,2010,36,21,15
35869,108,38,2010,318,180,138
35870,108,60,2010,2,2,0
35871,108,142,2010,67,21,46
35872,108,50,2010,1706,804,902
35873,108,114,2010,758,283,475
35874,142,2,2010,198,46,152
35875,142,51,2010,113,44,69
35876,142,141,2010,830,547,283
35877,142,134,2010,27,13,14
35878,142,76,2010,16,9,7
35879,142,12,2010,31,1,30
35880,142,103,2010,235,93,142
35881,142,66,2010,567,317,250
35882,142,78,2010,14,11,3
35883,142,13,2010,377,194,183
35884,142,3,2010,239,28,211
35885,142,11,2010,151,93,58
35886,142,67,2010,527,268,259
35887,142,53,2010,59,29,30
35888,142,105,2010,123,74,49
35889,142,30,2010,65,38,27
35890,142,116,2010,35,3,32
35891,142,29,2010,262,152,110
35892,142,135,2010,119,20,99
35893,142,10,2010,210,92,118
35894,142,136,2010,312,114,198
35895,142,106,2010,26,12,14
35896,142,172,2010,720,234,486
35897,142,107,2010,55,13,42
35898,142,117,2010,852,156,696
35899,142,137,2010,70,22,48
35900,142,137,2010,123,44,79
35901,142,54,2010,97,22,75
35902,142,14,2010,81,38,43
35903,142,31,2010,190,110,80
35904,142,151,2010,35,1,34
35905,142,39,2010,284,140,144
35906,142,108,2010,12,9,3
35907,142,97,2010,200,113,87
35908,142,120,2010,612,353,259
35909,142,119,2010,1559,765,794
35910,142,40,2010,25,12,13
35911,142,42,2010,234,137,97
35912,142,68,2010,2675,1265,1410
35913,142,118,2010,348,138,210
35914,142,155,2010,28,8,20
35915,142,69,2010,7234,3370,3864
35916,142,156,2010,221,55,166
35917,142,55,2010,9,3,6
35918,142,56,2010,1196,694,502
35919,142,98,2010,9,4,5
35920,142,157,2010,135,12,123
35921,142,32,2010,126,75,51
35922,142,5,2010,1165,427,738
35923,142,6,2010,142,60,82
35924,142,16,2010,9979,5120,4859
35925,142,44,2010,90,55,35
35926,142,17,2010,664,268,396
35927,142,57,2010,3917,1866,2051
35928,142,177,2010,1081,520,561
35929,142,167,2010,200,92,108
35930,142,18,2010,4913,2253,2660
35931,142,121,2010,130,43,87
35932,142,176,2010,97,39,58
35933,142,19,2010,2802,1041,1761
35934,142,168,2010,59,13,46
35935,142,20,2010,2976,1687,1289
35936,142,159,2010,45,19,26
35937,142,143,2010,4698,2107,2591
35938,142,122,2010,39,2,37
35939,142,123,2010,27,4,23
35940,142,7,2010,27,8,19
35941,142,160,2010,203,45,158
35942,142,161,2010,147,40,107
35943,142,100,2010,62,40,22
35944,142,72,2010,77,39,38
35945,142,144,2010,994,756,238
35946,142,125,2010,16,7,9
35947,142,21,2010,509,176,333
35948,142,150,2010,251,165,86
35949,142,73,2010,929,482,447
35950,142,162,2010,760,210,550
35951,142,48,2010,114,52,62
35952,142,9,2010,580,203,377
35953,142,33,2010,356,184,172
35954,142,61,2010,43,24,19
35955,142,158,2010,87,1,86
35956,142,22,2010,375,148,227
35957,142,35,2010,228,132,96
35958,142,36,2010,7014,4397,2617
35959,142,126,2010,42,9,33
35960,142,23,2010,7667,2832,4835
35961,142,164,2010,398,77,321
35962,142,127,2010,19,7,12
35963,142,165,2010,59,32,27
35964,142,37,2010,59,35,24
35965,142,128,2010,19080,8118,10962
35966,142,115,2010,210,90,120
35967,142,133,2010,32,7,25
35968,142,65,2010,389,190,199
35969,142,129,2010,0,0,0
35970,142,145,2010,46473,19510,26963
35971,142,49,2010,331,149,182
35972,142,74,2010,1278,612,666
35973,142,25,2010,7105,3218,3887
35974,142,169,2010,122,35,87
35975,142,27,2010,670,277,393
35976,142,146,2010,733,403,330
35977,142,26,2010,839,243,596
35978,142,170,2010,45,12,33
35979,142,130,2010,82,13,69
35980,142,38,2010,161,106,55
35981,142,60,2010,113,46,67
35982,142,50,2010,2944,1379,1565
35983,142,131,2010,137,31,106
35984,142,152,2010,62,9,53
35985,142,171,2010,106,22,84
35986,142,28,2010,5336,2186,3150
35987,142,132,2010,25,8,17
35988,97,103,2010,207,81,126
35989,97,66,2010,11,6,5
35990,97,3,2010,6,0,6
35991,97,79,2010,38,19,19
35992,97,67,2010,50,25,25
35993,97,105,2010,232,123,109
35994,97,95,2010,325,171,154
35995,97,106,2010,220,109,111
35996,97,172,2010,248,95,153
35997,97,107,2010,553,283,270
35998,97,96,2010,840,452,388
35999,97,81,2010,123,55,68
36000,97,83,2010,69,31,38
36001,97,108,2010,118,62,56
36002,97,68,2010,205,82,123
36003,97,69,2010,218,95,123
36004,97,98,2010,8521,4544,3977
36005,97,99,2010,11198,6627,4571
36006,97,173,2010,8,4,4
36007,97,5,2010,11,4,7
36008,97,6,2010,17,6,11
36009,97,44,2010,11,5,6
36010,97,17,2010,41,23,18
36011,97,57,2010,270,97,173
36012,97,86,2010,10,4,6
36013,97,177,2010,52,16,36
36014,97,100,2010,1644,891,753
36015,97,73,2010,32,11,21
36016,97,101,2010,7502,3533,3969
36017,97,102,2010,433,235,198
36018,97,111,2010,11,4,7
36019,97,112,2010,224,92,132
36020,97,61,2010,12,3,9
36021,97,88,2010,59,26,33
36022,97,36,2010,17,10,7
36023,97,65,2010,512,221,291
36024,97,49,2010,34,12,22
36025,97,74,2010,57,33,24
36026,97,50,2010,86,35,51
36027,97,114,2010,72,24,48
36028,138,135,2010,638,213,425
36029,138,68,2010,3649,1977,1672
36030,138,139,2010,205,89,116
36031,138,162,2010,287,133,154
36032,138,140,2010,1194,468,726
36033,138,65,2010,1023,416,607
36034,119,134,2010,286,119,167
36035,119,116,2010,864,398,466
36036,119,172,2010,112,11,101
36037,119,117,2010,159,75,84
36038,119,137,2010,1392,627,765
36039,119,120,2010,90,42,48
36040,119,68,2010,360,170,190
36041,119,5,2010,99,61,38
36042,119,121,2010,290,122,168
36043,119,123,2010,637,281,356
36044,119,125,2010,913,533,380
36045,119,126,2010,385,203,182
36046,119,128,2010,4691,2270,2421
36047,119,115,2010,101,44,57
36048,119,133,2010,268,79,189
36049,119,129,2010,1229,424,805
36050,119,145,2010,172,60,112
36051,119,130,2010,1257,430,827
36052,119,50,2010,47,29,18
36053,119,131,2010,434,209,225
36054,119,132,2010,199,71,128
36055,40,2,2010,13,3,10
36056,40,51,2010,7,0,7
36057,40,141,2010,14,3,11
36058,40,52,2010,0,0,0
36059,40,134,2010,3,1,2
36060,40,76,2010,1,0,1
36061,40,103,2010,14,3,11
36062,40,11,2010,690,280,410
36063,40,66,2010,70,37,33
36064,40,12,2010,1600,663,937
36065,40,13,2010,1,1,0
36066,40,3,2010,12,2,10
36067,40,79,2010,1,0,1
36068,40,29,2010,12796,7690,5106
36069,40,67,2010,117,49,68
36070,40,95,2010,1,0,1
36071,40,151,2010,0,0,0
36072,40,4,2010,0,0,0
36073,40,53,2010,2,1,1
36074,40,105,2010,62,34,28
36075,40,30,2010,78,28,50
36076,40,153,2010,0,0,0
36077,40,135,2010,2,0,2
36078,40,106,2010,8,0,8
36079,40,172,2010,201,99,102
36080,40,173,2010,1,1,0
36081,40,107,2010,13,7,6
36082,40,137,2010,4,1,3
36083,40,96,2010,2,0,2
36084,40,54,2010,13,4,9
36085,40,81,2010,19,9,10
36086,40,14,2010,13,7,6
36087,40,31,2010,67,27,40
36088,40,176,2010,6,1,5
36089,40,137,2010,2,0,2
36090,40,39,2010,135,37,98
36091,40,83,2010,1,0,1
36092,40,108,2010,7,2,5
36093,40,142,2010,41,4,37
36094,40,97,2010,2,0,2
36095,40,120,2010,4,0,4
36096,40,41,2010,1,1,0
36097,40,42,2010,2398,983,1415
36098,40,68,2010,212,80,132
36099,40,155,2010,0,0,0
36100,40,15,2010,1599,817,782
36101,40,69,2010,1369,629,740
36102,40,156,2010,6,2,4
36103,40,55,2010,1,1,0
36104,40,56,2010,25,12,13
36105,40,98,2010,7,3,4
36106,40,157,2010,0,0,0
36107,40,110,2010,2,2,0
36108,40,99,2010,1,0,1
36109,40,32,2010,99,55,44
36110,40,43,2010,22,9,13
36111,40,5,2010,111,23,88
36112,40,6,2010,28,5,23
36113,40,16,2010,10,2,8
36114,40,44,2010,146,61,85
36115,40,17,2010,49,15,34
36116,40,57,2010,295,81,214
36117,40,86,2010,2,1,1
36118,40,177,2010,55,27,28
36119,40,18,2010,4,1,3
36120,40,167,2010,4095,2289,1806
36121,40,121,2010,2,0,2
36122,40,19,2010,6,0,6
36123,40,168,2010,593,330,263
36124,40,46,2010,4259,2484,1775
36125,40,20,2010,10,0,10
36126,40,143,2010,4,2,2
36127,40,70,2010,1,0,1
36128,40,47,2010,2004,1171,833
36129,40,71,2010,14,7,7
36130,40,122,2010,1,1,0
36131,40,123,2010,0,0,0
36132,40,58,2010,0,0,0
36133,40,161,2010,2,2,0
36134,40,124,2010,2,1,1
36135,40,100,2010,28,10,18
36136,40,72,2010,1,1,0
36137,40,59,2010,0,0,0
36138,40,144,2010,15,3,12
36139,40,125,2010,2,0,2
36140,40,150,2010,1,0,1
36141,40,8,2010,20,1,19
36142,40,73,2010,129,32,97
36143,40,101,2010,1,0,1
36144,40,162,2010,14,4,10
36145,40,60,2010,4,2,2
36146,40,48,2010,150,48,102
36147,40,21,2010,0,0,0
36148,40,9,2010,32,5,27
36149,40,102,2010,0,0,0
36150,40,111,2010,0,0,0
36151,40,112,2010,15,7,8
36152,40,33,2010,599,318,281
36153,40,61,2010,43,14,29
36154,40,22,2010,1,0,1
36155,40,35,2010,64,24,40
36156,40,36,2010,154721,97155,57566
36157,40,126,2010,1,1,0
36158,40,90,2010,1,1,0
36159,40,23,2010,1,1,0
36160,40,164,2010,2,1,1
36161,40,63,2010,13,4,9
36162,40,165,2010,0,0,0
36163,40,37,2010,15,11,4
36164,40,64,2010,8,2,6
36165,40,128,2010,2,2,0
36166,40,115,2010,23,9,14
36167,40,65,2010,164,60,104
36168,40,10,2010,9,2,7
36169,40,145,2010,4,1,3
36170,40,113,2010,1,0,1
36171,40,49,2010,451,146,305
36172,40,74,2010,42,9,33
36173,40,25,2010,6,0,6
36174,40,169,2010,403,204,199
36175,40,166,2010,0,0,0
36176,40,93,2010,2,2,0
36177,40,146,2010,7,1,6
36178,40,26,2010,87,12,75
36179,40,170,2010,358,226,132
36180,40,130,2010,2,0,2
36181,40,38,2010,23350,12203,11147
36182,40,27,2010,7,2,5
36183,40,50,2010,524,159,365
36184,40,131,2010,4,1,3
36185,40,114,2010,4,2,2
36186,40,171,2010,1174,640,534
36187,40,1,2010,11,3,8
36188,40,28,2010,1,0,1
36189,40,132,2010,1,0,1
36190,40,133,2010,6,0,6
36191,148,134,2010,201,108,93
36192,148,147,2010,54,29,25
36193,148,116,2010,360,193,167
36194,148,137,2010,62,33,29
36195,148,137,2010,267,143,124
36196,148,120,2010,26,14,12
36197,148,149,2010,198,174,24
36198,148,159,2010,40,19,21
36199,148,125,2010,10841,4269,6572
36200,148,126,2010,229,123,106
36201,148,128,2010,146,77,69
36202,148,115,2010,12260,7576,4684
36203,148,130,2010,48,25,23
36204,120,116,2010,131,66,65
36205,120,137,2010,678,337,341
36206,120,119,2010,44934,22297,22637
36207,120,118,2010,2999,1428,1571
36208,120,126,2010,121,58,63
36209,120,128,2010,346579,165579,181000
36210,120,129,2010,111051,49618,61433
36211,120,145,2010,36781,17975,18806
36212,120,130,2010,177,85,92
36213,120,28,2010,117,56,61
36214,41,105,2010,18,9,9
36215,41,30,2010,12,3,9
36216,41,172,2010,18,14,4
36217,41,107,2010,36,14,22
36218,41,54,2010,25,11,14
36219,41,39,2010,3341,1517,1824
36220,41,120,2010,27,9,18
36221,41,69,2010,20,10,10
36222,41,156,2010,16,12,4
36223,41,43,2010,278,111,167
36224,41,5,2010,58,38,20
36225,41,121,2010,5,2,3
36226,41,47,2010,14,8,6
36227,41,48,2010,172,85,87
36228,41,112,2010,5,3,2
36229,41,33,2010,75,23,52
36230,41,35,2010,81,38,43
36231,41,36,2010,39,25,14
36232,41,63,2010,35,9,26
36233,41,115,2010,14,6,8
36234,41,49,2010,68,27,41
36235,41,146,2010,6,2,4
36236,41,50,2010,92,50,42
36237,42,2,2010,2342,1061,1281
36238,42,51,2010,174,26,148
36239,42,141,2010,635,125,510
36240,42,52,2010,2,0,2
36241,42,134,2010,328,123,205
36242,42,76,2010,1,1,0
36243,42,103,2010,267,107,160
36244,42,11,2010,69,42,27
36245,42,77,2010,0,0,0
36246,42,66,2010,496,222,274
36247,42,12,2010,79,47,32
36248,42,78,2010,9,5,4
36249,42,13,2010,14,4,10
36250,42,3,2010,1197,331,866
36251,42,79,2010,11,2,9
36252,42,29,2010,216,124,92
36253,42,67,2010,419,143,276
36254,42,95,2010,2,1,1
36255,42,151,2010,4,2,2
36256,42,4,2010,3,1,2
36257,42,53,2010,557,267,290
36258,42,147,2010,11,4,7
36259,42,105,2010,904,522,382
36260,42,30,2010,999,460,539
36261,42,152,2010,5,1,4
36262,42,116,2010,39,16,23
36263,42,153,2010,8,2,6
36264,42,135,2010,474,152,322
36265,42,136,2010,7,1,6
36266,42,106,2010,342,178,164
36267,42,172,2010,6591,3832,2759
36268,42,107,2010,816,395,421
36269,42,117,2010,3,1,2
36270,42,137,2010,83,33,50
36271,42,96,2010,45,18,27
36272,42,54,2010,159,77,82
36273,42,81,2010,321,129,192
36274,42,14,2010,112,29,83
36275,42,31,2010,108,48,60
36276,42,176,2010,2,1,1
36277,42,137,2010,914,439,475
36278,42,39,2010,832,321,511
36279,42,118,2010,6,5,1
36280,42,82,2010,3,0,3
36281,42,83,2010,112,52,60
36282,42,108,2010,133,56,77
36283,42,142,2010,758,143,615
36284,42,97,2010,42,26,16
36285,42,138,2010,9,6,3
36286,42,119,2010,56,30,26
36287,42,40,2010,21761,11355,10406
36288,42,148,2010,11,5,6
36289,42,120,2010,1434,578,856
36290,42,68,2010,1850,688,1162
36291,42,139,2010,7,4,3
36292,42,155,2010,385,85,300
36293,42,15,2010,27,15,12
36294,42,69,2010,5770,2433,3337
36295,42,156,2010,861,241,620
36296,42,56,2010,658,150,508
36297,42,84,2010,1,0,1
36298,42,98,2010,59,22,37
36299,42,157,2010,45,5,40
36300,42,158,2010,4,0,4
36301,42,110,2010,14,8,6
36302,42,85,2010,12,4,8
36303,42,99,2010,39,23,16
36304,42,32,2010,1442,660,782
36305,42,43,2010,144,59,85
36306,42,5,2010,3624,1350,2274
36307,42,6,2010,3924,1662,2262
36308,42,16,2010,6180,2511,3669
36309,42,44,2010,406,101,305
36310,42,17,2010,688,207,481
36311,42,57,2010,1700,461,1239
36312,42,86,2010,54,24,30
36313,42,177,2010,1103,657,446
36314,42,18,2010,206,55,151
36315,42,167,2010,156,89,67
36316,42,121,2010,826,414,412
36317,42,19,2010,100,33,67
36318,42,168,2010,27,14,13
36319,42,46,2010,879,516,363
36320,42,20,2010,490,170,320
36321,42,159,2010,104,34,70
36322,42,143,2010,138,46,92
36323,42,47,2010,504,311,193
36324,42,71,2010,70,35,35
36325,42,122,2010,9,8,1
36326,42,123,2010,14,5,9
36327,42,7,2010,2,0,2
36328,42,160,2010,3,0,3
36329,42,58,2010,31,9,22
36330,42,161,2010,8,0,8
36331,42,124,2010,34,13,21
36332,42,100,2010,471,199,272
36333,42,72,2010,3,0,3
36334,42,59,2010,2,2,0
36335,42,144,2010,1589,410,1179
36336,42,125,2010,52,27,25
36337,42,150,2010,69,42,27
36338,42,8,2010,899,214,685
36339,42,73,2010,1237,319,918
36340,42,101,2010,83,45,38
36341,42,162,2010,1227,210,1017
36342,42,60,2010,93,52,41
36343,42,48,2010,1473,691,782
36344,42,21,2010,5,4,1
36345,42,9,2010,1179,343,836
36346,42,102,2010,20,7,13
36347,42,111,2010,12,6,6
36348,42,112,2010,383,208,175
36349,42,33,2010,2602,1243,1359
36350,42,61,2010,333,97,236
36351,42,22,2010,10,4,6
36352,42,35,2010,1480,659,821
36353,42,36,2010,7339,4119,3220
36354,42,126,2010,173,91,82
36355,42,90,2010,1,0,1
36356,42,91,2010,3,1,2
36357,42,92,2010,2,0,2
36358,42,62,2010,0,0,0
36359,42,23,2010,237,116,121
36360,42,164,2010,110,24,86
36361,42,63,2010,69,32,37
36362,42,127,2010,6,5,1
36363,42,165,2010,103,22,81
36364,42,37,2010,109,37,72
36365,42,64,2010,26,10,16
36366,42,128,2010,7110,3363,3747
36367,42,115,2010,564,215,349
36368,42,129,2010,0,0,0
36369,42,65,2010,1544,592,952
36370,42,10,2010,649,289,360
36371,42,145,2010,800,363,437
36372,42,113,2010,2,0,2
36373,42,49,2010,30966,14919,16047
36374,42,74,2010,878,357,521
36375,42,25,2010,384,145,239
36376,42,169,2010,27,14,13
36377,42,166,2010,46,11,35
36378,42,93,2010,26,13,13
36379,42,146,2010,527,95,432
36380,42,26,2010,4890,1270,3620
36381,42,170,2010,20,12,8
36382,42,94,2010,0,0,0
36383,42,130,2010,121,58,63
36384,42,38,2010,857,487,370
36385,42,27,2010,68,22,46
36386,42,50,2010,4367,1206,3161
36387,42,131,2010,394,151,243
36388,42,114,2010,75,25,50
36389,42,171,2010,76,38,38
36390,42,1,2010,4251,2300,1951
36391,42,28,2010,31,16,15
36392,42,132,2010,138,77,61
36393,42,133,2010,54,18,36
36394,68,2,2010,4470,2025,2445
36395,68,51,2010,6286,3002,3284
36396,68,141,2010,1343555,615840,727715
36397,68,52,2010,922,528,394
36398,68,134,2010,19989,9797,10192
36399,68,75,2010,9,3,6
36400,68,76,2010,56,42,14
36401,68,103,2010,12156,7021,5135
36402,68,11,2010,17920,10278,7642
36403,68,77,2010,10,6,4
36404,68,66,2010,11793,8186,3607
36405,68,12,2010,3860,2002,1858
36406,68,78,2010,42,26,16
36407,68,13,2010,151,83,68
36408,68,3,2010,4690,1726,2964
36409,68,79,2010,72,40,32
36410,68,29,2010,3192,2018,1174
36411,68,67,2010,143882,87411,56471
36412,68,95,2010,8,7,1
36413,68,151,2010,19169,9085,10084
36414,68,4,2010,81,32,49
36415,68,53,2010,13089,6870,6219
36416,68,147,2010,38,21,17
36417,68,105,2010,53906,33460,20446
36418,68,30,2010,16552,9665,6887
36419,68,152,2010,8208,3909,4299
36420,68,116,2010,1752,1005,747
36421,68,153,2010,20933,11769,9164
36422,68,135,2010,76324,47059,29265
36423,68,136,2010,6966,3151,3815
36424,68,106,2010,13523,7250,6273
36425,68,172,2010,103338,61313,42025
36426,68,173,2010,484,274,210
36427,68,174,2010,16,8,8
36428,68,107,2010,25571,14929,10642
36429,68,117,2010,34401,18515,15886
36430,68,137,2010,65240,32085,33155
36431,68,96,2010,706,406,300
36432,68,54,2010,9481,4653,4828
36433,68,81,2010,4488,2729,1759
36434,68,14,2010,967,518,449
36435,68,31,2010,8551,5444,3107
36436,68,176,2010,56,35,21
36437,68,137,2010,72046,38438,33608
36438,68,39,2010,6085,3987,2098
36439,68,118,2010,6170,3049,3121
36440,68,82,2010,6049,4123,1926
36441,68,83,2010,3277,2234,1043
36442,68,108,2010,3884,2553,1331
36443,68,142,2010,29051,10749,18302
36444,68,97,2010,1046,639,407
36445,68,138,2010,366,214,152
36446,68,119,2010,599,394,205
36447,68,40,2010,853,550,303
36448,68,148,2010,19,14,5
36449,68,120,2010,8146,5218,2928
36450,68,41,2010,3,3,0
36451,68,42,2010,3595,2759,836
36452,68,139,2010,18574,10131,8443
36453,68,155,2010,1790,894,896
36454,68,15,2010,7121,3808,3313
36455,68,69,2010,219388,141076,78312
36456,68,156,2010,6287,3115,3172
36457,68,55,2010,66,46,20
36458,68,56,2010,12103,6482,5621
36459,68,98,2010,2811,1503,1308
36460,68,157,2010,28367,13212,15155
36461,68,158,2010,2878,1232,1646
36462,68,110,2010,4432,2690,1742
36463,68,85,2010,69806,40373,29433
36464,68,99,2010,550,333,217
36465,68,32,2010,9909,4862,5047
36466,68,43,2010,360,232,128
36467,68,5,2010,45131,24256,20875
36468,68,6,2010,21399,10176,11223
36469,68,16,2010,5747,2541,3206
36470,68,44,2010,9229,6049,3180
36471,68,45,2010,12,10,2
36472,68,17,2010,8636,4512,4124
36473,68,57,2010,345189,183614,161575
36474,68,86,2010,486,308,178
36475,68,177,2010,20073,14457,5616
36476,68,18,2010,1355,457,898
36477,68,167,2010,2425,1443,982
36478,68,121,2010,1641,1155,486
36479,68,19,2010,689,284,405
36480,68,168,2010,677,477,200
36481,68,46,2010,2620,1500,1120
36482,68,20,2010,44287,19305,24982
36483,68,149,2010,45,18,27
36484,68,159,2010,737,301,436
36485,68,143,2010,2207,1076,1131
36486,68,70,2010,26,12,14
36487,68,47,2010,2457,1475,982
36488,68,71,2010,12102,7306,4796
36489,68,122,2010,113062,70076,42986
36490,68,123,2010,100,52,48
36491,68,7,2010,6,2,4
36492,68,160,2010,70950,28471,42479
36493,68,58,2010,460,263,197
36494,68,161,2010,16685,5773,10912
36495,68,124,2010,41634,25624,16010
36496,68,100,2010,11813,7648,4165
36497,68,72,2010,23426,12091,11335
36498,68,59,2010,1317,655,662
36499,68,87,2010,6,6,0
36500,68,144,2010,870001,413512,456489
36501,68,125,2010,1211,689,522
36502,68,150,2010,162,90,72
36503,68,8,2010,1244,689,555
36504,68,73,2010,41166,22272,18894
36505,68,101,2010,607,406,201
36506,68,162,2010,5415,2530,2885
36507,68,60,2010,4214,2173,2041
36508,68,48,2010,3822,2573,1249
36509,68,21,2010,102,42,60
36510,68,9,2010,22329,8699,13630
36511,68,102,2010,479,290,189
36512,68,111,2010,970,552,418
36513,68,112,2010,10970,6673,4297
36514,68,33,2010,104843,66151,38692
36515,68,61,2010,669693,331630,338063
36516,68,88,2010,48,25,23
36517,68,22,2010,139,78,61
36518,68,35,2010,84320,44962,39358
36519,68,36,2010,60093,38982,21111
36520,68,126,2010,5816,3254,2562
36521,68,90,2010,3,3,0
36522,68,91,2010,4460,3123,1337
36523,68,92,2010,27,20,7
36524,68,62,2010,206,104,102
36525,68,140,2010,210,126,84
36526,68,23,2010,2337,1095,1242
36527,68,164,2010,110686,48377,62309
36528,68,63,2010,79539,40599,38940
36529,68,127,2010,560,409,151
36530,68,165,2010,1221,656,565
36531,68,37,2010,4181,2531,1650
36532,68,64,2010,2434,1391,1043
36533,68,128,2010,1768,933,835
36534,68,115,2010,4864,2959,1905
36535,68,65,2010,285868,163433,122435
36536,68,10,2010,44946,21645,23301
36537,68,145,2010,3012,1181,1831
36538,68,113,2010,22896,13601,9295
36539,68,49,2010,9447,6686,2761
36540,68,74,2010,89461,53249,36212
36541,68,25,2010,15736,6680,9056
36542,68,169,2010,229,132,97
36543,68,166,2010,22314,10710,11604
36544,68,93,2010,385,282,103
36545,68,146,2010,364914,161502,203412
36546,68,26,2010,279301,132459,146842
36547,68,170,2010,198,114,84
36548,68,94,2010,7,3,4
36549,68,130,2010,545,327,218
36550,68,38,2010,14912,10235,4677
36551,68,27,2010,736,329,407
36552,68,50,2010,174048,88997,85051
36553,68,131,2010,604,355,249
36554,68,114,2010,2287,1274,1013
36555,68,171,2010,1036,609,427
36556,68,1,2010,118068,64869,53199
36557,68,28,2010,457,255,202
36558,68,132,2010,325,183,142
36559,68,133,2010,658,377,281
36560,109,141,2010,83,44,39
36561,109,67,2010,129,69,60
36562,109,105,2010,16137,7937,8200
36563,109,172,2010,1032,517,515
36564,109,82,2010,599,433,166
36565,109,68,2010,20809,9729,11080
36566,109,110,2010,3044,1644,1400
36567,109,85,2010,15743,9083,6660
36568,109,57,2010,117,62,55
36569,109,112,2010,419,215,204
36570,109,91,2010,1246,640,606
36571,109,113,2010,25501,13566,11935
36572,139,141,2010,72,28,44
36573,139,134,2010,723,286,437
36574,139,67,2010,327,142,185
36575,139,116,2010,109,42,67
36576,139,135,2010,33089,16098,16991
36577,139,136,2010,2955,1137,1818
36578,139,172,2010,226,63,163
36579,139,137,2010,10660,5518,5142
36580,139,137,2010,5818,2590,3228
36581,139,151,2010,34101,16306,17795
36582,139,138,2010,56815,27851,28964
36583,139,68,2010,10497,4410,6087
36584,139,69,2010,57,24,33
36585,139,156,2010,4156,592,3564
36586,139,157,2010,3251,821,2430
36587,139,17,2010,11,4,7
36588,139,177,2010,21,9,12
36589,139,176,2010,105,41,64
36590,139,20,2010,1633,481,1152
36591,139,160,2010,36033,12510,23523
36592,139,144,2010,467,229,238
36593,139,162,2010,15619,4148,11471
36594,139,126,2010,137,66,71
36595,139,140,2010,4251,2185,2066
36596,139,164,2010,19925,3924,16001
36597,139,115,2010,8,0,8
36598,139,25,2010,18,8,10
36599,139,166,2010,15035,7320,7715
36600,139,146,2010,146,63,83
36601,139,152,2010,4567,1758,2809
36602,155,157,2010,38981,16408,22573
36603,155,159,2010,854,403,451
36604,155,160,2010,8933,3280,5653
36605,155,161,2010,3146,466,2680
36606,155,158,2010,11904,6140,5764
36607,155,164,2010,114379,57819,56560
36608,155,165,2010,2250,1053,1197
36609,15,2,2010,39,18,21
36610,15,51,2010,10,6,4
36611,15,141,2010,17,10,7
36612,15,12,2010,5544,3641,1903
36613,15,103,2010,15,7,8
36614,15,66,2010,24,11,13
36615,15,11,2010,11770,5321,6449
36616,15,67,2010,21,13,8
36617,15,30,2010,215,118,97
36618,15,29,2010,1016,822,194
36619,15,172,2010,70,36,34
36620,15,81,2010,12,5,7
36621,15,31,2010,32,20,12
36622,15,40,2010,114,78,36
36623,15,42,2010,11,8,3
36624,15,68,2010,38,25,13
36625,15,69,2010,581,320,261
36626,15,56,2010,152,72,80
36627,15,32,2010,46,26,20
36628,15,5,2010,30,12,18
36629,15,6,2010,114,50,64
36630,15,17,2010,30,11,19
36631,15,57,2010,17,6,11
36632,15,167,2010,1583,688,895
36633,15,168,2010,231,155,76
36634,15,20,2010,9,5,4
36635,15,46,2010,190,124,66
36636,15,47,2010,195,150,45
36637,15,8,2010,17,0,17
36638,15,73,2010,11,7,4
36639,15,9,2010,81,6,75
36640,15,112,2010,20,18,2
36641,15,33,2010,167,120,47
36642,15,35,2010,204,154,50
36643,15,36,2010,34226,19610,14616
36644,15,65,2010,18,9,9
36645,15,74,2010,14,7,7
36646,15,169,2010,138,87,51
36647,15,26,2010,436,133,303
36648,15,170,2010,188,122,66
36649,15,38,2010,11231,6403,4828
36650,15,50,2010,32,9,23
36651,15,171,2010,705,456,249
36652,69,2,2010,80248,35245,45003
36653,69,51,2010,14532,6959,7573
36654,69,141,2010,18744,5453,13291
36655,69,134,2010,0,0,0
36656,69,103,2010,14929,7779,7150
36657,69,11,2010,10156,5277,4879
36658,69,66,2010,207456,106839,100617
36659,69,12,2010,15448,7636,7812
36660,69,3,2010,6102,2096,4006
36661,69,29,2010,20563,13482,7081
36662,69,67,2010,28146,14191,13955
36663,69,151,2010,1726,508,1218
36664,69,53,2010,160948,80505,80443
36665,69,105,2010,51460,33732,17728
36666,69,30,2010,84834,43424,41410
36667,69,152,2010,1245,371,874
36668,69,116,2010,564,255,309
36669,69,135,2010,16025,6847,9178
36670,69,136,2010,255,71,184
36671,69,106,2010,12839,6630,6209
36672,69,172,2010,82444,43953,38491
36673,69,107,2010,17812,10983,6829
36674,69,137,2010,3386,1663,1723
36675,69,96,2010,1523,847,676
36676,69,54,2010,168713,90060,78653
36677,69,81,2010,11701,6666,5035
36678,69,14,2010,1492,643,849
36679,69,31,2010,437756,248582,189174
36680,69,176,2010,2409,1564,845
36681,69,137,2010,7029,3327,3702
36682,69,39,2010,20919,11535,9384
36683,69,83,2010,8932,6023,2909
36684,69,108,2010,6835,4210,2625
36685,69,142,2010,18806,5289,13517
36686,69,97,2010,1073,614,459
36687,69,119,2010,11787,6064,5723
36688,69,40,2010,9442,5696,3746
36689,69,120,2010,16760,8322,8438
36690,69,42,2010,13120,9442,3678
36691,69,68,2010,117432,63151,54281
36692,69,139,2010,421,170,251
36693,69,155,2010,3559,905,2654
36694,69,15,2010,18431,11054,7377
36695,69,156,2010,24278,12105,12173
36696,69,56,2010,173208,78919,94289
36697,69,98,2010,1686,913,773
36698,69,157,2010,3408,1019,2389
36699,69,85,2010,1274,684,590
36700,69,99,2010,1160,735,425
36701,69,32,2010,139137,66424,72713
36702,69,43,2010,1451,677,774
36703,69,5,2010,55002,20762,34240
36704,69,6,2010,110767,46955,63812
36705,69,16,2010,92654,35648,57006
36706,69,44,2010,9160,4145,5015
36707,69,17,2010,12001,4205,7796
36708,69,57,2010,333818,126912,206906
36709,69,86,2010,1838,1015,823
36710,69,177,2010,26644,15835,10809
36711,69,18,2010,10198,3503,6695
36712,69,167,2010,812460,411041,401419
36713,69,121,2010,12109,8568,3541
36714,69,168,2010,67389,34598,32791
36715,69,46,2010,24736,14133,10603
36716,69,20,2010,64057,24858,39199
36717,69,159,2010,1586,506,1080
36718,69,143,2010,3601,1402,2199
36719,69,70,2010,247,143,104
36720,69,47,2010,40138,25471,14667
36721,69,71,2010,16865,8329,8536
36722,69,122,2010,1283,853,430
36723,69,160,2010,1168,475,693
36724,69,58,2010,606,328,278
36725,69,100,2010,14713,8772,5941
36726,69,59,2010,17889,10706,7183
36727,69,144,2010,92260,39462,52798
36728,69,8,2010,3160,1349,1811
36729,69,73,2010,112186,53709,58477
36730,69,101,2010,1224,679,545
36731,69,162,2010,21442,7170,14272
36732,69,60,2010,46370,24429,21941
36733,69,48,2010,7118,3961,3157
36734,69,9,2010,40410,14840,25570
36735,69,102,2010,592,336,256
36736,69,111,2010,4098,2286,1812
36737,69,112,2010,14955,9629,5326
36738,69,33,2010,1528510,807570,720940
36739,69,61,2010,79303,36708,42595
36740,69,35,2010,475337,251239,224098
36741,69,36,2010,857226,464348,392878
36742,69,126,2010,994,494,500
36743,69,23,2010,3017,1208,1809
36744,69,164,2010,3356,1096,2260
36745,69,63,2010,130129,65454,64675
36746,69,165,2010,2623,777,1846
36747,69,37,2010,34516,20436,14080
36748,69,64,2010,32005,17096,14909
36749,69,128,2010,5927,2352,3575
36750,69,115,2010,14794,7657,7137
36751,69,65,2010,80991,42017,38974
36752,69,10,2010,37625,17481,20144
36753,69,145,2010,0,0,0
36754,69,49,2010,16100,8986,7114
36755,69,74,2010,67890,36191,31699
36756,69,25,2010,42766,17179,25587
36757,69,169,2010,23344,11796,11548
36758,69,166,2010,11478,4407,7071
36759,69,93,2010,738,452,286
36760,69,146,2010,33215,10530,22685
36761,69,26,2010,1314223,624047,690176
36762,69,170,2010,5334,2858,2476
36763,69,130,2010,2088,1153,935
36764,69,38,2010,210327,123527,86800
36765,69,50,2010,83240,32767,50473
36766,69,131,2010,792,357,435
36767,69,114,2010,2747,1458,1289
36768,69,171,2010,34045,17947,16098
36769,69,1,2010,90977,47567,43410
36770,69,28,2010,2330,641,1689
36771,69,132,2010,744,412,332
36772,156,141,2010,11,3,8
36773,156,105,2010,11,5,6
36774,156,135,2010,95,32,63
36775,156,10,2010,17,8,9
36776,156,136,2010,13,3,10
36777,156,172,2010,189,31,158
36778,156,137,2010,25,12,13
36779,156,151,2010,13963,6248,7715
36780,156,120,2010,25,12,13
36781,156,68,2010,182,78,104
36782,156,155,2010,1337,624,713
36783,156,157,2010,114,42,72
36784,156,5,2010,708,275,433
36785,156,17,2010,38,16,22
36786,156,57,2010,192,74,118
36787,156,177,2010,46,16,30
36788,156,121,2010,13,3,10
36789,156,20,2010,818,319,499
36790,156,159,2010,24718,11542,13176
36791,156,160,2010,4175,1228,2947
36792,156,161,2010,11,4,7
36793,156,73,2010,152,67,85
36794,156,162,2010,57056,24244,32812
36795,156,9,2010,55,26,29
36796,156,33,2010,39,21,18
36797,156,36,2010,55,31,24
36798,156,126,2010,311,201,110
36799,156,164,2010,61,23,38
36800,156,165,2010,1939,974,965
36801,156,145,2010,21,5,16
36802,156,74,2010,121,53,68
36803,156,25,2010,43,20,23
36804,156,166,2010,73412,34279,39133
36805,156,142,2010,32,14,18
36806,156,50,2010,1130,580,550
36807,156,131,2010,7,4,3
36808,156,152,2010,48452,22640,25812
36809,55,144,2010,933,352,581
36810,55,65,2010,1942,1239,703
36811,55,50,2010,5317,2527,2790
36812,56,2,2010,6704,1317,5387
36813,56,51,2010,463157,218109,245048
36814,56,141,2010,1167,171,996
36815,56,52,2010,4,2,2
36816,56,134,2010,9,5,4
36817,56,75,2010,11,6,5
36818,56,76,2010,31,14,17
36819,56,103,2010,679,434,245
36820,56,11,2010,15130,8481,6649
36821,56,77,2010,1,0,1
36822,56,66,2010,2386,1618,768
36823,56,12,2010,536,328,208
36824,56,78,2010,23,12,11
36825,56,13,2010,24,9,15
36826,56,3,2010,10390,633,9757
36827,56,79,2010,11,3,8
36828,56,29,2010,1543,1151,392
36829,56,67,2010,5426,3171,2255
36830,56,95,2010,5,5,0
36831,56,151,2010,8,3,5
36832,56,4,2010,2,0,2
36833,56,53,2010,467,318,149
36834,56,147,2010,8,5,3
36835,56,105,2010,2347,1603,744
36836,56,30,2010,77194,49025,28169
36837,56,152,2010,84,7,77
36838,56,116,2010,141,65,76
36839,56,153,2010,14,8,6
36840,56,135,2010,490,232,258
36841,56,80,2010,0,0,0
36842,56,136,2010,19,11,8
36843,56,106,2010,389,249,140
36844,56,172,2010,3596,1698,1898
36845,56,173,2010,0,0,0
36846,56,107,2010,423,321,102
36847,56,117,2010,78,17,61
36848,56,137,2010,1497,822,675
36849,56,96,2010,40,33,7
36850,56,54,2010,454,317,137
36851,56,81,2010,373,264,109
36852,56,14,2010,22882,12806,10076
36853,56,31,2010,4691,2866,1825
36854,56,176,2010,36,17,19
36855,56,137,2010,222,119,103
36856,56,39,2010,955,631,324
36857,56,118,2010,41,23,18
36858,56,82,2010,19,19,0
36859,56,83,2010,599,493,106
36860,56,108,2010,89,70,19
36861,56,142,2010,29935,13105,16830
36862,56,97,2010,53,41,12
36863,56,138,2010,1,1,0
36864,56,119,2010,296,159,137
36865,56,40,2010,137,106,31
36866,56,148,2010,22,6,16
36867,56,120,2010,2563,1748,815
36868,56,41,2010,1,1,0
36869,56,42,2010,816,688,128
36870,56,68,2010,7090,4323,2767
36871,56,109,2010,0,0,0
36872,56,139,2010,8,6,2
36873,56,155,2010,53,8,45
36874,56,15,2010,88308,51832,36476
36875,56,69,2010,121089,65577,55512
36876,56,156,2010,632,172,460
36877,56,55,2010,5,2,3
36878,56,84,2010,2,1,1
36879,56,98,2010,32,26,6
36880,56,157,2010,193,17,176
36881,56,158,2010,0,0,0
36882,56,110,2010,11,8,3
36883,56,85,2010,40,23,17
36884,56,99,2010,53,41,12
36885,56,32,2010,1830,1220,610
36886,56,43,2010,57,33,24
36887,56,5,2010,10751,2077,8674
36888,56,6,2010,2017,542,1475
36889,56,16,2010,9200,1675,7525
36890,56,44,2010,625,422,203
36891,56,45,2010,5,2,3
36892,56,17,2010,754,340,414
36893,56,57,2010,6674,3863,2811
36894,56,86,2010,12,8,4
36895,56,177,2010,539,413,126
36896,56,18,2010,861,217,644
36897,56,167,2010,28574,15405,13169
36898,56,121,2010,481,284,197
36899,56,19,2010,148,63,85
36900,56,168,2010,580,322,258
36901,56,46,2010,373,302,71
36902,56,20,2010,2173,921,1252
36903,56,149,2010,0,0,0
36904,56,159,2010,33,14,19
36905,56,143,2010,679,273,406
36906,56,70,2010,10,7,3
36907,56,47,2010,577,493,84
36908,56,71,2010,147,79,68
36909,56,122,2010,138,81,57
36910,56,7,2010,3,2,1
36911,56,160,2010,31,12,19
36912,56,58,2010,95,69,26
36913,56,161,2010,125,5,120
36914,56,124,2010,40,33,7
36915,56,100,2010,420,333,87
36916,56,72,2010,47,23,24
36917,56,87,2010,83,44,39
36918,56,144,2010,2198,617,1581
36919,56,125,2010,68,40,28
36920,56,150,2010,8,3,5
36921,56,8,2010,53,13,40
36922,56,73,2010,3966,2581,1385
36923,56,101,2010,170,87,83
36924,56,162,2010,3026,1069,1957
36925,56,60,2010,2297,1308,989
36926,56,48,2010,547,361,186
36927,56,21,2010,5,3,2
36928,56,9,2010,33141,1277,31864
36929,56,102,2010,166,87,79
36930,56,111,2010,84,68,16
36931,56,112,2010,308,219,89
36932,56,33,2010,16587,10630,5957
36933,56,61,2010,344,224,120
36934,56,88,2010,0,0,0
36935,56,22,2010,1168,628,540
36936,56,35,2010,48918,27831,21087
36937,56,36,2010,57389,36818,20571
36938,56,126,2010,103,22,81
36939,56,90,2010,2,1,1
36940,56,92,2010,7,6,1
36941,56,62,2010,1,1,0
36942,56,140,2010,7,2,5
36943,56,23,2010,451,219,232
36944,56,164,2010,678,57,621
36945,56,63,2010,4641,3034,1607
36946,56,127,2010,26,23,3
36947,56,165,2010,186,62,124
36948,56,37,2010,914,745,169
36949,56,64,2010,138,106,32
36950,56,128,2010,785,180,605
36951,56,115,2010,7317,4136,3181
36952,56,65,2010,1250,833,417
36953,56,10,2010,941,580,361
36954,56,145,2010,1965,784,1181
36955,56,113,2010,9,7,2
36956,56,49,2010,5739,3401,2338
36957,56,74,2010,3916,2290,1626
36958,56,25,2010,7459,1921,5538
36959,56,169,2010,103,70,33
36960,56,166,2010,14,3,11
36961,56,93,2010,18,14,4
36962,56,146,2010,674,147,527
36963,56,26,2010,35395,19805,15590
36964,56,170,2010,123,73,50
36965,56,130,2010,148,91,57
36966,56,38,2010,20604,15992,4612
36967,56,27,2010,91,40,51
36968,56,50,2010,18723,11151,7572
36969,56,131,2010,419,192,227
36970,56,114,2010,119,72,47
36971,56,171,2010,8784,5048,3736
36972,56,1,2010,223,116,107
36973,56,28,2010,29,12,17
36974,56,132,2010,252,143,109
36975,56,133,2010,445,249,196
36976,84,76,2010,38,19,19
36977,84,78,2010,30,15,15
36978,84,79,2010,176,88,88
36979,84,82,2010,74,37,37
36980,84,110,2010,337,285,52
36981,84,86,2010,114,58,56
36982,84,87,2010,10,5,5
36983,84,90,2010,15,7,8
36984,84,91,2010,162,81,81
36985,84,92,2010,373,286,87
36986,84,93,2010,2170,1450,720
36987,98,103,2010,482,185,297
36988,98,105,2010,209,87,122
36989,98,95,2010,796,391,405
36990,98,106,2010,262,105,157
36991,98,172,2010,571,264,307
36992,98,107,2010,1005,468,537
36993,98,96,2010,1010,495,515
36994,98,81,2010,574,233,341
36995,98,83,2010,95,38,57
36996,98,108,2010,145,63,82
36997,98,97,2010,16691,13092,3599
36998,98,68,2010,224,67,157
36999,98,109,2010,17,8,9
37000,98,69,2010,556,202,354
37001,98,85,2010,12,4,8
37002,98,99,2010,7292,4013,3279
37003,98,6,2010,16,5,11
37004,98,17,2010,114,41,73
37005,98,57,2010,320,94,226
37006,98,177,2010,128,48,80
37007,98,20,2010,22,3,19
37008,98,100,2010,15250,6358,8892
37009,98,73,2010,122,61,61
37010,98,101,2010,7443,3502,3941
37011,98,9,2010,23,12,11
37012,98,102,2010,261,126,135
37013,98,111,2010,51,25,26
37014,98,112,2010,397,171,226
37015,98,61,2010,25,2,23
37016,98,88,2010,88,37,51
37017,98,23,2010,28,3,25
37018,98,65,2010,1148,431,717
37019,98,49,2010,41,12,29
37020,98,74,2010,134,44,90
37021,98,25,2010,68,22,46
37022,98,26,2010,22,13,9
37023,98,142,2010,28,27,1
37024,98,50,2010,194,69,125
37025,98,114,2010,122,43,79
37026,157,2,2010,0,0,0
37027,157,51,2010,0,0,0
37028,157,141,2010,0,0,0
37029,157,52,2010,0,0,0
37030,157,134,2010,0,0,0
37031,157,76,2010,0,0,0
37032,157,12,2010,0,0,0
37033,157,103,2010,0,0,0
37034,157,66,2010,0,0,0
37035,157,78,2010,0,0,0
37036,157,13,2010,0,0,0
37037,157,3,2010,0,0,0
37038,157,11,2010,0,0,0
37039,157,79,2010,0,0,0
37040,157,67,2010,81,28,53
37041,157,4,2010,0,0,0
37042,157,53,2010,0,0,0
37043,157,147,2010,0,0,0
37044,157,105,2010,97,27,70
37045,157,95,2010,0,0,0
37046,157,30,2010,0,0,0
37047,157,116,2010,0,0,0
37048,157,135,2010,0,0,0
37049,157,153,2010,37,14,23
37050,157,10,2010,0,0,0
37051,157,136,2010,0,0,0
37052,157,106,2010,0,0,0
37053,157,172,2010,81,16,65
37054,157,107,2010,0,0,0
37055,157,117,2010,0,0,0
37056,157,137,2010,0,0,0
37057,157,137,2010,0,0,0
37058,157,96,2010,0,0,0
37059,157,54,2010,0,0,0
37060,157,81,2010,1875,757,1118
37061,157,151,2010,928,291,637
37062,157,39,2010,0,0,0
37063,157,82,2010,0,0,0
37064,157,83,2010,0,0,0
37065,157,108,2010,0,0,0
37066,157,97,2010,0,0,0
37067,157,138,2010,0,0,0
37068,157,120,2010,0,0,0
37069,157,119,2010,0,0,0
37070,157,42,2010,0,0,0
37071,157,68,2010,648,195,453
37072,157,118,2010,0,0,0
37073,157,139,2010,0,0,0
37074,157,155,2010,319,126,193
37075,157,69,2010,0,0,0
37076,157,156,2010,0,0,0
37077,157,85,2010,0,0,0
37078,157,99,2010,0,0,0
37079,157,5,2010,0,0,0
37080,157,17,2010,0,0,0
37081,157,57,2010,0,0,0
37082,157,177,2010,46,17,29
37083,157,18,2010,0,0,0
37084,157,121,2010,0,0,0
37085,157,176,2010,0,0,0
37086,157,20,2010,0,0,0
37087,157,149,2010,0,0,0
37088,157,46,2010,0,0,0
37089,157,159,2010,29367,16151,13216
37090,157,143,2010,0,0,0
37091,157,70,2010,0,0,0
37092,157,122,2010,0,0,0
37093,157,123,2010,0,0,0
37094,157,160,2010,54950,30173,24777
37095,157,161,2010,1351,552,799
37096,157,124,2010,0,0,0
37097,157,144,2010,0,0,0
37098,157,125,2010,0,0,0
37099,157,150,2010,0,0,0
37100,157,8,2010,0,0,0
37101,157,73,2010,0,0,0
37102,157,101,2010,0,0,0
37103,157,162,2010,359,63,296
37104,157,48,2010,0,0,0
37105,157,9,2010,0,0,0
37106,157,33,2010,0,0,0
37107,157,61,2010,144,0,144
37108,157,158,2010,5032,2159,2873
37109,157,35,2010,0,0,0
37110,157,36,2010,149,30,119
37111,157,126,2010,0,0,0
37112,157,92,2010,0,0,0
37113,157,140,2010,0,0,0
37114,157,23,2010,120,42,78
37115,157,164,2010,3571,1407,2164
37116,157,63,2010,0,0,0
37117,157,127,2010,0,0,0
37118,157,165,2010,13557,7456,6101
37119,157,1,2010,0,0,0
37120,157,64,2010,0,0,0
37121,157,128,2010,0,0,0
37122,157,115,2010,0,0,0
37123,157,133,2010,0,0,0
37124,157,65,2010,1022,419,603
37125,157,129,2010,0,0,0
37126,157,145,2010,0,0,0
37127,157,148,2010,0,0,0
37128,157,49,2010,0,0,0
37129,157,74,2010,0,0,0
37130,157,25,2010,15,1,14
37131,157,169,2010,0,0,0
37132,157,166,2010,935,256,679
37133,157,146,2010,0,0,0
37134,157,26,2010,0,0,0
37135,157,130,2010,0,0,0
37136,157,38,2010,25,8,17
37137,157,142,2010,0,0,0
37138,157,50,2010,0,0,0
37139,157,131,2010,0,0,0
37140,157,152,2010,698,250,448
37141,157,114,2010,0,0,0
37142,157,171,2010,0,0,0
37143,158,153,2010,521,315,206
37144,158,68,2010,104,31,73
37145,158,155,2010,1410,700,710
37146,158,157,2010,4657,2282,2375
37147,158,159,2010,847,311,536
37148,158,161,2010,527,260,267
37149,158,61,2010,776,397,379
37150,158,164,2010,10455,5541,4914
37151,158,165,2010,766,375,391
37152,110,76,2010,9,5,4
37153,110,78,2010,8,4,4
37154,110,79,2010,142,64,78
37155,110,105,2010,1135,424,711
37156,110,172,2010,610,235,375
37157,110,82,2010,23,9,14
37158,110,84,2010,102,44,58
37159,110,86,2010,157,68,89
37160,110,91,2010,116,46,70
37161,110,92,2010,195,84,111
37162,110,113,2010,2443,1172,1271
37163,110,93,2010,468,199,269
37164,110,50,2010,305,131,174
37165,85,103,2010,417,178,239
37166,85,66,2010,151,23,128
37167,85,106,2010,298,106,192
37168,85,172,2010,311,131,180
37169,85,107,2010,743,364,379
37170,85,96,2010,244,150,94
37171,85,81,2010,1080,475,605
37172,85,83,2010,2164,953,1211
37173,85,68,2010,397,154,243
37174,85,69,2010,805,324,481
37175,85,57,2010,1102,322,780
37176,85,177,2010,197,90,107
37177,85,100,2010,274,156,118
37178,85,112,2010,315,127,188
37179,85,88,2010,1390,757,633
37180,85,65,2010,1166,424,742
37181,85,74,2010,338,121,217
37182,85,114,2010,256,155,101
37183,99,103,2010,136,59,77
37184,99,67,2010,18,6,12
37185,99,105,2010,169,100,69
37186,99,95,2010,260,123,137
37187,99,80,2010,64,31,33
37188,99,106,2010,221,109,112
37189,99,172,2010,425,155,270
37190,99,107,2010,618,270,348
37191,99,96,2010,613,285,328
37192,99,81,2010,436,139,297
37193,99,83,2010,96,36,60
37194,99,108,2010,328,107,221
37195,99,97,2010,6303,3390,2913
37196,99,68,2010,103,44,59
37197,99,69,2010,208,72,136
37198,99,98,2010,3280,1613,1667
37199,99,85,2010,31,4,27
37200,99,17,2010,64,22,42
37201,99,57,2010,186,46,140
37202,99,86,2010,19,3,16
37203,99,177,2010,99,45,54
37204,99,18,2010,29,14,15
37205,99,176,2010,45,14,31
37206,99,100,2010,1116,563,553
37207,99,73,2010,65,20,45
37208,99,101,2010,5530,2737,2793
37209,99,102,2010,284,122,162
37210,99,111,2010,25,10,15
37211,99,112,2010,274,117,157
37212,99,88,2010,92,35,57
37213,99,36,2010,18,8,10
37214,99,65,2010,374,162,212
37215,99,49,2010,22,10,12
37216,99,74,2010,44,13,31
37217,99,50,2010,73,22,51
37218,99,114,2010,48,18,30
37219,173,3,2010,435,166,269
37220,173,172,2010,2260045,1251904,1008141
37221,173,174,2010,69830,38572,31258
37222,173,68,2010,2149,763,1386
37223,173,69,2010,1932,538,1394
37224,173,5,2010,17632,9337,8295
37225,173,44,2010,681,297,384
37226,173,57,2010,629,244,385
37227,173,177,2010,13892,6940,6952
37228,173,8,2010,9141,4814,4327
37229,173,73,2010,999,364,635
37230,173,9,2010,7398,3086,4312
37231,173,61,2010,107,61,46
37232,173,36,2010,86,74,12
37233,173,65,2010,393,201,192
37234,173,10,2010,766,510,256
37235,173,74,2010,711,223,488
37236,173,50,2010,17301,6755,10546
37237,173,1,2010,10704,6797,3907
37238,32,2,2010,1821,686,1135
37239,32,51,2010,189,94,95
37240,32,141,2010,686,166,520
37241,32,52,2010,0,0,0
37242,32,134,2010,80,27,53
37243,32,76,2010,0,0,0
37244,32,103,2010,327,149,178
37245,32,11,2010,212,114,98
37246,32,77,2010,0,0,0
37247,32,66,2010,8097,3681,4416
37248,32,12,2010,151,80,71
37249,32,78,2010,7,2,5
37250,32,13,2010,14,6,8
37251,32,3,2010,68,8,60
37252,32,79,2010,5,2,3
37253,32,29,2010,233,153,80
37254,32,67,2010,1620,784,836
37255,32,95,2010,1,0,1
37256,32,151,2010,26,5,21
37257,32,4,2010,0,0,0
37258,32,53,2010,387,161,226
37259,32,147,2010,6,2,4
37260,32,105,2010,507,232,275
37261,32,30,2010,2096,1122,974
37262,32,152,2010,0,0,0
37263,32,116,2010,0,0,0
37264,32,153,2010,0,0,0
37265,32,135,2010,201,54,147
37266,32,80,2010,0,0,0
37267,32,136,2010,1,1,0
37268,32,106,2010,158,74,84
37269,32,172,2010,11058,5088,5970
37270,32,107,2010,199,93,106
37271,32,117,2010,0,0,0
37272,32,137,2010,81,13,68
37273,32,96,2010,32,9,23
37274,32,54,2010,2338,1236,1102
37275,32,81,2010,612,347,265
37276,32,14,2010,277,135,142
37277,32,31,2010,1596,982,614
37278,32,176,2010,0,0,0
37279,32,137,2010,26,8,18
37280,32,39,2010,363,149,214
37281,32,118,2010,0,0,0
37282,32,82,2010,0,0,0
37283,32,83,2010,36,15,21
37284,32,108,2010,112,41,71
37285,32,142,2010,775,168,607
37286,32,97,2010,13,8,5
37287,32,138,2010,0,0,0
37288,32,119,2010,11,6,5
37289,32,40,2010,126,93,33
37290,32,148,2010,0,0,0
37291,32,120,2010,132,34,98
37292,32,41,2010,0,0,0
37293,32,42,2010,699,355,344
37294,32,68,2010,3830,1790,2040
37295,32,139,2010,5,1,4
37296,32,155,2010,11,5,6
37297,32,15,2010,212,95,117
37298,32,69,2010,31209,15887,15322
37299,32,156,2010,124,41,83
37300,32,56,2010,1324,669,655
37301,32,84,2010,5,1,4
37302,32,98,2010,18,9,9
37303,32,157,2010,43,6,37
37304,32,158,2010,8,0,8
37305,32,110,2010,5,1,4
37306,32,85,2010,0,0,0
37307,32,99,2010,11,5,6
37308,32,43,2010,130,69,61
37309,32,5,2010,1108,386,722
37310,32,6,2010,2037,769,1268
37311,32,16,2010,1101,344,757
37312,32,44,2010,805,386,419
37313,32,17,2010,1683,689,994
37314,32,57,2010,3824,1410,2414
37315,32,86,2010,30,9,21
37316,32,177,2010,1347,657,690
37317,32,18,2010,395,99,296
37318,32,167,2010,531,274,257
37319,32,121,2010,88,40,48
37320,32,19,2010,175,59,116
37321,32,168,2010,132,101,31
37322,32,46,2010,142,105,37
37323,32,20,2010,344,80,264
37324,32,149,2010,6,1,5
37325,32,159,2010,33,9,24
37326,32,143,2010,320,112,208
37327,32,70,2010,7,5,2
37328,32,47,2010,145,81,64
37329,32,71,2010,138,62,76
37330,32,122,2010,32,19,13
37331,32,123,2010,0,0,0
37332,32,160,2010,20,2,18
37333,32,58,2010,37,19,18
37334,32,161,2010,5,0,5
37335,32,124,2010,51,22,29
37336,32,100,2010,424,200,224
37337,32,72,2010,5,1,4
37338,32,59,2010,39,14,25
37339,32,144,2010,188,52,136
37340,32,125,2010,20,7,13
37341,32,150,2010,7,2,5
37342,32,8,2010,56,19,37
37343,32,73,2010,2701,1107,1594
37344,32,101,2010,23,12,11
37345,32,162,2010,1172,374,798
37346,32,60,2010,144,52,92
37347,32,48,2010,1161,702,459
37348,32,21,2010,17,12,5
37349,32,9,2010,232,75,157
37350,32,102,2010,26,8,18
37351,32,111,2010,20,12,8
37352,32,112,2010,219,105,114
37353,32,33,2010,4033,2624,1409
37354,32,61,2010,330,128,202
37355,32,22,2010,33,14,19
37356,32,35,2010,214330,112580,101750
37357,32,36,2010,4500,2830,1670
37358,32,126,2010,18,8,10
37359,32,90,2010,5,1,4
37360,32,91,2010,0,0,0
37361,32,92,2010,5,2,3
37362,32,62,2010,0,0,0
37363,32,23,2010,325,87,238
37364,32,164,2010,24,6,18
37365,32,63,2010,24689,12261,12428
37366,32,127,2010,0,0,0
37367,32,165,2010,30,1,29
37368,32,37,2010,22121,13901,8220
37369,32,64,2010,413,200,213
37370,32,128,2010,399,85,314
37371,32,115,2010,337,156,181
37372,32,65,2010,1202,581,621
37373,32,10,2010,52,21,31
37374,32,145,2010,173,38,135
37375,32,113,2010,0,0,0
37376,32,49,2010,1530,770,760
37377,32,74,2010,2218,1017,1201
37378,32,25,2010,1241,302,939
37379,32,169,2010,18,8,10
37380,32,166,2010,8,1,7
37381,32,93,2010,14,8,6
37382,32,146,2010,189,29,160
37383,32,26,2010,2128,636,1492
37384,32,170,2010,0,0,0
37385,32,130,2010,32,13,19
37386,32,38,2010,29075,17235,11840
37387,32,27,2010,181,80,101
37388,32,50,2010,5367,2233,3134
37389,32,131,2010,57,18,39
37390,32,114,2010,68,38,30
37391,32,171,2010,117,66,51
37392,32,1,2010,3440,1752,1688
37393,32,28,2010,274,79,195
37394,32,132,2010,18,12,6
37395,32,133,2010,39,13,26
37396,43,2,2010,6,0,6
37397,43,51,2010,39,21,18
37398,43,141,2010,24,7,17
37399,43,52,2010,0,0,0
37400,43,134,2010,39,11,28
37401,43,76,2010,0,0,0
37402,43,103,2010,26,10,16
37403,43,11,2010,5,4,1
37404,43,77,2010,1,0,1
37405,43,66,2010,143,84,59
37406,43,12,2010,7,5,2
37407,43,78,2010,4,2,2
37408,43,13,2010,1,0,1
37409,43,3,2010,0,0,0
37410,43,79,2010,2,1,1
37411,43,29,2010,40,28,12
37412,43,67,2010,104,51,53
37413,43,95,2010,2,1,1
37414,43,151,2010,0,0,0
37415,43,53,2010,144,70,74
37416,43,105,2010,104,78,26
37417,43,30,2010,135,72,63
37418,43,152,2010,1,0,1
37419,43,153,2010,41,22,19
37420,43,135,2010,4,0,4
37421,43,136,2010,0,0,0
37422,43,106,2010,81,38,43
37423,43,172,2010,483,312,171
37424,43,107,2010,154,93,61
37425,43,137,2010,1,1,0
37426,43,96,2010,5,2,3
37427,43,54,2010,148,70,78
37428,43,81,2010,35,20,15
37429,43,14,2010,5,1,4
37430,43,31,2010,156,83,73
37431,43,176,2010,2,0,2
37432,43,137,2010,2,0,2
37433,43,39,2010,2912,1491,1421
37434,43,118,2010,1,0,1
37435,43,82,2010,2,1,1
37436,43,83,2010,21,14,7
37437,43,108,2010,25,16,9
37438,43,142,2010,27,5,22
37439,43,97,2010,11,5,6
37440,43,138,2010,3,2,1
37441,43,119,2010,3,0,3
37442,43,40,2010,137,79,58
37443,43,120,2010,62,35,27
37444,43,41,2010,324,192,132
37445,43,42,2010,182,125,57
37446,43,68,2010,444,211,233
37447,43,139,2010,1,1,0
37448,43,155,2010,7,3,4
37449,43,15,2010,20,12,8
37450,43,69,2010,1699,1026,673
37451,43,156,2010,44,27,17
37452,43,55,2010,1,0,1
37453,43,56,2010,25,11,14
37454,43,98,2010,32,15,17
37455,43,157,2010,14,8,6
37456,43,158,2010,1,0,1
37457,43,110,2010,20,13,7
37458,43,85,2010,7,5,2
37459,43,99,2010,32,18,14
37460,43,32,2010,154,68,86
37461,43,5,2010,272,147,125
37462,43,6,2010,35,14,21
37463,43,16,2010,48,20,28
37464,43,44,2010,80,26,54
37465,43,17,2010,31,11,20
37466,43,57,2010,218,88,130
37467,43,86,2010,17,12,5
37468,43,177,2010,86,55,31
37469,43,18,2010,12,7,5
37470,43,167,2010,15,13,2
37471,43,121,2010,52,39,13
37472,43,19,2010,2,0,2
37473,43,168,2010,1,1,0
37474,43,46,2010,645,309,336
37475,43,20,2010,30,10,20
37476,43,159,2010,0,0,0
37477,43,143,2010,2,0,2
37478,43,70,2010,0,0,0
37479,43,47,2010,1444,629,815
37480,43,71,2010,110,58,52
37481,43,122,2010,2,1,1
37482,43,123,2010,3,1,2
37483,43,160,2010,1,0,1
37484,43,58,2010,4,2,2
37485,43,161,2010,1,0,1
37486,43,124,2010,7,4,3
37487,43,100,2010,68,39,29
37488,43,72,2010,1,1,0
37489,43,59,2010,3,3,0
37490,43,144,2010,152,55,97
37491,43,125,2010,14,7,7
37492,43,150,2010,36,21,15
37493,43,8,2010,94,40,54
37494,43,73,2010,297,149,148
37495,43,101,2010,5,4,1
37496,43,162,2010,58,25,33
37497,43,60,2010,31,13,18
37498,43,48,2010,985,531,454
37499,43,21,2010,0,0,0
37500,43,9,2010,26,9,17
37501,43,102,2010,6,2,4
37502,43,111,2010,3,0,3
37503,43,112,2010,72,46,26
37504,43,33,2010,10091,4354,5737
37505,43,61,2010,607,205,402
37506,43,88,2010,0,0,0
37507,43,22,2010,2,2,0
37508,43,35,2010,203,87,116
37509,43,36,2010,298,191,107
37510,43,126,2010,1,0,1
37511,43,92,2010,0,0,0
37512,43,62,2010,0,0,0
37513,43,23,2010,3,2,1
37514,43,164,2010,14,5,9
37515,43,63,2010,389,208,181
37516,43,165,2010,13,5,8
37517,43,37,2010,231,70,161
37518,43,64,2010,29,12,17
37519,43,128,2010,1,1,0
37520,43,115,2010,66,42,24
37521,43,65,2010,288,122,166
37522,43,10,2010,162,102,60
37523,43,145,2010,0,0,0
37524,43,49,2010,1847,959,888
37525,43,74,2010,145,76,69
37526,43,25,2010,19,6,13
37527,43,169,2010,4,4,0
37528,43,166,2010,2,1,1
37529,43,93,2010,3,2,1
37530,43,146,2010,16,4,12
37531,43,26,2010,61,23,38
37532,43,170,2010,1,1,0
37533,43,130,2010,22,17,5
37534,43,38,2010,210,136,74
37535,43,27,2010,2,1,1
37536,43,50,2010,1093,429,664
37537,43,131,2010,21,13,8
37538,43,114,2010,8,2,6
37539,43,171,2010,5,3,2
37540,43,1,2010,480,266,214
37541,43,28,2010,1,1,0
37542,43,132,2010,7,6,1
37543,43,133,2010,10,8,2
37544,5,2,2010,18085,9342,8743
37545,5,3,2010,2855334,1380839,1474495
37546,5,4,2010,10831,5411,5420
37547,5,172,2010,100003,48472,51531
37548,5,68,2010,1992,1045,947
37549,5,69,2010,2734,1407,1327
37550,5,6,2010,2518,1322,1196
37551,5,16,2010,770,319,451
37552,5,177,2010,2063,1167,896
37553,5,167,2010,497,288,209
37554,5,121,2010,8874,4649,4225
37555,5,19,2010,13519,6838,6681
37556,5,7,2010,992,482,510
37557,5,124,2010,399,247,152
37558,5,8,2010,841906,545028,296878
37559,5,162,2010,1037,418,619
37560,5,9,2010,956166,458194,497972
37561,5,61,2010,383,207,176
37562,5,23,2010,16579,7838,8741
37563,5,10,2010,212022,106218,105804
37564,5,26,2010,151,72,79
37565,5,36,2010,1433,788,645
37566,5,130,2010,51990,33963,18027
37567,5,27,2010,44142,21165,22977
37568,5,50,2010,12622,6441,6181
37569,5,1,2010,1520,929,591
37570,5,132,2010,1666,1044,622
37571,6,2,2010,2572558,1160829,1411729
37572,6,11,2010,1517,797,720
37573,6,12,2010,7349,3869,3480
37574,6,16,2010,99556,45875,53681
37575,6,9,2010,19207,8224,10983
37576,6,26,2010,1558,714,844
37577,6,170,2010,2999,1256,1743
37578,16,2,2010,320,164,156
37579,16,119,2010,826,290,536
37580,16,5,2010,238,102,136
37581,16,6,2010,18029,9149,8880
37582,16,18,2010,10580,3449,7131
37583,16,19,2010,410,146,264
37584,16,20,2010,1558,711,847
37585,16,161,2010,205,58,147
37586,16,144,2010,600,248,352
37587,16,9,2010,698,203,495
37588,16,36,2010,280,96,184
37589,16,23,2010,690,216,474
37590,16,128,2010,424,131,293
37591,16,129,2010,302,45,257
37592,16,145,2010,3882,565,3317
37593,16,25,2010,6342,2574,3768
37594,16,27,2010,295,76,219
37595,16,146,2010,320,51,269
37596,16,26,2010,17961,6965,10996
37597,16,142,2010,14702,3067,11635
37598,16,28,2010,2049,464,1585
37599,44,2,2010,145,28,117
37600,44,51,2010,291,120,171
37601,44,141,2010,576,166,410
37602,44,52,2010,2,2,0
37603,44,134,2010,470,234,236
37604,44,75,2010,1,1,0
37605,44,76,2010,2,1,1
37606,44,103,2010,320,169,151
37607,44,11,2010,52,25,27
37608,44,77,2010,7,4,3
37609,44,66,2010,767,512,255
37610,44,12,2010,49,23,26
37611,44,78,2010,26,12,14
37612,44,13,2010,80,42,38
37613,44,3,2010,3164,924,2240
37614,44,79,2010,18,10,8
37615,44,29,2010,598,338,260
37616,44,67,2010,1603,878,725
37617,44,95,2010,2,2,0
37618,44,151,2010,33,21,12
37619,44,4,2010,7,2,5
37620,44,53,2010,627,331,296
37621,44,147,2010,78,36,42
37622,44,105,2010,10075,4171,5904
37623,44,30,2010,1932,1037,895
37624,44,152,2010,9,3,6
37625,44,116,2010,47,23,24
37626,44,153,2010,4,1,3
37627,44,135,2010,339,196,143
37628,44,80,2010,24,14,10
37629,44,136,2010,10,3,7
37630,44,106,2010,139,81,58
37631,44,172,2010,12416,6329,6087
37632,44,173,2010,1847,1099,748
37633,44,137,2010,2466,1255,1211
37634,44,96,2010,11,7,4
37635,44,54,2010,495,240,255
37636,44,81,2010,81,44,37
37637,44,14,2010,282,141,141
37638,44,31,2010,5953,2729,3224
37639,44,176,2010,128,77,51
37640,44,137,2010,51,27,24
37641,44,39,2010,959,559,400
37642,44,118,2010,1,1,0
37643,44,82,2010,1,1,0
37644,44,83,2010,10,4,6
37645,44,108,2010,38,26,12
37646,44,142,2010,521,166,355
37647,44,97,2010,26,15,11
37648,44,119,2010,37,14,23
37649,44,40,2010,2686,1567,1119
37650,44,148,2010,21,12,9
37651,44,120,2010,151,83,68
37652,44,41,2010,3,2,1
37653,44,42,2010,946,724,222
37654,44,68,2010,10912,6306,4606
37655,44,139,2010,4,2,2
37656,44,155,2010,56,26,30
37657,44,15,2010,250,113,137
37658,44,69,2010,14065,8641,5424
37659,44,156,2010,493,272,221
37660,44,55,2010,38,20,18
37661,44,56,2010,623,276,347
37662,44,84,2010,14,7,7
37663,44,98,2010,122,64,58
37664,44,157,2010,49,22,27
37665,44,158,2010,1,1,0
37666,44,110,2010,28,17,11
37667,44,85,2010,4,3,1
37668,44,99,2010,12,8,4
37669,44,32,2010,8033,3671,4362
37670,44,43,2010,37,20,17
37671,44,5,2010,19348,9886,9462
37672,44,6,2010,436,149,287
37673,44,16,2010,443,172,271
37674,44,17,2010,215,99,116
37675,44,57,2010,7743,3832,3911
37676,44,86,2010,117,80,37
37677,44,177,2010,518,347,171
37678,44,18,2010,109,48,61
37679,44,167,2010,254,138,116
37680,44,121,2010,472,274,198
37681,44,19,2010,197,80,117
37682,44,168,2010,31,17,14
37683,44,46,2010,21660,11604,10056
37684,44,20,2010,130,56,74
37685,44,149,2010,38,21,17
37686,44,159,2010,105,46,59
37687,44,143,2010,430,185,245
37688,44,70,2010,2,1,1
37689,44,47,2010,37759,19330,18429
37690,44,71,2010,153,73,80
37691,44,122,2010,12,8,4
37692,44,123,2010,74,35,39
37693,44,7,2010,2,2,0
37694,44,160,2010,28,15,13
37695,44,58,2010,364,201,163
37696,44,161,2010,8,3,5
37697,44,124,2010,3163,1380,1783
37698,44,100,2010,299,208,91
37699,44,72,2010,7,2,5
37700,44,87,2010,1,1,0
37701,44,144,2010,268,82,186
37702,44,125,2010,38,19,19
37703,44,150,2010,37,23,14
37704,44,8,2010,133,43,90
37705,44,73,2010,4875,2598,2277
37706,44,101,2010,16,9,7
37707,44,162,2010,21433,12237,9196
37708,44,60,2010,641,274,367
37709,44,48,2010,299,159,140
37710,44,21,2010,48,24,24
37711,44,9,2010,9025,3314,5711
37712,44,102,2010,16,10,6
37713,44,111,2010,26,18,8
37714,44,112,2010,124,82,42
37715,44,33,2010,124820,53456,71364
37716,44,61,2010,2434,1057,1377
37717,44,22,2010,34,17,17
37718,44,35,2010,19499,10303,9196
37719,44,36,2010,6432,3491,2941
37720,44,126,2010,78,47,31
37721,44,90,2010,2,1,1
37722,44,91,2010,7,2,5
37723,44,92,2010,2,1,1
37724,44,23,2010,420,207,213
37725,44,164,2010,22,12,10
37726,44,127,2010,11,7,4
37727,44,165,2010,192,79,113
37728,44,37,2010,11589,4848,6741
37729,44,64,2010,206,100,106
37730,44,128,2010,520,246,274
37731,44,115,2010,8794,4635,4159
37732,44,65,2010,7588,5040,2548
37733,44,10,2010,233,98,135
37734,44,145,2010,576,209,367
37735,44,113,2010,12,8,4
37736,44,49,2010,1829,1269,560
37737,44,74,2010,541,329,212
37738,44,25,2010,112,35,77
37739,44,169,2010,21,12,9
37740,44,166,2010,112,45,67
37741,44,93,2010,109,70,39
37742,44,146,2010,98,20,78
37743,44,26,2010,479,116,363
37744,44,170,2010,4,3,1
37745,44,94,2010,1,0,1
37746,44,130,2010,146,81,65
37747,44,38,2010,4468,2119,2349
37748,44,27,2010,197,96,101
37749,44,50,2010,249392,129646,119746
37750,44,131,2010,122,69,53
37751,44,114,2010,54,31,23
37752,44,171,2010,90,53,37
37753,44,1,2010,622,392,230
37754,44,28,2010,30,13,17
37755,44,132,2010,333,178,155
37756,44,133,2010,3033,1635,1398
37757,45,44,2010,2116,1330,786
37758,45,115,2010,577,325,252
37759,45,50,2010,37521,18599,18922
37760,17,2,2010,2462,1284,1178
37761,17,141,2010,44292,23914,20378
37762,17,12,2010,13118,6953,6165
37763,17,103,2010,38148,20145,18003
37764,17,66,2010,4910,2713,2197
37765,17,67,2010,5811,3218,2593
37766,17,105,2010,8661,4891,3770
37767,17,30,2010,16128,8988,7140
37768,17,29,2010,22417,12622,9795
37769,17,106,2010,3283,1769,1514
37770,17,172,2010,582,323,259
37771,17,107,2010,2678,1572,1106
37772,17,39,2010,1858,1253,605
37773,17,120,2010,78029,39285,38744
37774,17,42,2010,299,220,79
37775,17,68,2010,40576,22181,18395
37776,17,15,2010,9034,4825,4209
37777,17,69,2010,22937,12991,9946
37778,17,56,2010,2991,1637,1354
37779,17,32,2010,12115,6735,5380
37780,17,5,2010,18389,9595,8794
37781,17,6,2010,50732,26081,24651
37782,17,16,2010,65732,34570,31162
37783,17,57,2010,5066,2820,2246
37784,17,167,2010,13218,7210,6008
37785,17,168,2010,2442,1369,1073
37786,17,20,2010,6043,3425,2618
37787,17,46,2010,3812,2143,1669
37788,17,143,2010,16748,9175,7573
37789,17,47,2010,3751,2172,1579
37790,17,100,2010,2522,1304,1218
37791,17,144,2010,158158,83294,74864
37792,17,73,2010,4955,2906,2049
37793,17,112,2010,2366,1284,1082
37794,17,33,2010,57485,32277,25208
37795,17,35,2010,100528,56130,44398
37796,17,36,2010,111148,63412,47736
37797,17,115,2010,11365,6124,5241
37798,17,65,2010,1833,1031,802
37799,17,49,2010,667,400,267
37800,17,74,2010,3736,2188,1548
37801,17,25,2010,9195,5027,4168
37802,17,169,2010,1828,980,848
37803,17,146,2010,22828,12154,10674
37804,17,26,2010,27111,14244,12867
37805,17,170,2010,2231,1178,1053
37806,17,38,2010,131007,72875,58132
37807,17,142,2010,20459,10813,9646
37808,17,50,2010,21205,11479,9726
37809,17,114,2010,6184,3319,2865
37810,17,171,2010,21638,11536,10102
37811,17,28,2010,29931,16618,13313
37812,57,2,2010,5549,341,5208
37813,57,51,2010,440648,209209,231439
37814,57,141,2010,23713,8241,15472
37815,57,52,2010,61,43,18
37816,57,134,2010,1934,1000,934
37817,57,76,2010,24,14,10
37818,57,103,2010,78640,41423,37217
37819,57,11,2010,1107,696,411
37820,57,66,2010,17060,11822,5238
37821,57,12,2010,668,454,214
37822,57,78,2010,90,56,34
37823,57,13,2010,39,20,19
37824,57,3,2010,89149,24070,65079
37825,57,79,2010,58,27,31
37826,57,29,2010,33171,15678,17493
37827,57,67,2010,46838,26619,20219
37828,57,95,2010,26,13,13
37829,57,151,2010,2528,993,1535
37830,57,4,2010,33,12,21
37831,57,53,2010,10348,8205,2143
37832,57,147,2010,46,22,24
37833,57,105,2010,110536,70124,40412
37834,57,30,2010,58493,37859,20634
37835,57,152,2010,11105,3349,7756
37836,57,116,2010,985,555,430
37837,57,153,2010,6260,4800,1460
37838,57,135,2010,11165,5374,5791
37839,57,136,2010,533,138,395
37840,57,106,2010,12765,7353,5412
37841,57,172,2010,194677,96008,98669
37842,57,107,2010,39214,25361,13853
37843,57,117,2010,39,24,15
37844,57,137,2010,3474,1659,1815
37845,57,96,2010,1478,935,543
37846,57,54,2010,25997,14785,11212
37847,57,81,2010,32329,24743,7586
37848,57,14,2010,696,380,316
37849,57,31,2010,10566,8566,2000
37850,57,176,2010,102,62,40
37851,57,137,2010,6198,3106,3092
37852,57,39,2010,3592,2362,1230
37853,57,118,2010,101,54,47
37854,57,82,2010,265,193,72
37855,57,83,2010,40445,28179,12266
37856,57,108,2010,89989,54621,35368
37857,57,142,2010,107072,29594,77478
37858,57,97,2010,11705,7840,3865
37859,57,138,2010,121,70,51
37860,57,119,2010,13557,6170,7387
37861,57,40,2010,1370,1167,203
37862,57,148,2010,37,22,15
37863,57,120,2010,30974,18055,12919
37864,57,42,2010,2995,2351,644
37865,57,68,2010,137725,83248,54477
37866,57,139,2010,383,171,212
37867,57,155,2010,1253,237,1016
37868,57,15,2010,10030,8679,1351
37869,57,69,2010,222661,125857,96804
37870,57,156,2010,44622,17505,27117
37871,57,56,2010,20212,9691,10521
37872,57,84,2010,19,13,6
37873,57,98,2010,2107,1302,805
37874,57,157,2010,3646,1146,2500
37875,57,158,2010,695,251,444
37876,57,110,2010,79,59,20
37877,57,85,2010,738,470,268
37878,57,99,2010,2117,1553,564
37879,57,32,2010,13074,9700,3374
37880,57,43,2010,220,144,76
37881,57,5,2010,128999,49745,79254
37882,57,6,2010,14360,6269,8091
37883,57,16,2010,3952,1115,2837
37884,57,44,2010,4025,2294,1731
37885,57,17,2010,4541,1783,2758
37886,57,86,2010,373,228,145
37887,57,177,2010,9489,6322,3167
37888,57,18,2010,3324,853,2471
37889,57,167,2010,3586,3004,582
37890,57,121,2010,3528,2097,1431
37891,57,19,2010,578,234,344
37892,57,168,2010,1188,1002,186
37893,57,46,2010,3078,2457,621
37894,57,20,2010,7206,2598,4608
37895,57,149,2010,29,16,13
37896,57,159,2010,2160,369,1791
37897,57,143,2010,36492,18806,17686
37898,57,70,2010,179,94,85
37899,57,47,2010,5537,4201,1336
37900,57,71,2010,4782,2643,2139
37901,57,122,2010,2348,1653,695
37902,57,123,2010,173,92,81
37903,57,7,2010,83,39,44
37904,57,160,2010,2880,425,2455
37905,57,58,2010,2105,1526,579
37906,57,161,2010,630,136,494
37907,57,124,2010,9404,5298,4106
37908,57,100,2010,9012,6100,2912
37909,57,72,2010,1653,894,759
37910,57,59,2010,2066,1141,925
37911,57,144,2010,416832,178913,237919
37912,57,125,2010,834,540,294
37913,57,150,2010,93,46,47
37914,57,8,2010,1647,697,950
37915,57,73,2010,13617,8409,5208
37916,57,101,2010,1135,765,370
37917,57,162,2010,53072,28853,24219
37918,57,60,2010,74223,32817,41406
37919,57,48,2010,1884,1175,709
37920,57,21,2010,48,25,23
37921,57,9,2010,78200,24920,53280
37922,57,102,2010,1055,767,288
37923,57,111,2010,2646,1815,831
37924,57,112,2010,115021,71355,43666
37925,57,33,2010,124693,93263,31430
37926,57,61,2010,7080,4599,2481
37927,57,22,2010,77,40,37
37928,57,35,2010,1016949,583325,433624
37929,57,36,2010,79608,62315,17293
37930,57,126,2010,791,411,380
37931,57,90,2010,4,3,1
37932,57,91,2010,24,12,12
37933,57,92,2010,25,17,8
37934,57,62,2010,1907,1200,707
37935,57,140,2010,77,54,23
37936,57,23,2010,1018,480,538
37937,57,164,2010,80612,17609,63003
37938,57,63,2010,87994,43296,44698
37939,57,127,2010,1025,805,220
37940,57,165,2010,1389,560,829
37941,57,37,2010,11467,8322,3145
37942,57,64,2010,4614,2718,1896
37943,57,128,2010,12634,5457,7177
37944,57,115,2010,5726,3288,2438
37945,57,129,2010,24,15,9
37946,57,65,2010,33117,23480,9637
37947,57,10,2010,83767,36082,47685
37948,57,145,2010,3094,654,2440
37949,57,113,2010,47,32,15
37950,57,49,2010,6846,4627,2219
37951,57,74,2010,194518,104520,89998
37952,57,25,2010,5827,1974,3853
37953,57,169,2010,179,134,45
37954,57,166,2010,4859,1707,3152
37955,57,93,2010,186,140,46
37956,57,146,2010,112624,40471,72153
37957,57,26,2010,20888,8792,12096
37958,57,170,2010,195,159,36
37959,57,130,2010,996,544,452
37960,57,38,2010,213559,168226,45333
37961,57,27,2010,324,159,165
37962,57,50,2010,68044,39734,28310
37963,57,131,2010,1631,922,709
37964,57,114,2010,7912,4472,3440
37965,57,171,2010,2424,1975,449
37966,57,1,2010,4973,2726,2247
37967,57,28,2010,298,137,161
37968,57,132,2010,895,478,417
37969,57,133,2010,904,484,420
37970,86,76,2010,156,79,77
37971,86,78,2010,677,342,335
37972,86,79,2010,545,276,269
37973,86,95,2010,7,4,3
37974,86,96,2010,101,56,45
37975,86,81,2010,1830,919,911
37976,86,82,2010,140,71,69
37977,86,97,2010,135,76,59
37978,86,84,2010,210,107,103
37979,86,98,2010,309,173,136
37980,86,99,2010,164,93,71
37981,86,5,2010,1152,430,722
37982,86,101,2010,126,71,55
37983,86,102,2010,76,42,34
37984,86,90,2010,98,50,48
37985,86,91,2010,335,169,166
37986,86,92,2010,229,116,113
37987,86,93,2010,2349,1188,1161
37988,86,50,2010,4843,2473,2370
37989,177,103,2010,3181,1751,1430
37990,177,66,2010,569,313,256
37991,177,3,2010,10175,5599,4576
37992,177,67,2010,697,383,314
37993,177,105,2010,230552,126859,103693
37994,177,172,2010,687156,375576,311580
37995,177,39,2010,499,274,225
37996,177,142,2010,1593,876,717
37997,177,42,2010,599,330,269
37998,177,68,2010,9060,4985,4075
37999,177,69,2010,5971,3287,2684
38000,177,156,2010,1883,1036,847
38001,177,5,2010,22497,12379,10118
38002,177,6,2010,4841,2664,2177
38003,177,44,2010,1061,584,477
38004,177,57,2010,2731,1502,1229
38005,177,100,2010,1956,1076,880
38006,177,73,2010,1099,604,495
38007,177,162,2010,2729,1502,1227
38008,177,48,2010,416,229,187
38009,177,9,2010,10299,5666,4633
38010,177,112,2010,54636,30063,24573
38011,177,33,2010,978,539,439
38012,177,61,2010,465,256,209
38013,177,36,2010,7814,4300,3514
38014,177,65,2010,1907,1050,857
38015,177,10,2010,9097,5005,4092
38016,177,49,2010,1553,855,698
38017,177,74,2010,1089,599,490
38018,177,50,2010,16044,8828,7216
38019,177,1,2010,41781,22988,18793
38020,18,2,2010,119,38,81
38021,18,141,2010,646,304,342
38022,18,66,2010,219,75,144
38023,18,13,2010,800,249,551
38024,18,3,2010,21853,4894,16959
38025,18,11,2010,50,27,23
38026,18,67,2010,137,57,80
38027,18,53,2010,115,50,65
38028,18,105,2010,199,82,117
38029,18,30,2010,95,43,52
38030,18,10,2010,23474,16757,6717
38031,18,136,2010,50,9,41
38032,18,172,2010,17420,12233,5187
38033,18,107,2010,48,24,24
38034,18,54,2010,50,29,21
38035,18,14,2010,248,104,144
38036,18,31,2010,46,24,22
38037,18,39,2010,95,35,60
38038,18,120,2010,144,105,39
38039,18,119,2010,141,50,91
38040,18,68,2010,743,286,457
38041,18,69,2010,1347,503,844
38042,18,156,2010,51,13,38
38043,18,56,2010,117,61,56
38044,18,173,2010,73,24,49
38045,18,32,2010,1103,497,606
38046,18,5,2010,11113,1122,9991
38047,18,6,2010,179,70,109
38048,18,16,2010,396962,187721,209241
38049,18,44,2010,99,45,54
38050,18,17,2010,2953,777,2176
38051,18,57,2010,581,242,339
38052,18,177,2010,195,54,141
38053,18,167,2010,39,22,17
38054,18,176,2010,159,38,121
38055,18,19,2010,1415,323,1092
38056,18,20,2010,3457,1517,1940
38057,18,143,2010,1832,614,1218
38058,18,161,2010,130,24,106
38059,18,144,2010,1125,694,431
38060,18,21,2010,1198,492,706
38061,18,8,2010,343,114,229
38062,18,73,2010,375,151,224
38063,18,162,2010,50,13,37
38064,18,48,2010,82,35,47
38065,18,9,2010,6120,1980,4140
38066,18,33,2010,153,75,78
38067,18,22,2010,421,88,333
38068,18,35,2010,510,320,190
38069,18,36,2010,1122,657,465
38070,18,23,2010,9467,2446,7021
38071,18,63,2010,110,72,38
38072,18,37,2010,44,24,20
38073,18,128,2010,142,47,95
38074,18,115,2010,110,29,81
38075,18,65,2010,574,269,305
38076,18,129,2010,521,146,375
38077,18,145,2010,4227,1181,3046
38078,18,49,2010,170,77,93
38079,18,74,2010,375,148,227
38080,18,25,2010,124888,43279,81609
38081,18,27,2010,393,131,262
38082,18,146,2010,489,192,297
38083,18,26,2010,1929,385,1544
38084,18,38,2010,745,504,241
38085,18,60,2010,167,95,72
38086,18,142,2010,113465,19881,93584
38087,18,50,2010,1521,517,1004
38088,18,28,2010,4478,1175,3303
38089,167,12,2010,45483,20286,25197
38090,167,11,2010,8597,3576,5021
38091,167,29,2010,65001,32914,32087
38092,167,172,2010,2033,894,1139
38093,167,40,2010,1046,559,487
38094,167,15,2010,3079,1173,1906
38095,167,176,2010,57915,28556,29359
38096,167,168,2010,6331,3353,2978
38097,167,46,2010,1046,502,544
38098,167,47,2010,4124,1900,2224
38099,167,36,2010,2211875,1154667,1057208
38100,167,169,2010,14870,6818,8052
38101,167,26,2010,44089,20955,23134
38102,167,170,2010,987,391,596
38103,167,38,2010,317803,163343,154460
38104,167,171,2010,264862,126540,138322
38105,121,116,2010,4256,2150,2106
38106,121,137,2010,9133,4642,4491
38107,121,120,2010,35309,17948,17361
38108,121,119,2010,1686,857,829
38109,121,125,2010,589,298,291
38110,121,150,2010,67,34,33
38111,121,126,2010,6201,3134,3067
38112,121,128,2010,392063,190369,201694
38113,121,115,2010,110,57,53
38114,121,129,2010,53218,26058,27160
38115,121,145,2010,26998,13723,13275
38116,121,130,2010,326978,173022,153956
38117,121,131,2010,39120,19773,19347
38118,19,2,2010,1794,624,1170
38119,19,13,2010,849,541,308
38120,19,3,2010,258071,37701,220370
38121,19,10,2010,25192,12527,12665
38122,19,136,2010,1138,397,741
38123,19,120,2010,2902,1011,1891
38124,19,119,2010,4122,1436,2686
38125,19,68,2010,2358,972,1386
38126,19,5,2010,675347,175100,500247
38127,19,18,2010,33502,13018,20484
38128,19,20,2010,5908,2058,3850
38129,19,144,2010,2087,728,1359
38130,19,8,2010,1854,647,1207
38131,19,73,2010,780,336,444
38132,19,162,2010,1518,529,989
38133,19,9,2010,225820,56127,169693
38134,19,22,2010,224,159,65
38135,19,23,2010,1716,581,1135
38136,19,128,2010,2763,962,1801
38137,19,129,2010,0,0,0
38138,19,145,2010,41211,16080,25131
38139,19,25,2010,14426,5027,9399
38140,19,27,2010,21510,11014,10496
38141,19,146,2010,1259,439,820
38142,19,26,2010,10482,3652,6830
38143,19,142,2010,168563,62472,106091
38144,19,50,2010,8016,3045,4971
38145,19,28,2010,47699,16620,31079
38146,168,12,2010,5311,2622,2689
38147,168,11,2010,2702,1315,1387
38148,168,29,2010,11293,7075,4218
38149,168,172,2010,308,153,155
38150,168,40,2010,651,381,270
38151,168,42,2010,132,57,75
38152,168,15,2010,3712,1922,1790
38153,168,69,2010,2066,1202,864
38154,168,167,2010,14692,8974,5718
38155,168,176,2010,2017,1122,895
38156,168,46,2010,1024,595,429
38157,168,47,2010,3008,1759,1249
38158,168,33,2010,3647,2258,1389
38159,168,35,2010,547,299,248
38160,168,36,2010,126897,76212,50685
38161,168,1,2010,122,44,78
38162,168,169,2010,2503,1287,1216
38163,168,26,2010,1193,625,568
38164,168,170,2010,1136,654,482
38165,168,38,2010,30395,18446,11949
38166,168,171,2010,10426,5834,4592
38167,46,2,2010,25,1,24
38168,46,51,2010,7,2,5
38169,46,141,2010,17,2,15
38170,46,52,2010,1,0,1
38171,46,134,2010,2,1,1
38172,46,75,2010,0,0,0
38173,46,76,2010,0,0,0
38174,46,103,2010,22,11,11
38175,46,11,2010,922,348,574
38176,46,77,2010,0,0,0
38177,46,66,2010,142,66,76
38178,46,12,2010,2433,1011,1422
38179,46,13,2010,0,0,0
38180,46,3,2010,8,0,8
38181,46,79,2010,0,0,0
38182,46,29,2010,54799,35540,19259
38183,46,67,2010,116,49,67
38184,46,151,2010,0,0,0
38185,46,53,2010,6,0,6
38186,46,147,2010,0,0,0
38187,46,105,2010,37,10,27
38188,46,30,2010,538,73,465
38189,46,116,2010,0,0,0
38190,46,153,2010,1,0,1
38191,46,135,2010,2,0,2
38192,46,106,2010,5,0,5
38193,46,172,2010,230,112,118
38194,46,107,2010,10,6,4
38195,46,137,2010,1,0,1
38196,46,96,2010,1,1,0
38197,46,54,2010,6,1,5
38198,46,81,2010,57,21,36
38199,46,14,2010,22,13,9
38200,46,31,2010,249,121,128
38201,46,176,2010,14,5,9
38202,46,137,2010,0,0,0
38203,46,39,2010,288,59,229
38204,46,83,2010,1,0,1
38205,46,108,2010,0,0,0
38206,46,142,2010,42,7,35
38207,46,119,2010,0,0,0
38208,46,40,2010,3442,1874,1568
38209,46,41,2010,0,0,0
38210,46,42,2010,277,111,166
38211,46,68,2010,331,141,190
38212,46,139,2010,0,0,0
38213,46,155,2010,0,0,0
38214,46,15,2010,1614,718,896
38215,46,69,2010,3097,1564,1533
38216,46,156,2010,0,0,0
38217,46,56,2010,34,13,21
38218,46,98,2010,0,0,0
38219,46,32,2010,244,134,110
38220,46,43,2010,40,7,33
38221,46,5,2010,102,15,87
38222,46,6,2010,38,6,32
38223,46,16,2010,11,5,6
38224,46,44,2010,761,376,385
38225,46,17,2010,117,50,67
38226,46,57,2010,317,101,216
38227,46,86,2010,1,0,1
38228,46,177,2010,15,9,6
38229,46,18,2010,7,1,6
38230,46,167,2010,7058,3873,3185
38231,46,121,2010,3,2,1
38232,46,19,2010,3,0,3
38233,46,168,2010,987,563,424
38234,46,20,2010,48,5,43
38235,46,143,2010,6,3,3
38236,46,70,2010,0,0,0
38237,46,47,2010,20226,12071,8155
38238,46,71,2010,13,5,8
38239,46,122,2010,0,0,0
38240,46,123,2010,0,0,0
38241,46,160,2010,1,0,1
38242,46,58,2010,10,2,8
38243,46,161,2010,0,0,0
38244,46,124,2010,0,0,0
38245,46,100,2010,45,7,38
38246,46,72,2010,0,0,0
38247,46,59,2010,0,0,0
38248,46,144,2010,11,2,9
38249,46,125,2010,0,0,0
38250,46,150,2010,0,0,0
38251,46,8,2010,14,1,13
38252,46,73,2010,134,31,103
38253,46,101,2010,0,0,0
38254,46,162,2010,12,0,12
38255,46,60,2010,0,0,0
38256,46,48,2010,192,63,129
38257,46,9,2010,35,5,30
38258,46,111,2010,1,0,1
38259,46,112,2010,8,1,7
38260,46,33,2010,1233,667,566
38261,46,61,2010,52,16,36
38262,46,22,2010,0,0,0
38263,46,35,2010,310,38,272
38264,46,36,2010,163606,103306,60300
38265,46,126,2010,0,0,0
38266,46,23,2010,2,0,2
38267,46,63,2010,6,0,6
38268,46,165,2010,1,0,1
38269,46,37,2010,56,24,32
38270,46,64,2010,11,5,6
38271,46,128,2010,5,1,4
38272,46,115,2010,13,4,9
38273,46,129,2010,2,0,2
38274,46,65,2010,196,73,123
38275,46,10,2010,40,13,27
38276,46,145,2010,1,0,1
38277,46,49,2010,449,147,302
38278,46,74,2010,91,35,56
38279,46,25,2010,20,0,20
38280,46,169,2010,669,339,330
38281,46,166,2010,0,0,0
38282,46,93,2010,2,0,2
38283,46,146,2010,2,0,2
38284,46,26,2010,106,28,78
38285,46,170,2010,714,377,337
38286,46,130,2010,2,0,2
38287,46,38,2010,39933,21415,18518
38288,46,27,2010,9,3,6
38289,46,50,2010,1369,580,789
38290,46,131,2010,1,0,1
38291,46,114,2010,2,0,2
38292,46,171,2010,2296,1258,1038
38293,46,1,2010,10,4,6
38294,46,28,2010,0,0,0
38295,46,132,2010,0,0,0
38296,46,133,2010,4,0,4
38297,20,13,2010,128,50,78
38298,20,3,2010,3498,970,2528
38299,20,10,2010,3757,3321,436
38300,20,172,2010,2789,2424,365
38301,20,68,2010,119,58,61
38302,20,69,2010,216,100,116
38303,20,32,2010,177,99,78
38304,20,5,2010,1779,223,1556
38305,20,16,2010,138593,67300,71293
38306,20,17,2010,473,154,319
38307,20,18,2010,554,301,253
38308,20,19,2010,227,64,163
38309,20,143,2010,293,122,171
38310,20,144,2010,180,138,42
38311,20,21,2010,192,97,95
38312,20,9,2010,980,393,587
38313,20,36,2010,180,131,49
38314,20,23,2010,1515,485,1030
38315,20,129,2010,84,29,55
38316,20,145,2010,677,234,443
38317,20,25,2010,19987,8576,11411
38318,20,26,2010,309,77,232
38319,20,38,2010,119,100,19
38320,20,142,2010,95688,27064,68624
38321,20,50,2010,244,103,141
38322,20,28,2010,717,233,484
38323,149,147,2010,106,59,47
38324,149,172,2010,118,51,67
38325,149,156,2010,87,29,58
38326,149,5,2010,223,99,124
38327,149,123,2010,36,14,22
38328,149,125,2010,23,7,16
38329,149,150,2010,4,1,3
38330,149,9,2010,223,99,124
38331,149,115,2010,2544,1236,1308
38332,149,133,2010,68,32,36
38333,149,148,2010,36,19,17
38334,149,130,2010,134,60,74
38335,149,131,2010,83,41,42
38336,149,132,2010,68,32,36
38337,159,151,2010,25,6,19
38338,159,68,2010,59,32,27
38339,159,155,2010,711,315,396
38340,159,69,2010,186,105,81
38341,159,156,2010,7069,2960,4109
38342,159,157,2010,35375,15728,19647
38343,159,5,2010,712,109,603
38344,159,57,2010,50,23,27
38345,159,20,2010,871,248,623
38346,159,160,2010,1267,354,913
38347,159,73,2010,60,32,28
38348,159,162,2010,4922,1093,3829
38349,159,158,2010,454,262,192
38350,159,164,2010,342,106,236
38351,159,165,2010,12578,5735,6843
38352,159,65,2010,57,30,27
38353,159,49,2010,225,124,101
38354,159,74,2010,30,15,15
38355,159,166,2010,365,127,238
38356,159,50,2010,230,125,105
38357,159,152,2010,221,58,163
38358,143,2,2010,285,79,206
38359,143,51,2010,268,83,185
38360,143,141,2010,3195,1352,1843
38361,143,66,2010,670,309,361
38362,143,13,2010,862,205,657
38363,143,3,2010,1113,52,1061
38364,143,11,2010,228,83,145
38365,143,67,2010,602,238,364
38366,143,53,2010,294,89,205
38367,143,105,2010,228,89,139
38368,143,29,2010,678,266,412
38369,143,10,2010,328,124,204
38370,143,136,2010,766,194,572
38371,143,172,2010,2737,760,1977
38372,143,117,2010,3824,521,3303
38373,143,137,2010,359,89,270
38374,143,137,2010,387,86,301
38375,143,39,2010,686,217,469
38376,143,97,2010,631,220,411
38377,143,120,2010,1630,585,1045
38378,143,119,2010,2600,814,1786
38379,143,42,2010,740,268,472
38380,143,68,2010,4475,1538,2937
38381,143,118,2010,1269,334,935
38382,143,69,2010,6257,2513,3744
38383,143,156,2010,547,107,440
38384,143,56,2010,2331,935,1396
38385,143,32,2010,302,136,166
38386,143,5,2010,4310,963,3347
38387,143,6,2010,367,92,275
38388,143,16,2010,60945,19278,41667
38389,143,57,2010,5955,2220,3735
38390,143,177,2010,896,318,578
38391,143,167,2010,715,136,579
38392,143,18,2010,18164,5191,12973
38393,143,121,2010,300,100,200
38394,143,19,2010,9613,2014,7599
38395,143,20,2010,9850,3647,6203
38396,143,160,2010,302,69,233
38397,143,161,2010,319,67,252
38398,143,72,2010,246,78,168
38399,143,144,2010,4361,2130,2231
38400,143,21,2010,1508,305,1203
38401,143,73,2010,1576,668,908
38402,143,162,2010,2537,576,1961
38403,143,48,2010,300,112,188
38404,143,9,2010,2189,544,1645
38405,143,33,2010,605,317,288
38406,143,158,2010,276,2,274
38407,143,22,2010,1260,278,982
38408,143,35,2010,531,273,258
38409,143,36,2010,6450,2285,4165
38410,143,23,2010,31573,7364,24209
38411,143,164,2010,998,129,869
38412,143,165,2010,212,67,145
38413,143,128,2010,93040,25331,67709
38414,143,115,2010,576,167,409
38415,143,65,2010,647,244,403
38416,143,129,2010,1582,451,1131
38417,143,145,2010,12842,3659,9183
38418,143,49,2010,667,214,453
38419,143,74,2010,830,346,484
38420,143,25,2010,24709,7072,17637
38421,143,169,2010,605,129,476
38422,143,27,2010,2471,740,1731
38423,143,146,2010,2746,1024,1722
38424,143,26,2010,2257,559,1698
38425,143,170,2010,212,46,166
38426,143,38,2010,779,363,416
38427,143,142,2010,18695,5357,13338
38428,143,50,2010,6438,2266,4172
38429,143,131,2010,236,60,176
38430,143,171,2010,336,42,294
38431,143,28,2010,18983,4804,14179
38432,70,2,2010,3,0,3
38433,70,51,2010,0,0,0
38434,70,141,2010,4,1,3
38435,70,52,2010,0,0,0
38436,70,134,2010,7,1,6
38437,70,103,2010,19,11,8
38438,70,11,2010,7,3,4
38439,70,66,2010,3615,2115,1500
38440,70,12,2010,0,0,0
38441,70,78,2010,3,1,2
38442,70,3,2010,2,0,2
38443,70,29,2010,4,4,0
38444,70,67,2010,41,22,19
38445,70,53,2010,297,174,123
38446,70,105,2010,143,102,41
38447,70,30,2010,10,7,3
38448,70,152,2010,1,1,0
38449,70,135,2010,5,1,4
38450,70,106,2010,4,4,0
38451,70,172,2010,66,35,31
38452,70,107,2010,30,23,7
38453,70,96,2010,3,2,1
38454,70,54,2010,130,65,65
38455,70,81,2010,7,3,4
38456,70,31,2010,54,38,16
38457,70,137,2010,2,0,2
38458,70,39,2010,15,7,8
38459,70,83,2010,64,42,22
38460,70,108,2010,10,7,3
38461,70,142,2010,13,2,11
38462,70,97,2010,1,0,1
38463,70,119,2010,0,0,0
38464,70,40,2010,2,1,1
38465,70,120,2010,6,3,3
38466,70,42,2010,9,5,4
38467,70,68,2010,115,56,59
38468,70,155,2010,1,0,1
38469,70,15,2010,0,0,0
38470,70,69,2010,1635,859,776
38471,70,56,2010,49,23,26
38472,70,98,2010,4,3,1
38473,70,157,2010,1,1,0
38474,70,85,2010,0,0,0
38475,70,99,2010,1,1,0
38476,70,32,2010,49,32,17
38477,70,43,2010,2,1,1
38478,70,5,2010,23,10,13
38479,70,6,2010,8,6,2
38480,70,16,2010,1,0,1
38481,70,44,2010,9,5,4
38482,70,17,2010,6,4,2
38483,70,57,2010,878,309,569
38484,70,86,2010,2,1,1
38485,70,177,2010,14,7,7
38486,70,18,2010,1,0,1
38487,70,167,2010,5,4,1
38488,70,121,2010,5,4,1
38489,70,19,2010,1,0,1
38490,70,168,2010,3,2,1
38491,70,46,2010,7,5,2
38492,70,143,2010,1,1,0
38493,70,47,2010,1,1,0
38494,70,71,2010,5,3,2
38495,70,122,2010,0,0,0
38496,70,7,2010,2,0,2
38497,70,58,2010,1,0,1
38498,70,124,2010,2,2,0
38499,70,100,2010,21,11,10
38500,70,72,2010,0,0,0
38501,70,59,2010,1,0,1
38502,70,144,2010,11,6,5
38503,70,125,2010,4,1,3
38504,70,8,2010,2,0,2
38505,70,73,2010,68,39,29
38506,70,101,2010,3,2,1
38507,70,162,2010,4,1,3
38508,70,60,2010,75,37,38
38509,70,48,2010,6,4,2
38510,70,9,2010,4,1,3
38511,70,102,2010,6,3,3
38512,70,111,2010,2,2,0
38513,70,112,2010,14,8,6
38514,70,33,2010,47,37,10
38515,70,61,2010,387,188,199
38516,70,35,2010,19,15,4
38517,70,36,2010,44,32,12
38518,70,91,2010,1,0,1
38519,70,164,2010,1,0,1
38520,70,63,2010,347,173,174
38521,70,127,2010,1,0,1
38522,70,37,2010,30,23,7
38523,70,64,2010,113,85,28
38524,70,128,2010,3,1,2
38525,70,115,2010,30,17,13
38526,70,65,2010,274,122,152
38527,70,10,2010,7,2,5
38528,70,49,2010,24,15,9
38529,70,74,2010,12215,6005,6210
38530,70,25,2010,3,1,2
38531,70,93,2010,0,0,0
38532,70,146,2010,18,5,13
38533,70,26,2010,585,285,300
38534,70,130,2010,1,1,0
38535,70,38,2010,20,17,3
38536,70,27,2010,1,0,1
38537,70,50,2010,57,26,31
38538,70,131,2010,3,1,2
38539,70,114,2010,0,0,0
38540,70,171,2010,1,0,1
38541,70,1,2010,11,7,4
38542,70,132,2010,0,0,0
38543,70,133,2010,5,4,1
38544,47,2,2010,24,2,22
38545,47,51,2010,0,0,0
38546,47,141,2010,0,0,0
38547,47,134,2010,0,0,0
38548,47,103,2010,67,35,32
38549,47,11,2010,678,227,451
38550,47,77,2010,0,0,0
38551,47,66,2010,60,26,34
38552,47,12,2010,1031,371,660
38553,47,78,2010,0,0,0
38554,47,13,2010,0,0,0
38555,47,3,2010,0,0,0
38556,47,29,2010,41370,25708,15662
38557,47,67,2010,205,82,123
38558,47,95,2010,0,0,0
38559,47,151,2010,0,0,0
38560,47,53,2010,0,0,0
38561,47,105,2010,70,41,29
38562,47,30,2010,83,19,64
38563,47,135,2010,0,0,0
38564,47,106,2010,0,0,0
38565,47,172,2010,60,58,2
38566,47,107,2010,0,0,0
38567,47,137,2010,0,0,0
38568,47,54,2010,0,0,0
38569,47,81,2010,0,0,0
38570,47,14,2010,33,12,21
38571,47,31,2010,94,50,44
38572,47,176,2010,0,0,0
38573,47,137,2010,0,0,0
38574,47,39,2010,354,138,216
38575,47,82,2010,0,0,0
38576,47,108,2010,0,0,0
38577,47,142,2010,56,13,43
38578,47,119,2010,0,0,0
38579,47,40,2010,958,514,444
38580,47,120,2010,0,0,0
38581,47,42,2010,101,35,66
38582,47,68,2010,335,148,187
38583,47,155,2010,0,0,0
38584,47,15,2010,723,301,422
38585,47,69,2010,1786,840,946
38586,47,156,2010,0,0,0
38587,47,56,2010,57,20,37
38588,47,157,2010,0,0,0
38589,47,110,2010,0,0,0
38590,47,99,2010,0,0,0
38591,47,32,2010,115,56,59
38592,47,43,2010,54,24,30
38593,47,5,2010,0,0,0
38594,47,6,2010,82,13,69
38595,47,16,2010,0,0,0
38596,47,44,2010,1465,692,773
38597,47,17,2010,39,27,12
38598,47,57,2010,338,105,233
38599,47,86,2010,0,0,0
38600,47,177,2010,28,12,16
38601,47,18,2010,0,0,0
38602,47,167,2010,5366,2932,2434
38603,47,121,2010,0,0,0
38604,47,19,2010,0,0,0
38605,47,168,2010,455,255,200
38606,47,46,2010,6670,3736,2934
38607,47,20,2010,52,6,46
38608,47,159,2010,0,0,0
38609,47,143,2010,0,0,0
38610,47,71,2010,0,0,0
38611,47,122,2010,0,0,0
38612,47,123,2010,0,0,0
38613,47,7,2010,0,0,0
38614,47,160,2010,0,0,0
38615,47,58,2010,0,0,0
38616,47,161,2010,0,0,0
38617,47,124,2010,0,0,0
38618,47,100,2010,0,0,0
38619,47,72,2010,0,0,0
38620,47,144,2010,0,0,0
38621,47,125,2010,0,0,0
38622,47,150,2010,0,0,0
38623,47,8,2010,0,0,0
38624,47,73,2010,131,49,82
38625,47,101,2010,0,0,0
38626,47,162,2010,28,0,28
38627,47,60,2010,0,0,0
38628,47,48,2010,1142,534,608
38629,47,21,2010,0,0,0
38630,47,9,2010,63,4,59
38631,47,111,2010,0,0,0
38632,47,112,2010,0,0,0
38633,47,33,2010,2633,1585,1048
38634,47,61,2010,59,16,43
38635,47,22,2010,0,0,0
38636,47,35,2010,213,23,190
38637,47,36,2010,70305,40803,29502
38638,47,126,2010,0,0,0
38639,47,23,2010,0,0,0
38640,47,63,2010,0,0,0
38641,47,37,2010,34,18,16
38642,47,64,2010,0,0,0
38643,47,128,2010,0,0,0
38644,47,115,2010,0,0,0
38645,47,65,2010,658,275,383
38646,47,10,2010,0,0,0
38647,47,145,2010,0,0,0
38648,47,113,2010,0,0,0
38649,47,49,2010,307,139,168
38650,47,74,2010,50,13,37
38651,47,25,2010,0,0,0
38652,47,169,2010,392,196,196
38653,47,166,2010,0,0,0
38654,47,146,2010,0,0,0
38655,47,26,2010,75,18,57
38656,47,170,2010,289,176,113
38657,47,130,2010,0,0,0
38658,47,38,2010,14475,7432,7043
38659,47,27,2010,27,13,14
38660,47,50,2010,3901,1876,2025
38661,47,131,2010,0,0,0
38662,47,114,2010,26,15,11
38663,47,171,2010,1133,600,533
38664,47,1,2010,40,18,22
38665,47,132,2010,0,0,0
38666,47,133,2010,0,0,0
38667,71,2,2010,0,0,0
38668,71,51,2010,197,82,115
38669,71,141,2010,66,30,36
38670,71,52,2010,0,0,0
38671,71,134,2010,0,0,0
38672,71,76,2010,0,0,0
38673,71,103,2010,26,11,15
38674,71,11,2010,0,0,0
38675,71,77,2010,0,0,0
38676,71,66,2010,634,365,269
38677,71,12,2010,0,0,0
38678,71,78,2010,0,0,0
38679,71,13,2010,0,0,0
38680,71,3,2010,20,7,13
38681,71,79,2010,0,0,0
38682,71,29,2010,28,23,5
38683,71,67,2010,12979,6450,6529
38684,71,151,2010,0,0,0
38685,71,4,2010,0,0,0
38686,71,53,2010,1587,679,908
38687,71,147,2010,0,0,0
38688,71,105,2010,195,114,81
38689,71,30,2010,576,384,192
38690,71,152,2010,0,0,0
38691,71,116,2010,0,0,0
38692,71,153,2010,1060,503,557
38693,71,135,2010,39,21,18
38694,71,136,2010,0,0,0
38695,71,106,2010,38,16,22
38696,71,172,2010,691,306,385
38697,71,107,2010,17,10,7
38698,71,117,2010,0,0,0
38699,71,137,2010,0,0,0
38700,71,96,2010,0,0,0
38701,71,54,2010,271,114,157
38702,71,81,2010,15,8,7
38703,71,14,2010,41,20,21
38704,71,31,2010,594,402,192
38705,71,176,2010,0,0,0
38706,71,137,2010,64,29,35
38707,71,39,2010,1662,862,800
38708,71,118,2010,0,0,0
38709,71,82,2010,76,47,29
38710,71,83,2010,23,13,10
38711,71,108,2010,0,0,0
38712,71,142,2010,17,6,11
38713,71,97,2010,0,0,0
38714,71,138,2010,0,0,0
38715,71,119,2010,0,0,0
38716,71,40,2010,345,279,66
38717,71,148,2010,0,0,0
38718,71,120,2010,0,0,0
38719,71,42,2010,854,506,348
38720,71,68,2010,23716,12576,11140
38721,71,139,2010,0,0,0
38722,71,155,2010,0,0,0
38723,71,15,2010,0,0,0
38724,71,69,2010,9259,5083,4176
38725,71,156,2010,0,0,0
38726,71,55,2010,0,0,0
38727,71,56,2010,1195,599,596
38728,71,84,2010,0,0,0
38729,71,98,2010,0,0,0
38730,71,157,2010,0,0,0
38731,71,158,2010,0,0,0
38732,71,110,2010,0,0,0
38733,71,85,2010,0,0,0
38734,71,99,2010,0,0,0
38735,71,32,2010,711,476,235
38736,71,43,2010,215,107,108
38737,71,5,2010,127,56,71
38738,71,6,2010,152,63,89
38739,71,16,2010,0,0,0
38740,71,44,2010,1067,561,506
38741,71,17,2010,27,10,17
38742,71,57,2010,13517,6649,6868
38743,71,86,2010,0,0,0
38744,71,177,2010,185,89,96
38745,71,18,2010,0,0,0
38746,71,167,2010,0,0,0
38747,71,121,2010,0,0,0
38748,71,19,2010,0,0,0
38749,71,168,2010,0,0,0
38750,71,46,2010,320,274,46
38751,71,20,2010,23,12,11
38752,71,159,2010,0,0,0
38753,71,143,2010,0,0,0
38754,71,70,2010,0,0,0
38755,71,47,2010,393,260,133
38756,71,122,2010,0,0,0
38757,71,123,2010,0,0,0
38758,71,160,2010,0,0,0
38759,71,58,2010,177,73,104
38760,71,161,2010,0,0,0
38761,71,124,2010,34,21,13
38762,71,100,2010,18,12,6
38763,71,72,2010,0,0,0
38764,71,59,2010,5600,2249,3351
38765,71,144,2010,160,80,80
38766,71,125,2010,0,0,0
38767,71,150,2010,0,0,0
38768,71,8,2010,20,5,15
38769,71,73,2010,2926,1479,1447
38770,71,101,2010,0,0,0
38771,71,162,2010,0,0,0
38772,71,60,2010,227,90,137
38773,71,48,2010,115,47,68
38774,71,21,2010,0,0,0
38775,71,9,2010,0,0,0
38776,71,102,2010,0,0,0
38777,71,111,2010,0,0,0
38778,71,112,2010,65,35,30
38779,71,33,2010,2065,1281,784
38780,71,61,2010,62068,30165,31903
38781,71,22,2010,0,0,0
38782,71,35,2010,1140,762,378
38783,71,36,2010,256,165,91
38784,71,126,2010,17,8,9
38785,71,92,2010,0,0,0
38786,71,62,2010,0,0,0
38787,71,140,2010,0,0,0
38788,71,23,2010,0,0,0
38789,71,164,2010,20,8,12
38790,71,63,2010,3881,1527,2354
38791,71,127,2010,0,0,0
38792,71,165,2010,0,0,0
38793,71,37,2010,464,260,204
38794,71,64,2010,317,158,159
38795,71,128,2010,0,0,0
38796,71,115,2010,30,13,17
38797,71,65,2010,2621,1360,1261
38798,71,10,2010,0,0,0
38799,71,145,2010,0,0,0
38800,71,113,2010,0,0,0
38801,71,49,2010,1350,738,612
38802,71,74,2010,349,172,177
38803,71,25,2010,0,0,0
38804,71,169,2010,0,0,0
38805,71,166,2010,0,0,0
38806,71,93,2010,0,0,0
38807,71,146,2010,88,26,62
38808,71,26,2010,132,57,75
38809,71,170,2010,0,0,0
38810,71,130,2010,0,0,0
38811,71,38,2010,115,87,28
38812,71,27,2010,0,0,0
38813,71,50,2010,4329,1980,2349
38814,71,131,2010,0,0,0
38815,71,114,2010,0,0,0
38816,71,171,2010,0,0,0
38817,71,1,2010,47,28,19
38818,71,28,2010,0,0,0
38819,71,132,2010,0,0,0
38820,71,133,2010,0,0,0
38821,174,172,2010,251200,134463,116737
38822,174,173,2010,18888,7707,11181
38823,174,61,2010,1790,708,1082
38824,122,172,2010,1784,779,1005
38825,122,117,2010,9876,4271,5605
38826,122,68,2010,8066,3483,4583
38827,122,5,2010,1425,617,808
38828,123,116,2010,5314,2441,2873
38829,123,137,2010,1413,645,768
38830,123,137,2010,4841,2280,2561
38831,123,5,2010,2419,1116,1303
38832,123,125,2010,54826,26281,28545
38833,123,126,2010,6482,3066,3416
38834,123,128,2010,87,38,49
38835,123,115,2010,8272,4579,3693
38836,123,50,2010,1478,715,763
38837,123,131,2010,9620,5355,4265
38838,123,132,2010,42865,25418,17447
38839,123,133,2010,37189,20983,16206
38840,7,66,2010,20,5,15
38841,7,3,2010,28598,4097,24501
38842,7,10,2010,6850,1938,4912
38843,7,68,2010,98,24,74
38844,7,69,2010,213,52,161
38845,7,5,2010,13568,4596,8972
38846,7,57,2010,229,100,129
38847,7,177,2010,97,58,39
38848,7,20,2010,9,2,7
38849,7,9,2010,203,51,152
38850,7,49,2010,31,7,24
38851,7,74,2010,101,25,76
38852,7,142,2010,32,7,25
38853,7,50,2010,102,39,63
38854,160,2,2010,385,86,299
38855,160,51,2010,1028,567,461
38856,160,141,2010,385,139,246
38857,160,52,2010,835,396,439
38858,160,134,2010,1253,663,590
38859,160,135,2010,1445,707,738
38860,160,136,2010,482,246,236
38861,160,106,2010,1242,567,675
38862,160,172,2010,2795,1242,1553
38863,160,137,2010,8510,4069,4441
38864,160,137,2010,1810,921,889
38865,160,54,2010,792,289,503
38866,160,151,2010,1295,547,748
38867,160,138,2010,653,331,322
38868,160,68,2010,4357,2045,2312
38869,160,139,2010,9603,4754,4849
38870,160,155,2010,1006,514,492
38871,160,156,2010,4058,1788,2270
38872,160,84,2010,300,171,129
38873,160,157,2010,29054,14059,14995
38874,160,17,2010,1081,503,578
38875,160,177,2010,514,257,257
38876,160,167,2010,1488,632,856
38877,160,176,2010,1434,792,642
38878,160,159,2010,910,514,396
38879,160,143,2010,878,331,547
38880,160,161,2010,10600,4798,5802
38881,160,144,2010,632,375,257
38882,160,162,2010,2955,1434,1521
38883,160,158,2010,289,193,96
38884,160,36,2010,311,161,150
38885,160,126,2010,385,161,224
38886,160,23,2010,1178,663,515
38887,160,164,2010,16797,8416,8381
38888,160,165,2010,1713,921,792
38889,160,115,2010,449,150,299
38890,160,145,2010,493,204,289
38891,160,166,2010,3116,1371,1745
38892,160,27,2010,2463,1178,1285
38893,160,94,2010,536,300,236
38894,160,142,2010,589,311,278
38895,160,131,2010,717,440,277
38896,160,152,2010,43132,19821,23311
38897,160,114,2010,407,215,192
38898,160,132,2010,471,278,193
38899,58,51,2010,63,34,29
38900,58,141,2010,43,12,31
38901,58,103,2010,8,0,8
38902,58,11,2010,22,13,9
38903,58,66,2010,90,44,46
38904,58,3,2010,13,6,7
38905,58,29,2010,23,21,2
38906,58,67,2010,136,56,80
38907,58,53,2010,134,44,90
38908,58,105,2010,79,42,37
38909,58,30,2010,739,383,356
38910,58,172,2010,292,168,124
38911,58,54,2010,59,24,35
38912,58,14,2010,36,15,21
38913,58,31,2010,66,44,22
38914,58,39,2010,107,44,63
38915,58,142,2010,383,119,264
38916,58,119,2010,1354,665,689
38917,58,120,2010,280,135,145
38918,58,42,2010,65,42,23
38919,58,68,2010,352,179,173
38920,58,15,2010,33,17,16
38921,58,69,2010,804,424,380
38922,58,156,2010,55,6,49
38923,58,56,2010,63,18,45
38924,58,32,2010,117,76,41
38925,58,5,2010,215,71,144
38926,58,6,2010,24,12,12
38927,58,16,2010,73,35,38
38928,58,44,2010,223,121,102
38929,58,17,2010,9,2,7
38930,58,57,2010,1198,381,817
38931,58,177,2010,37,29,8
38932,58,18,2010,32,5,27
38933,58,121,2010,27,17,10
38934,58,19,2010,47,16,31
38935,58,46,2010,63,32,31
38936,58,20,2010,52,16,36
38937,58,143,2010,655,195,460
38938,58,47,2010,36,26,10
38939,58,144,2010,182,134,48
38940,58,73,2010,347,158,189
38941,58,162,2010,275,135,140
38942,58,60,2010,24,7,17
38943,58,48,2010,54,15,39
38944,58,9,2010,149,79,70
38945,58,112,2010,22,15,7
38946,58,33,2010,203,134,69
38947,58,61,2010,47,21,26
38948,58,35,2010,554,311,243
38949,58,36,2010,775,542,233
38950,58,23,2010,21,10,11
38951,58,63,2010,450,166,284
38952,58,37,2010,83,58,25
38953,58,64,2010,17,8,9
38954,58,128,2010,3723,1830,1893
38955,58,115,2010,142,70,72
38956,58,65,2010,123,61,62
38957,58,10,2010,14,5,9
38958,58,145,2010,366,179,187
38959,58,49,2010,380,157,223
38960,58,74,2010,85,40,45
38961,58,25,2010,215,32,183
38962,58,93,2010,10,5,5
38963,58,146,2010,263,112,151
38964,58,26,2010,188,60,128
38965,58,38,2010,235,174,61
38966,58,27,2010,21,6,15
38967,58,50,2010,8482,3896,4586
38968,58,171,2010,16,12,4
38969,58,133,2010,29,10,19
38970,161,141,2010,1133,365,768
38971,161,103,2010,46,17,29
38972,161,67,2010,42,17,25
38973,161,105,2010,111,39,72
38974,161,135,2010,273,91,182
38975,161,136,2010,36,12,24
38976,161,172,2010,110,69,41
38977,161,137,2010,96,37,59
38978,161,151,2010,382,147,235
38979,161,139,2010,59,23,36
38980,161,156,2010,144,75,69
38981,161,157,2010,2157,1084,1073
38982,161,16,2010,94,38,56
38983,161,57,2010,38,16,22
38984,161,19,2010,22,10,12
38985,161,20,2010,83,36,47
38986,161,143,2010,97,39,58
38987,161,160,2010,5297,2344,2953
38988,161,144,2010,238,92,146
38989,161,158,2010,834,436,398
38990,161,36,2010,42,8,34
38991,161,23,2010,212,79,133
38992,161,164,2010,26706,10592,16114
38993,161,65,2010,59,21,38
38994,161,25,2010,97,43,54
38995,161,166,2010,113,55,58
38996,161,27,2010,48,21,27
38997,161,146,2010,172,73,99
38998,161,142,2010,156,64,92
38999,124,3,2010,7235,4772,2463
39000,124,67,2010,103,23,80
39001,124,10,2010,979,756,223
39002,124,172,2010,2564,1612,952
39003,124,68,2010,1308,545,763
39004,124,69,2010,119,60,59
39005,124,173,2010,20,7,13
39006,124,5,2010,7517,1294,6223
39007,124,44,2010,44,21,23
39008,124,57,2010,127,55,72
39009,124,177,2010,8,5,3
39010,124,122,2010,1979,941,1038
39011,124,9,2010,163,97,66
39012,124,36,2010,43,25,18
39013,124,127,2010,108,72,36
39014,124,115,2010,541,308,233
39015,124,65,2010,24,9,15
39016,124,74,2010,92,26,66
39017,124,50,2010,395,206,189
39018,100,141,2010,99,28,71
39019,100,134,2010,52,28,24
39020,100,103,2010,14174,6713,7461
39021,100,66,2010,502,247,255
39022,100,3,2010,50,12,38
39023,100,11,2010,97,48,49
39024,100,67,2010,848,382,466
39025,100,105,2010,4533,2544,1989
39026,100,95,2010,2313,1237,1076
39027,100,30,2010,247,140,107
39028,100,135,2010,40,9,31
39029,100,106,2010,5268,2496,2772
39030,100,172,2010,7274,3293,3981
39031,100,107,2010,13262,7578,5684
39032,100,137,2010,79,26,53
39033,100,96,2010,2483,1351,1132
39034,100,54,2010,53,28,25
39035,100,81,2010,11825,5774,6051
39036,100,31,2010,330,210,120
39037,100,39,2010,253,106,147
39038,100,83,2010,1604,805,799
39039,100,108,2010,2202,1118,1084
39040,100,97,2010,8866,4635,4231
39041,100,42,2010,148,91,57
39042,100,68,2010,8535,4422,4113
39043,100,69,2010,7035,3033,4002
39044,100,56,2010,250,81,169
39045,100,98,2010,32894,17870,15024
39046,100,85,2010,941,355,586
39047,100,99,2010,9982,5382,4600
39048,100,32,2010,370,228,142
39049,100,5,2010,864,338,526
39050,100,6,2010,274,93,181
39051,100,16,2010,48,10,38
39052,100,44,2010,271,93,178
39053,100,17,2010,1173,469,704
39054,100,57,2010,4965,1659,3306
39055,100,86,2010,127,52,75
39056,100,177,2010,3005,1494,1511
39057,100,18,2010,42,10,32
39058,100,121,2010,66,28,38
39059,100,176,2010,30,13,17
39060,100,20,2010,974,402,572
39061,100,46,2010,34,22,12
39062,100,47,2010,59,42,17
39063,100,144,2010,234,89,145
39064,100,73,2010,1071,414,657
39065,100,101,2010,3573,1912,1661
39066,100,162,2010,139,30,109
39067,100,48,2010,178,63,115
39068,100,9,2010,145,33,112
39069,100,102,2010,1767,907,860
39070,100,111,2010,507,292,215
39071,100,112,2010,5888,2803,3085
39072,100,33,2010,850,528,322
39073,100,61,2010,441,170,271
39074,100,88,2010,1336,627,709
39075,100,35,2010,398,252,146
39076,100,36,2010,1573,1018,555
39077,100,23,2010,107,29,78
39078,100,164,2010,33,14,19
39079,100,63,2010,59,34,25
39080,100,37,2010,104,71,33
39081,100,1,2010,82,40,42
39082,100,64,2010,52,29,23
39083,100,115,2010,194,85,109
39084,100,65,2010,20731,9801,10930
39085,100,49,2010,416,192,224
39086,100,74,2010,1461,654,807
39087,100,25,2010,192,65,127
39088,100,93,2010,28,14,14
39089,100,26,2010,271,95,176
39090,100,38,2010,330,215,115
39091,100,142,2010,196,42,154
39092,100,50,2010,3380,1438,1942
39093,100,114,2010,2372,1097,1275
39094,72,68,2010,6399,3679,2720
39095,72,57,2010,4443,1972,2471
39096,59,51,2010,2015,1186,829
39097,59,66,2010,245,170,75
39098,59,53,2010,34304,20488,13816
39099,59,30,2010,70,13,57
39100,59,54,2010,14529,9077,5452
39101,59,31,2010,115,49,66
39102,59,39,2010,93,75,18
39103,59,68,2010,397,277,120
39104,59,69,2010,1785,1223,562
39105,59,56,2010,50,10,40
39106,59,32,2010,45,15,30
39107,59,57,2010,186,133,53
39108,59,71,2010,96,60,36
39109,59,73,2010,138,110,28
39110,59,33,2010,94,26,68
39111,59,35,2010,101,55,46
39112,59,36,2010,823,478,345
39113,59,63,2010,17455,9689,7766
39114,59,37,2010,54,5,49
39115,59,64,2010,1438,937,501
39116,59,49,2010,144,89,55
39117,59,74,2010,202,172,30
39118,59,26,2010,79,75,4
39119,59,38,2010,135,47,88
39120,59,60,2010,2949,1739,1210
39121,59,50,2010,98,83,15
39122,87,76,2010,110,58,52
39123,87,82,2010,265,144,121
39124,87,83,2010,23,6,17
39125,87,110,2010,230,97,133
39126,87,90,2010,113,65,48
39127,87,92,2010,28,9,19
39128,87,93,2010,42,16,26
39129,87,50,2010,100,49,51
39130,144,141,2010,10231,5074,5157
39131,144,67,2010,1069,530,539
39132,144,137,2010,1433,710,723
39133,144,68,2010,26839,13320,13519
39134,144,69,2010,1098,545,553
39135,144,157,2010,750,372,378
39136,144,16,2010,1306,647,659
39137,144,57,2010,1444,716,728
39138,144,20,2010,1029,509,520
39139,144,143,2010,896,444,452
39140,144,161,2010,1213,602,611
39141,144,164,2010,1376,682,694
39142,144,65,2010,3121,1548,1573
39143,144,25,2010,1560,773,787
39144,144,146,2010,1964,974,990
39145,144,142,2010,1416,702,714
39146,144,50,2010,924,458,466
39147,125,134,2010,35889,18551,17338
39148,125,116,2010,1817,934,883
39149,125,153,2010,6262,3069,3193
39150,125,137,2010,5799,2986,2813
39151,125,5,2010,2256,860,1396
39152,125,121,2010,22749,11972,10777
39153,125,149,2010,7201,4097,3104
39154,125,123,2010,57509,29108,28401
39155,125,162,2010,4919,2613,2306
39156,125,9,2010,1298,496,802
39157,125,61,2010,4178,1499,2679
39158,125,127,2010,15553,8557,6996
39159,125,115,2010,18519,9370,9149
39160,125,133,2010,89389,47285,42104
39161,125,131,2010,6816,3321,3495
39162,125,132,2010,4880,2574,2306
39163,150,2,2010,43,25,18
39164,150,141,2010,484,255,229
39165,150,134,2010,38119,15648,22471
39166,150,76,2010,469,280,189
39167,150,103,2010,50,31,19
39168,150,66,2010,609,280,329
39169,150,78,2010,50,37,13
39170,150,13,2010,49,35,14
39171,150,3,2010,32,12,20
39172,150,11,2010,63,0,63
39173,150,67,2010,184,91,93
39174,150,147,2010,658,336,322
39175,150,105,2010,534,311,223
39176,150,30,2010,30,24,6
39177,150,116,2010,389,152,237
39178,150,135,2010,118,21,97
39179,150,106,2010,32,9,23
39180,150,172,2010,3106,877,2229
39181,150,137,2010,1117,468,649
39182,150,137,2010,3548,1820,1728
39183,150,81,2010,680,403,277
39184,150,31,2010,76,51,25
39185,150,151,2010,156,88,68
39186,150,39,2010,113,37,76
39187,150,120,2010,211,144,67
39188,150,42,2010,79,56,23
39189,150,68,2010,536,295,241
39190,150,155,2010,86,48,38
39191,150,69,2010,9063,5224,3839
39192,150,156,2010,143,59,84
39193,150,157,2010,53,21,32
39194,150,5,2010,674,233,441
39195,150,6,2010,30,12,18
39196,150,44,2010,60,31,29
39197,150,17,2010,108,48,60
39198,150,57,2010,824,454,370
39199,150,177,2010,113,71,42
39200,150,121,2010,1110,550,560
39201,150,176,2010,101,0,101
39202,150,20,2010,46,18,28
39203,150,149,2010,126,65,61
39204,150,143,2010,35,18,17
39205,150,71,2010,43,24,19
39206,150,123,2010,369,172,197
39207,150,124,2010,106,63,43
39208,150,125,2010,137,59,78
39209,150,73,2010,516,264,252
39210,150,162,2010,982,381,601
39211,150,48,2010,53,35,18
39212,150,9,2010,166,18,148
39213,150,33,2010,168,110,58
39214,150,61,2010,433,177,256
39215,150,35,2010,30,14,16
39216,150,36,2010,454,188,266
39217,150,126,2010,358,158,200
39218,150,164,2010,30,12,18
39219,150,127,2010,56,35,21
39220,150,165,2010,163,88,75
39221,150,128,2010,93,28,65
39222,150,115,2010,8481,4250,4231
39223,150,133,2010,14449,7125,7324
39224,150,65,2010,344,141,203
39225,150,145,2010,199,110,89
39226,150,148,2010,196,107,89
39227,150,49,2010,101,54,47
39228,150,74,2010,428,247,181
39229,150,26,2010,35,14,21
39230,150,130,2010,481,236,245
39231,150,38,2010,257,35,222
39232,150,142,2010,174,68,106
39233,150,50,2010,1718,992,726
39234,150,131,2010,1098,557,541
39235,150,152,2010,71,37,34
39236,150,132,2010,3024,1063,1961
39237,8,3,2010,244,121,123
39238,8,4,2010,75457,36863,38594
39239,8,10,2010,42,25,17
39240,8,172,2010,20977,14777,6200
39241,8,5,2010,461186,328092,133094
39242,8,9,2010,1296,460,836
39243,73,2,2010,30985,14264,16721
39244,73,51,2010,894,409,485
39245,73,141,2010,3893,1395,2498
39246,73,52,2010,10,5,5
39247,73,134,2010,1985,797,1188
39248,73,75,2010,24,16,8
39249,73,76,2010,28,22,6
39250,73,103,2010,2830,1591,1239
39251,73,11,2010,1659,807,852
39252,73,77,2010,2496,1247,1249
39253,73,66,2010,6496,3678,2818
39254,73,12,2010,2022,999,1023
39255,73,78,2010,55,27,28
39256,73,13,2010,105,55,50
39257,73,3,2010,1116,684,432
39258,73,79,2010,68,30,38
39259,73,29,2010,199,107,92
39260,73,67,2010,49063,27535,21528
39261,73,95,2010,21,16,5
39262,73,151,2010,263,88,175
39263,73,4,2010,195,87,108
39264,73,53,2010,6788,2871,3917
39265,73,147,2010,215,109,106
39266,73,105,2010,13357,8521,4836
39267,73,30,2010,13340,6976,6364
39268,73,152,2010,336,127,209
39269,73,116,2010,2732,1338,1394
39270,73,153,2010,11676,6156,5520
39271,73,135,2010,1886,952,934
39272,73,80,2010,13,7,6
39273,73,136,2010,101,36,65
39274,73,106,2010,3035,1611,1424
39275,73,172,2010,52617,29400,23217
39276,73,107,2010,12906,7501,5405
39277,73,117,2010,17,4,13
39278,73,137,2010,1004,456,548
39279,73,96,2010,623,352,271
39280,73,54,2010,201,101,100
39281,73,81,2010,1174,756,418
39282,73,14,2010,381,173,208
39283,73,31,2010,406,199,207
39284,73,176,2010,31,13,18
39285,73,137,2010,4991,2431,2560
39286,73,39,2010,3225,1933,1292
39287,73,118,2010,103,66,37
39288,73,82,2010,73,38,35
39289,73,83,2010,7751,5430,2321
39290,73,108,2010,1789,1102,687
39291,73,142,2010,11761,3491,8270
39292,73,97,2010,347,200,147
39293,73,138,2010,39,25,14
39294,73,119,2010,1671,825,846
39295,73,40,2010,523,382,141
39296,73,148,2010,77,45,32
39297,73,120,2010,8580,3956,4624
39298,73,41,2010,6,4,2
39299,73,42,2010,2541,1847,694
39300,73,68,2010,21982,11980,10002
39301,73,139,2010,88,49,39
39302,73,155,2010,527,174,353
39303,73,15,2010,203,94,109
39304,73,69,2010,120131,70626,49505
39305,73,156,2010,13151,6617,6534
39306,73,55,2010,32,13,19
39307,73,56,2010,9089,3518,5571
39308,73,84,2010,46,30,16
39309,73,98,2010,630,318,312
39310,73,157,2010,2453,730,1723
39311,73,158,2010,231,90,141
39312,73,110,2010,2331,1525,806
39313,73,85,2010,1239,600,639
39314,73,99,2010,392,251,141
39315,73,32,2010,8396,4791,3605
39316,73,43,2010,427,245,182
39317,73,5,2010,17273,7804,9469
39318,73,6,2010,25349,11376,13973
39319,73,16,2010,40821,16465,24356
39320,73,44,2010,4520,2304,2216
39321,73,45,2010,3,2,1
39322,73,17,2010,5249,2300,2949
39323,73,57,2010,20044,7038,13006
39324,73,86,2010,820,501,319
39325,73,177,2010,5839,3276,2563
39326,73,18,2010,888,364,524
39327,73,167,2010,127,63,64
39328,73,121,2010,2518,1421,1097
39329,73,19,2010,1107,470,637
39330,73,168,2010,43,18,25
39331,73,46,2010,1190,757,433
39332,73,20,2010,3370,1445,1925
39333,73,149,2010,105,52,53
39334,73,159,2010,2060,787,1273
39335,73,143,2010,695,220,475
39336,73,70,2010,3,3,0
39337,73,47,2010,2032,1378,654
39338,73,71,2010,996,542,454
39339,73,122,2010,163,96,67
39340,73,123,2010,281,139,142
39341,73,7,2010,9,2,7
39342,73,160,2010,157,75,82
39343,73,58,2010,298,178,120
39344,73,161,2010,335,32,303
39345,73,124,2010,348,212,136
39346,73,100,2010,2868,1730,1138
39347,73,72,2010,62,38,24
39348,73,59,2010,0,0,0
39349,73,87,2010,8,4,4
39350,73,144,2010,166946,79048,87898
39351,73,125,2010,632,315,317
39352,73,150,2010,237,136,101
39353,73,8,2010,1340,522,818
39354,73,101,2010,401,239,162
39355,73,162,2010,6277,2710,3567
39356,73,60,2010,83,40,43
39357,73,48,2010,2487,1446,1041
39358,73,21,2010,426,211,215
39359,73,9,2010,11191,4509,6682
39360,73,102,2010,262,138,124
39361,73,111,2010,178,119,59
39362,73,112,2010,3436,2338,1098
39363,73,33,2010,57899,33150,24749
39364,73,61,2010,14600,6914,7686
39365,73,22,2010,57,31,26
39366,73,35,2010,11035,6974,4061
39367,73,36,2010,35423,22880,12543
39368,73,126,2010,1140,577,563
39369,73,90,2010,74,46,28
39370,73,91,2010,54,25,29
39371,73,92,2010,59,39,20
39372,73,62,2010,0,0,0
39373,73,140,2010,144,76,68
39374,73,23,2010,1426,669,757
39375,73,164,2010,916,337,579
39376,73,63,2010,51582,26519,25063
39377,73,127,2010,86,55,31
39378,73,165,2010,4516,1325,3191
39379,73,37,2010,220,87,133
39380,73,64,2010,74,33,41
39381,73,128,2010,19756,8655,11101
39382,73,115,2010,12840,6878,5962
39383,73,129,2010,0,0,0
39384,73,65,2010,19440,10070,9370
39385,73,10,2010,9933,4780,5153
39386,73,145,2010,4426,1485,2941
39387,73,113,2010,186216,102278,83938
39388,73,49,2010,4067,2388,1679
39389,73,74,2010,6340,3640,2700
39390,73,25,2010,6927,3127,3800
39391,73,169,2010,28,15,13
39392,73,166,2010,1178,410,768
39393,73,93,2010,522,330,192
39394,73,146,2010,4310,1520,2790
39395,73,26,2010,196147,94812,101335
39396,73,170,2010,13,10,3
39397,73,94,2010,2,1,1
39398,73,130,2010,1170,568,602
39399,73,38,2010,679,341,338
39400,73,27,2010,518,248,270
39401,73,50,2010,47041,20978,26063
39402,73,131,2010,1538,775,763
39403,73,114,2010,617,305,312
39404,73,171,2010,132,66,66
39405,73,1,2010,12119,6479,5640
39406,73,28,2010,376,145,231
39407,73,132,2010,947,495,452
39408,73,133,2010,1386,710,676
39409,101,2,2010,57,26,31
39410,101,141,2010,105,57,48
39411,101,76,2010,111,57,54
39412,101,103,2010,251,121,130
39413,101,66,2010,36,14,22
39414,101,78,2010,78,39,39
39415,101,67,2010,41,10,31
39416,101,105,2010,114,62,52
39417,101,95,2010,23,11,12
39418,101,30,2010,57,37,20
39419,101,106,2010,117,48,69
39420,101,172,2010,129,45,84
39421,101,107,2010,415,189,226
39422,101,137,2010,44,14,30
39423,101,96,2010,9989,4938,5051
39424,101,81,2010,873,334,539
39425,101,39,2010,49,16,33
39426,101,83,2010,64,30,34
39427,101,108,2010,103,41,62
39428,101,97,2010,2267,1037,1230
39429,101,120,2010,76,29,47
39430,101,68,2010,138,55,83
39431,101,69,2010,279,101,178
39432,101,98,2010,1634,771,863
39433,101,85,2010,22,11,11
39434,101,99,2010,11534,5936,5598
39435,101,5,2010,23,11,12
39436,101,44,2010,23,6,17
39437,101,57,2010,177,41,136
39438,101,86,2010,19,6,13
39439,101,177,2010,38,13,25
39440,101,18,2010,25,10,15
39441,101,100,2010,785,434,351
39442,101,73,2010,248,135,113
39443,101,162,2010,23,14,9
39444,101,102,2010,376,165,211
39445,101,112,2010,212,89,123
39446,101,88,2010,54,25,29
39447,101,36,2010,180,109,71
39448,101,164,2010,175,99,76
39449,101,128,2010,36,29,7
39450,101,65,2010,427,186,241
39451,101,49,2010,31,12,19
39452,101,74,2010,78,21,57
39453,101,38,2010,73,42,31
39454,101,50,2010,66,23,43
39455,101,114,2010,36,22,14
39456,101,28,2010,28,20,8
39457,162,135,2010,22214,9281,12933
39458,162,136,2010,24099,10069,14030
39459,162,151,2010,290747,121478,169269
39460,162,156,2010,183688,76748,106940
39461,162,159,2010,16968,7089,9879
39462,162,160,2010,132962,55554,77408
39463,162,165,2010,3365,1405,1960
39464,162,166,2010,122002,50974,71028
39465,176,3,2010,138,84,54
39466,176,105,2010,2525,1263,1262
39467,176,10,2010,139,94,45
39468,176,172,2010,25969,12655,13314
39469,176,173,2010,149,49,100
39470,176,5,2010,330,159,171
39471,176,177,2010,191,87,104
39472,176,9,2010,154,77,77
39473,176,112,2010,474,237,237
39474,176,36,2010,132,62,70
39475,176,1,2010,682,309,373
39476,176,50,2010,276,117,159
39477,60,51,2010,70230,41980,28250
39478,60,53,2010,8043,4686,3357
39479,60,30,2010,990,577,413
39480,60,54,2010,1323,771,552
39481,60,31,2010,50,28,22
39482,60,69,2010,39,23,16
39483,60,56,2010,216,125,91
39484,60,32,2010,75,43,32
39485,60,57,2010,35,21,14
39486,60,59,2010,8519,4964,3555
39487,60,33,2010,93,54,39
39488,60,35,2010,22,12,10
39489,60,36,2010,199,117,82
39490,60,63,2010,16538,9636,6902
39491,60,37,2010,34,20,14
39492,60,64,2010,237,138,99
39493,60,26,2010,19770,10520,9250
39494,60,38,2010,60,34,26
39495,60,142,2010,1813,1056,757
39496,48,2,2010,8836,3437,5399
39497,48,51,2010,435,209,226
39498,48,141,2010,1113,392,721
39499,48,52,2010,7,5,2
39500,48,134,2010,377,200,177
39501,48,76,2010,3,1,2
39502,48,103,2010,803,420,383
39503,48,11,2010,196,101,95
39504,48,77,2010,17,3,14
39505,48,66,2010,1300,632,668
39506,48,12,2010,367,211,156
39507,48,78,2010,13,6,7
39508,48,13,2010,25,13,12
39509,48,3,2010,704,364,340
39510,48,79,2010,20,8,12
39511,48,29,2010,676,485,191
39512,48,67,2010,1305,643,662
39513,48,95,2010,8,2,6
39514,48,151,2010,18,9,9
39515,48,4,2010,233,124,109
39516,48,53,2010,12952,6550,6402
39517,48,147,2010,110,55,55
39518,48,105,2010,3577,2444,1133
39519,48,30,2010,2043,990,1053
39520,48,152,2010,23,4,19
39521,48,116,2010,895,477,418
39522,48,153,2010,382,174,208
39523,48,135,2010,543,236,307
39524,48,80,2010,1,1,0
39525,48,136,2010,23,4,19
39526,48,106,2010,6308,2991,3317
39527,48,172,2010,9823,6501,3322
39528,48,173,2010,0,0,0
39529,48,174,2010,0,0,0
39530,48,107,2010,4806,2243,2563
39531,48,117,2010,4,3,1
39532,48,137,2010,145,69,76
39533,48,96,2010,245,125,120
39534,48,54,2010,2730,1310,1420
39535,48,81,2010,715,485,230
39536,48,14,2010,121,30,91
39537,48,31,2010,1345,692,653
39538,48,176,2010,40,19,21
39539,48,137,2010,1689,816,873
39540,48,39,2010,22586,11116,11470
39541,48,118,2010,34,22,12
39542,48,82,2010,15,7,8
39543,48,83,2010,556,358,198
39544,48,108,2010,582,283,299
39545,48,142,2010,726,226,500
39546,48,97,2010,155,75,80
39547,48,138,2010,3,2,1
39548,48,119,2010,4828,2340,2488
39549,48,40,2010,1975,974,1001
39550,48,148,2010,14,4,10
39551,48,120,2010,5137,2406,2731
39552,48,41,2010,812,420,392
39553,48,42,2010,6593,3921,2672
39554,48,68,2010,4620,2029,2591
39555,48,139,2010,8,3,5
39556,48,155,2010,1012,406,606
39557,48,15,2010,207,111,96
39558,48,69,2010,24735,11554,13181
39559,48,156,2010,1524,710,814
39560,48,55,2010,8,3,5
39561,48,56,2010,849,263,586
39562,48,84,2010,0,0,0
39563,48,98,2010,389,189,200
39564,48,157,2010,163,77,86
39565,48,158,2010,22,9,13
39566,48,110,2010,86,54,32
39567,48,85,2010,30,11,19
39568,48,99,2010,94,47,47
39569,48,32,2010,2145,987,1158
39570,48,43,2010,4849,2366,2483
39571,48,5,2010,8132,4054,4078
39572,48,6,2010,13037,5818,7219
39573,48,16,2010,20534,8794,11740
39574,48,44,2010,700,299,401
39575,48,45,2010,0,0,0
39576,48,17,2010,712,300,412
39577,48,57,2010,2265,807,1458
39578,48,86,2010,145,76,69
39579,48,177,2010,1181,776,405
39580,48,18,2010,301,131,170
39581,48,167,2010,646,411,235
39582,48,121,2010,1496,850,646
39583,48,19,2010,316,124,192
39584,48,168,2010,141,102,39
39585,48,46,2010,2731,1284,1447
39586,48,20,2010,1673,739,934
39587,48,149,2010,9,6,3
39588,48,159,2010,895,463,432
39589,48,143,2010,284,91,193
39590,48,70,2010,25,12,13
39591,48,47,2010,9784,4075,5709
39592,48,71,2010,123,48,75
39593,48,122,2010,444,232,212
39594,48,123,2010,93,52,41
39595,48,7,2010,4,2,2
39596,48,160,2010,39,14,25
39597,48,58,2010,62,30,32
39598,48,161,2010,18,2,16
39599,48,124,2010,173,96,77
39600,48,100,2010,834,489,345
39601,48,72,2010,13,9,4
39602,48,59,2010,304,152,152
39603,48,87,2010,2,1,1
39604,48,144,2010,4874,2092,2782
39605,48,125,2010,138,82,56
39606,48,150,2010,81,46,35
39607,48,8,2010,719,297,422
39608,48,73,2010,7235,3335,3900
39609,48,101,2010,156,91,65
39610,48,162,2010,1002,398,604
39611,48,60,2010,2127,998,1129
39612,48,21,2010,35,12,23
39613,48,9,2010,17152,8275,8877
39614,48,102,2010,52,35,17
39615,48,111,2010,137,82,55
39616,48,112,2010,1161,726,435
39617,48,33,2010,49005,16831,32174
39618,48,61,2010,1098,484,614
39619,48,88,2010,0,0,0
39620,48,22,2010,32,15,17
39621,48,35,2010,4366,2157,2209
39622,48,36,2010,13748,9012,4736
39623,48,126,2010,530,283,247
39624,48,90,2010,3,2,1
39625,48,91,2010,13,6,7
39626,48,92,2010,23,9,14
39627,48,62,2010,4,2,2
39628,48,140,2010,2,0,2
39629,48,23,2010,368,183,185
39630,48,164,2010,173,65,108
39631,48,63,2010,3297,1659,1638
39632,48,127,2010,12,4,8
39633,48,165,2010,468,221,247
39634,48,37,2010,2025,670,1355
39635,48,64,2010,187,98,89
39636,48,128,2010,17925,8381,9544
39637,48,115,2010,1160,541,619
39638,48,129,2010,0,0,0
39639,48,65,2010,2674,1205,1469
39640,48,10,2010,8714,4141,4573
39641,48,145,2010,1061,448,613
39642,48,113,2010,39,23,16
39643,48,49,2010,41604,20792,20812
39644,48,74,2010,1868,949,919
39645,48,25,2010,1423,648,775
39646,48,169,2010,91,52,39
39647,48,166,2010,95,44,51
39648,48,93,2010,334,181,153
39649,48,146,2010,855,260,595
39650,48,26,2010,10429,4530,5899
39651,48,170,2010,57,26,31
39652,48,94,2010,0,0,0
39653,48,130,2010,824,431,393
39654,48,38,2010,2432,1859,573
39655,48,27,2010,245,125,120
39656,48,50,2010,16760,6828,9932
39657,48,131,2010,832,427,405
39658,48,114,2010,186,96,90
39659,48,171,2010,302,166,136
39660,48,1,2010,12919,6835,6084
39661,48,28,2010,170,77,93
39662,48,132,2010,463,247,216
39663,48,133,2010,228,108,120
39664,21,13,2010,393,173,220
39665,21,3,2010,108861,8099,100762
39666,21,10,2010,10342,5360,4982
39667,21,68,2010,1162,345,817
39668,21,5,2010,473206,69253,403953
39669,21,16,2010,4226,1660,2566
39670,21,18,2010,7523,2748,4775
39671,21,19,2010,294,58,236
39672,21,73,2010,556,144,412
39673,21,9,2010,86029,9586,76443
39674,21,22,2010,170,34,136
39675,21,23,2010,736,209,527
39676,21,129,2010,0,0,0
39677,21,145,2010,6978,2690,4288
39678,21,27,2010,6529,2800,3729
39679,21,142,2010,30361,10509,19852
39680,21,50,2010,4120,1328,2792
39681,9,2,2010,1990641,973633,1017008
39682,9,10,2010,663,317,346
39683,9,172,2010,338,142,196
39684,9,5,2010,1943345,890146,1053199
39685,9,6,2010,2345,1048,1297
39686,9,16,2010,287,138,149
39687,102,103,2010,2179,983,1196
39688,102,66,2010,93,43,50
39689,102,3,2010,36,8,28
39690,102,79,2010,29,15,14
39691,102,67,2010,232,73,159
39692,102,105,2010,1710,904,806
39693,102,95,2010,74,27,47
39694,102,30,2010,63,25,38
39695,102,106,2010,1549,723,826
39696,102,172,2010,15942,7512,8430
39697,102,107,2010,47190,25389,21801
39698,102,96,2010,6629,3469,3160
39699,102,54,2010,87,21,66
39700,102,81,2010,2413,1003,1410
39701,102,31,2010,34,21,13
39702,102,39,2010,127,27,100
39703,102,82,2010,50,32,18
39704,102,83,2010,6914,4657,2257
39705,102,108,2010,2282,1053,1229
39706,102,97,2010,2756,1382,1374
39707,102,42,2010,40,21,19
39708,102,68,2010,828,332,496
39709,102,15,2010,50,6,44
39710,102,69,2010,909,376,533
39711,102,56,2010,278,49,229
39712,102,84,2010,23,10,13
39713,102,98,2010,1372,598,774
39714,102,110,2010,42,23,19
39715,102,85,2010,463,250,213
39716,102,99,2010,1284,672,612
39717,102,173,2010,240,122,118
39718,102,32,2010,51,19,32
39719,102,5,2010,3828,1434,2394
39720,102,6,2010,74,19,55
39721,102,44,2010,80,23,57
39722,102,17,2010,951,299,652
39723,102,57,2010,1125,345,780
39724,102,86,2010,595,306,289
39725,102,177,2010,317,144,173
39726,102,18,2010,102,30,72
39727,102,20,2010,450,185,265
39728,102,143,2010,34,8,26
39729,102,47,2010,40,10,30
39730,102,100,2010,4127,1872,2255
39731,102,144,2010,68,23,45
39732,102,73,2010,413,133,280
39733,102,101,2010,11032,6444,4588
39734,102,162,2010,33,8,25
39735,102,48,2010,66,25,41
39736,102,9,2010,72,30,42
39737,102,111,2010,104,64,40
39738,102,112,2010,3666,1605,2061
39739,102,33,2010,168,62,106
39740,102,61,2010,217,73,144
39741,102,88,2010,616,220,396
39742,102,35,2010,155,43,112
39743,102,36,2010,851,306,545
39744,102,23,2010,44,15,29
39745,102,63,2010,23,4,19
39746,102,37,2010,31,19,12
39747,102,1,2010,51,21,30
39748,102,115,2010,40,21,19
39749,102,65,2010,3162,1190,1972
39750,102,49,2010,182,49,133
39751,102,74,2010,314,103,211
39752,102,25,2010,227,92,135
39753,102,93,2010,102,47,55
39754,102,26,2010,97,21,76
39755,102,38,2010,430,73,357
39756,102,142,2010,63,25,38
39757,102,50,2010,1723,603,1120
39758,102,114,2010,650,269,381
39759,111,103,2010,58456,29031,29425
39760,111,105,2010,75523,35963,39560
39761,111,106,2010,2161,891,1270
39762,111,172,2010,800,352,448
39763,111,68,2010,630,249,381
39764,111,69,2010,1700,718,982
39765,111,57,2010,898,345,553
39766,111,177,2010,2032,971,1061
39767,111,100,2010,1645,818,827
39768,111,33,2010,894,420,474
39769,111,65,2010,905,381,524
39770,111,50,2010,179,81,98
39771,111,114,2010,2997,1290,1707
39772,112,141,2010,18,6,12
39773,112,134,2010,14,10,4
39774,112,103,2010,11961,5850,6111
39775,112,66,2010,189,86,103
39776,112,67,2010,589,282,307
39777,112,105,2010,6193,2824,3369
39778,112,30,2010,65,26,39
39779,112,106,2010,7564,3829,3735
39780,112,172,2010,6491,2422,4069
39781,112,107,2010,6454,3260,3194
39782,112,96,2010,323,168,155
39783,112,54,2010,88,19,69
39784,112,81,2010,868,353,515
39785,112,31,2010,87,39,48
39786,112,39,2010,233,105,128
39787,112,83,2010,174,89,85
39788,112,108,2010,5312,2734,2578
39789,112,97,2010,103,54,49
39790,112,40,2010,16,8,8
39791,112,42,2010,68,35,33
39792,112,68,2010,2743,1253,1490
39793,112,109,2010,33,18,15
39794,112,69,2010,3268,1529,1739
39795,112,56,2010,57,16,41
39796,112,98,2010,156,80,76
39797,112,85,2010,47,29,18
39798,112,99,2010,158,98,60
39799,112,32,2010,62,32,30
39800,112,43,2010,14,3,11
39801,112,5,2010,402,118,284
39802,112,6,2010,55,17,38
39803,112,16,2010,18,4,14
39804,112,44,2010,203,101,102
39805,112,17,2010,486,191,295
39806,112,57,2010,3521,1553,1968
39807,112,177,2010,3214,1593,1621
39808,112,18,2010,38,12,26
39809,112,176,2010,83,37,46
39810,112,20,2010,67,27,40
39811,112,71,2010,14,6,8
39812,112,58,2010,20,1,19
39813,112,100,2010,1928,944,984
39814,112,144,2010,37,12,25
39815,112,73,2010,650,294,356
39816,112,101,2010,154,92,62
39817,112,48,2010,101,48,53
39818,112,9,2010,69,16,53
39819,112,102,2010,330,169,161
39820,112,111,2010,523,287,236
39821,112,33,2010,190,94,96
39822,112,61,2010,124,44,80
39823,112,88,2010,131,72,59
39824,112,35,2010,176,95,81
39825,112,36,2010,603,385,218
39826,112,92,2010,21,15,6
39827,112,23,2010,32,14,18
39828,112,64,2010,27,12,15
39829,112,115,2010,111,42,69
39830,112,65,2010,5483,2471,3012
39831,112,49,2010,270,128,142
39832,112,74,2010,748,345,403
39833,112,26,2010,50,18,32
39834,112,38,2010,231,152,79
39835,112,142,2010,19,4,15
39836,112,50,2010,1904,861,1043
39837,112,114,2010,587,253,334
39838,33,2,2010,147,15,132
39839,33,51,2010,131,20,111
39840,33,141,2010,604,109,495
39841,33,134,2010,59,7,52
39842,33,103,2010,283,111,172
39843,33,11,2010,2183,839,1344
39844,33,66,2010,3930,2021,1909
39845,33,12,2010,276,126,150
39846,33,3,2010,103,15,88
39847,33,29,2010,78747,49992,28755
39848,33,67,2010,5413,2653,2760
39849,33,53,2010,3606,2196,1410
39850,33,105,2010,270,117,153
39851,33,30,2010,1794,776,1018
39852,33,135,2010,48,11,37
39853,33,106,2010,61,26,35
39854,33,172,2010,1221,681,540
39855,33,107,2010,128,67,61
39856,33,137,2010,110,47,63
39857,33,96,2010,37,0,37
39858,33,54,2010,815,361,454
39859,33,81,2010,234,79,155
39860,33,14,2010,216,80,136
39861,33,31,2010,4680,2565,2115
39862,33,39,2010,926,443,483
39863,33,83,2010,21,15,6
39864,33,108,2010,47,0,47
39865,33,142,2010,469,124,345
39866,33,119,2010,25,25,0
39867,33,40,2010,206,134,72
39868,33,120,2010,45,14,31
39869,33,42,2010,260,150,110
39870,33,68,2010,27091,15783,11308
39871,33,15,2010,638,391,247
39872,33,69,2010,79149,44099,35050
39873,33,156,2010,37,13,24
39874,33,56,2010,3214,1464,1750
39875,33,157,2010,58,10,48
39876,33,110,2010,27,12,15
39877,33,32,2010,1393,747,646
39878,33,43,2010,511,266,245
39879,33,5,2010,889,304,585
39880,33,6,2010,239,73,166
39881,33,16,2010,441,110,331
39882,33,44,2010,7874,3887,3987
39883,33,17,2010,359,139,220
39884,33,57,2010,10304,4741,5563
39885,33,177,2010,529,332,197
39886,33,18,2010,142,17,125
39887,33,167,2010,4775,2626,2149
39888,33,121,2010,63,30,33
39889,33,19,2010,199,54,145
39890,33,168,2010,130,42,88
39891,33,46,2010,1608,998,610
39892,33,20,2010,397,78,319
39893,33,143,2010,249,80,169
39894,33,47,2010,52319,33682,18637
39895,33,71,2010,239,154,85
39896,33,160,2010,31,4,27
39897,33,100,2010,220,88,132
39898,33,72,2010,25,9,16
39899,33,59,2010,61,17,44
39900,33,144,2010,329,55,274
39901,33,125,2010,28,0,28
39902,33,8,2010,58,15,43
39903,33,73,2010,2686,1070,1616
39904,33,162,2010,395,7,388
39905,33,60,2010,275,110,165
39906,33,48,2010,1585,832,753
39907,33,9,2010,221,20,201
39908,33,102,2010,34,19,15
39909,33,112,2010,116,22,94
39910,33,61,2010,142,47,95
39911,33,22,2010,26,15,11
39912,33,35,2010,2573,1518,1055
39913,33,36,2010,39565,26357,13208
39914,33,23,2010,181,87,94
39915,33,164,2010,91,20,71
39916,33,63,2010,1073,407,666
39917,33,37,2010,1344,760,584
39918,33,64,2010,158,59,99
39919,33,115,2010,395,173,222
39920,33,65,2010,5000,2447,2553
39921,33,10,2010,89,46,43
39922,33,145,2010,117,23,94
39923,33,49,2010,1355,564,791
39924,33,74,2010,1053,491,562
39925,33,25,2010,610,97,513
39926,33,169,2010,60,45,15
39927,33,146,2010,425,52,373
39928,33,26,2010,906,214,692
39929,33,170,2010,56,52,4
39930,33,130,2010,65,40,25
39931,33,38,2010,214193,137339,76854
39932,33,27,2010,130,63,67
39933,33,50,2010,35829,17131,18698
39934,33,131,2010,72,27,45
39935,33,114,2010,97,49,48
39936,33,171,2010,515,344,171
39937,33,1,2010,2896,1178,1718
39938,33,28,2010,118,47,71
39939,33,132,2010,44,6,38
39940,33,133,2010,107,59,48
39941,61,51,2010,44,20,24
39942,61,141,2010,203,48,155
39943,61,52,2010,329,170,159
39944,61,134,2010,137826,73156,64670
39945,61,103,2010,1165,607,558
39946,61,11,2010,89,31,58
39947,61,66,2010,445,228,217
39948,61,12,2010,58,23,35
39949,61,3,2010,1297,334,963
39950,61,29,2010,834,422,412
39951,61,67,2010,3017,1526,1491
39952,61,151,2010,29,0,29
39953,61,53,2010,37,29,8
39954,61,105,2010,118415,67071,51344
39955,61,30,2010,4568,2196,2372
39956,61,153,2010,52513,27411,25102
39957,61,135,2010,65,20,45
39958,61,106,2010,172,90,82
39959,61,172,2010,9227,4376,4851
39960,61,173,2010,116,69,47
39961,61,174,2010,1760,967,793
39962,61,107,2010,568,369,199
39963,61,137,2010,419,361,58
39964,61,54,2010,72,41,31
39965,61,81,2010,1431,1095,336
39966,61,14,2010,26,12,14
39967,61,31,2010,218,146,72
39968,61,176,2010,65,38,27
39969,61,137,2010,1603,531,1072
39970,61,39,2010,349,167,182
39971,61,83,2010,59,37,22
39972,61,108,2010,394,200,194
39973,61,142,2010,370,48,322
39974,61,97,2010,76,68,8
39975,61,138,2010,194,177,17
39976,61,40,2010,112,80,32
39977,61,148,2010,511,208,303
39978,61,120,2010,27,9,18
39979,61,42,2010,295,177,118
39980,61,68,2010,80086,42448,37638
39981,61,139,2010,499,14,485
39982,61,155,2010,101,17,84
39983,61,15,2010,943,234,709
39984,61,69,2010,23733,11991,11742
39985,61,156,2010,170,43,127
39986,61,56,2010,165,76,89
39987,61,98,2010,27,14,13
39988,61,157,2010,3970,1844,2126
39989,61,158,2010,25070,10817,14253
39990,61,32,2010,352,234,118
39991,61,43,2010,25,13,12
39992,61,5,2010,6889,2887,4002
39993,61,6,2010,180,81,99
39994,61,16,2010,37,11,26
39995,61,44,2010,1377,690,687
39996,61,17,2010,299,29,270
39997,61,57,2010,2405,991,1414
39998,61,86,2010,23,9,14
39999,61,177,2010,273,158,115
40000,61,18,2010,25,9,16
40001,61,167,2010,769,357,412
40002,61,121,2010,90,44,46
40003,61,46,2010,182,135,47
40004,61,20,2010,65,25,40
40005,61,159,2010,25,0,25
40006,61,143,2010,25,4,21
40007,61,70,2010,179,0,179
40008,61,47,2010,322,205,117
40009,61,71,2010,3463,1740,1723
40010,61,122,2010,23,9,14
40011,61,123,2010,403,245,158
40012,61,160,2010,100,7,93
40013,61,58,2010,38,23,15
40014,61,161,2010,35,6,29
40015,61,100,2010,234,127,107
40016,61,59,2010,69,62,7
40017,61,144,2010,1736,560,1176
40018,61,125,2010,61946,32546,29400
40019,61,8,2010,468,136,332
40020,61,73,2010,3493,1681,1812
40021,61,162,2010,235,81,154
40022,61,60,2010,241,119,122
40023,61,48,2010,292,147,145
40024,61,9,2010,1708,566,1142
40025,61,102,2010,30,17,13
40026,61,111,2010,48,29,19
40027,61,112,2010,252,146,106
40028,61,33,2010,859,611,248
40029,61,35,2010,20079,9598,10481
40030,61,36,2010,5006,2964,2042
40031,61,140,2010,15804,8639,7165
40032,61,164,2010,1833,372,1461
40033,61,63,2010,46,23,23
40034,61,165,2010,48,7,41
40035,61,37,2010,82,62,20
40036,61,64,2010,50,31,19
40037,61,115,2010,9728,5093,4635
40038,61,65,2010,13976,7843,6133
40039,61,10,2010,23,9,14
40040,61,49,2010,709,384,325
40041,61,74,2010,14276,7000,7276
40042,61,25,2010,23,9,14
40043,61,166,2010,66,19,47
40044,61,146,2010,121,25,96
40045,61,26,2010,262,103,159
40046,61,130,2010,24,14,10
40047,61,38,2010,41047,17108,23939
40048,61,50,2010,16215,7966,8249
40049,61,131,2010,61,29,32
40050,61,114,2010,198,61,137
40051,61,171,2010,776,235,541
40052,61,1,2010,48,23,25
40053,61,133,2010,1010,99,911
40054,88,103,2010,1369,727,642
40055,88,105,2010,97,52,45
40056,88,106,2010,1052,559,493
40057,88,172,2010,1351,718,633
40058,88,107,2010,4589,2438,2151
40059,88,96,2010,551,292,259
40060,88,81,2010,12882,6843,6039
40061,88,82,2010,1215,646,569
40062,88,83,2010,63981,33992,29989
40063,88,108,2010,999,531,468
40064,88,142,2010,36,19,17
40065,88,97,2010,1327,705,622
40066,88,68,2010,146,78,68
40067,88,69,2010,515,273,242
40068,88,98,2010,511,271,240
40069,88,110,2010,52,27,25
40070,88,85,2010,235,125,110
40071,88,99,2010,174,92,82
40072,88,5,2010,51,27,24
40073,88,17,2010,46,24,22
40074,88,57,2010,195,104,91
40075,88,86,2010,44,23,21
40076,88,177,2010,85,46,39
40077,88,18,2010,92,49,43
40078,88,20,2010,18,10,8
40079,88,100,2010,3142,1669,1473
40080,88,73,2010,28,14,14
40081,88,101,2010,239,127,112
40082,88,102,2010,617,328,289
40083,88,112,2010,603,320,283
40084,88,33,2010,19,10,9
40085,88,61,2010,36,19,17
40086,88,65,2010,2344,1245,1099
40087,88,93,2010,176,93,83
40088,88,26,2010,22,12,10
40089,88,50,2010,176,93,83
40090,88,1,2010,65,34,31
40091,22,2,2010,1356,269,1087
40092,22,13,2010,659,239,420
40093,22,3,2010,169370,14102,155268
40094,22,10,2010,33403,9465,23938
40095,22,136,2010,663,131,532
40096,22,120,2010,1846,366,1480
40097,22,119,2010,2401,476,1925
40098,22,68,2010,1374,322,1052
40099,22,5,2010,540914,79934,460980
40100,22,18,2010,26916,5961,20955
40101,22,19,2010,8395,1680,6715
40102,22,20,2010,5865,1164,4701
40103,22,144,2010,1431,284,1147
40104,22,8,2010,66011,13125,52886
40105,22,73,2010,497,121,376
40106,22,162,2010,2347,466,1881
40107,22,9,2010,145204,20570,124634
40108,22,23,2010,1054,204,850
40109,22,128,2010,1609,319,1290
40110,22,129,2010,2632,585,2047
40111,22,145,2010,22272,4953,17319
40112,22,25,2010,8688,1725,6963
40113,22,27,2010,12533,3658,8875
40114,22,146,2010,910,180,730
40115,22,26,2010,6249,1240,5009
40116,22,142,2010,136060,28740,107320
40117,22,50,2010,4771,1032,3739
40118,22,28,2010,33584,6666,26918
40119,35,2,2010,0,0,0
40120,35,51,2010,790,411,379
40121,35,141,2010,12,3,9
40122,35,52,2010,0,0,0
40123,35,134,2010,0,0,0
40124,35,75,2010,0,0,0
40125,35,76,2010,0,0,0
40126,35,103,2010,26,13,13
40127,35,11,2010,11,6,5
40128,35,66,2010,816,375,441
40129,35,12,2010,0,0,0
40130,35,78,2010,0,0,0
40131,35,13,2010,0,0,0
40132,35,3,2010,11,3,8
40133,35,79,2010,0,0,0
40134,35,29,2010,25,12,13
40135,35,67,2010,1026,496,530
40136,35,95,2010,0,0,0
40137,35,151,2010,0,0,0
40138,35,4,2010,0,0,0
40139,35,53,2010,70,34,36
40140,35,147,2010,0,0,0
40141,35,105,2010,8,2,6
40142,35,30,2010,20319,11307,9012
40143,35,152,2010,0,0,0
40144,35,116,2010,0,0,0
40145,35,153,2010,0,0,0
40146,35,135,2010,2,0,2
40147,35,80,2010,0,0,0
40148,35,136,2010,0,0,0
40149,35,106,2010,2,1,1
40150,35,172,2010,2695,1104,1591
40151,35,107,2010,0,0,0
40152,35,117,2010,0,0,0
40153,35,137,2010,0,0,0
40154,35,96,2010,0,0,0
40155,35,54,2010,537,171,366
40156,35,81,2010,4,1,3
40157,35,14,2010,74,40,34
40158,35,31,2010,636,379,257
40159,35,176,2010,0,0,0
40160,35,137,2010,0,0,0
40161,35,39,2010,89,45,44
40162,35,118,2010,0,0,0
40163,35,82,2010,0,0,0
40164,35,83,2010,1,1,0
40165,35,108,2010,0,0,0
40166,35,142,2010,41,12,29
40167,35,97,2010,0,0,0
40168,35,138,2010,0,0,0
40169,35,119,2010,0,0,0
40170,35,40,2010,0,0,0
40171,35,148,2010,0,0,0
40172,35,120,2010,0,0,0
40173,35,41,2010,0,0,0
40174,35,42,2010,58,35,23
40175,35,68,2010,1880,787,1093
40176,35,139,2010,0,0,0
40177,35,155,2010,0,0,0
40178,35,15,2010,2,0,2
40179,35,69,2010,3208,1516,1692
40180,35,156,2010,2,0,2
40181,35,55,2010,0,0,0
40182,35,56,2010,5657,2592,3065
40183,35,84,2010,0,0,0
40184,35,98,2010,0,0,0
40185,35,157,2010,2,0,2
40186,35,158,2010,0,0,0
40187,35,110,2010,0,0,0
40188,35,85,2010,0,0,0
40189,35,99,2010,0,0,0
40190,35,32,2010,6673,3973,2700
40191,35,43,2010,0,0,0
40192,35,5,2010,9,4,5
40193,35,6,2010,1144,183,961
40194,35,16,2010,1245,330,915
40195,35,44,2010,379,174,205
40196,35,45,2010,0,0,0
40197,35,17,2010,1006,255,751
40198,35,57,2010,13083,5615,7468
40199,35,86,2010,0,0,0
40200,35,177,2010,22,9,13
40201,35,18,2010,1042,223,819
40202,35,167,2010,5,4,1
40203,35,121,2010,0,0,0
40204,35,19,2010,0,0,0
40205,35,168,2010,0,0,0
40206,35,46,2010,0,0,0
40207,35,20,2010,1256,243,1013
40208,35,159,2010,0,0,0
40209,35,143,2010,0,0,0
40210,35,70,2010,0,0,0
40211,35,47,2010,4,2,2
40212,35,71,2010,19,6,13
40213,35,122,2010,0,0,0
40214,35,123,2010,0,0,0
40215,35,7,2010,0,0,0
40216,35,160,2010,0,0,0
40217,35,58,2010,0,0,0
40218,35,161,2010,0,0,0
40219,35,124,2010,0,0,0
40220,35,100,2010,13,9,4
40221,35,72,2010,0,0,0
40222,35,59,2010,0,0,0
40223,35,144,2010,16,8,8
40224,35,125,2010,0,0,0
40225,35,150,2010,0,0,0
40226,35,8,2010,0,0,0
40227,35,73,2010,439,166,273
40228,35,101,2010,0,0,0
40229,35,162,2010,5,1,4
40230,35,60,2010,940,447,493
40231,35,48,2010,4,2,2
40232,35,21,2010,0,0,0
40233,35,9,2010,11,1,10
40234,35,102,2010,0,0,0
40235,35,111,2010,0,0,0
40236,35,112,2010,0,0,0
40237,35,33,2010,460,270,190
40238,35,61,2010,637,349,288
40239,35,22,2010,0,0,0
40240,35,36,2010,8135,5257,2878
40241,35,126,2010,0,0,0
40242,35,91,2010,0,0,0
40243,35,92,2010,0,0,0
40244,35,62,2010,0,0,0
40245,35,140,2010,0,0,0
40246,35,23,2010,17,0,17
40247,35,164,2010,2,0,2
40248,35,63,2010,2177,1082,1095
40249,35,165,2010,0,0,0
40250,35,37,2010,158,87,71
40251,35,64,2010,0,0,0
40252,35,128,2010,0,0,0
40253,35,115,2010,0,0,0
40254,35,65,2010,7333,3518,3815
40255,35,10,2010,0,0,0
40256,35,145,2010,0,0,0
40257,35,113,2010,0,0,0
40258,35,49,2010,168,77,91
40259,35,74,2010,99,52,47
40260,35,25,2010,4087,1489,2598
40261,35,169,2010,0,0,0
40262,35,166,2010,0,0,0
40263,35,93,2010,0,0,0
40264,35,146,2010,8,4,4
40265,35,26,2010,3710,735,2975
40266,35,170,2010,0,0,0
40267,35,130,2010,0,0,0
40268,35,38,2010,14032,8127,5905
40269,35,27,2010,13,0,13
40270,35,50,2010,1063,466,597
40271,35,131,2010,0,0,0
40272,35,114,2010,0,0,0
40273,35,171,2010,0,0,0
40274,35,1,2010,21,5,16
40275,35,28,2010,0,0,0
40276,35,132,2010,0,0,0
40277,35,133,2010,0,0,0
40278,36,2,2010,4999,1167,3832
40279,36,51,2010,230,94,136
40280,36,141,2010,763,226,537
40281,36,134,2010,501,98,403
40282,36,12,2010,752975,334175,418800
40283,36,103,2010,247,94,153
40284,36,66,2010,2897,1515,1382
40285,36,3,2010,463,62,401
40286,36,11,2010,517417,225949,291468
40287,36,67,2010,463,203,260
40288,36,53,2010,505,62,443
40289,36,147,2010,27,19,8
40290,36,105,2010,425,193,232
40291,36,30,2010,5731,1832,3899
40292,36,116,2010,128,21,107
40293,36,29,2010,749972,426449,323523
40294,36,135,2010,328,66,262
40295,36,153,2010,45,19,26
40296,36,10,2010,576,251,325
40297,36,136,2010,149,26,123
40298,36,106,2010,104,40,64
40299,36,172,2010,55119,24124,30995
40300,36,107,2010,203,62,141
40301,36,117,2010,87,42,45
40302,36,137,2010,569,143,426
40303,36,96,2010,31,14,17
40304,36,54,2010,314,85,229
40305,36,81,2010,2185,838,1347
40306,36,14,2010,703,345,358
40307,36,31,2010,11047,5512,5535
40308,36,151,2010,93,23,70
40309,36,39,2010,227,102,125
40310,36,108,2010,236,73,163
40311,36,138,2010,102,36,66
40312,36,120,2010,266,65,201
40313,36,40,2010,57651,30833,26818
40314,36,42,2010,2169,1169,1000
40315,36,68,2010,2518,1112,1406
40316,36,15,2010,441793,204177,237616
40317,36,69,2010,139367,70287,69080
40318,36,156,2010,310,63,247
40319,36,56,2010,1916,819,1097
40320,36,157,2010,200,43,157
40321,36,173,2010,58,24,34
40322,36,32,2010,16525,8259,8266
40323,36,43,2010,44,23,21
40324,36,5,2010,5594,1413,4181
40325,36,6,2010,1974,681,1293
40326,36,16,2010,968,182,786
40327,36,44,2010,171,84,87
40328,36,17,2010,3580,1605,1975
40329,36,57,2010,1861,709,1152
40330,36,177,2010,1005,498,507
40331,36,167,2010,2512343,1349679,1162664
40332,36,18,2010,801,141,660
40333,36,121,2010,443,151,292
40334,36,176,2010,10425,2363,8062
40335,36,19,2010,84,29,55
40336,36,168,2010,580279,296926,283353
40337,36,20,2010,949,157,792
40338,36,46,2010,87715,46671,41044
40339,36,143,2010,264,97,167
40340,36,47,2010,69747,36984,32763
40341,36,71,2010,35,14,21
40342,36,122,2010,82,26,56
40343,36,123,2010,28,11,17
40344,36,7,2010,45,27,18
40345,36,160,2010,71,6,65
40346,36,58,2010,52,25,27
40347,36,124,2010,63,18,45
40348,36,100,2010,200,104,96
40349,36,72,2010,45,30,15
40350,36,59,2010,259,53,206
40351,36,144,2010,1081,332,749
40352,36,125,2010,109,33,76
40353,36,21,2010,51,20,31
40354,36,150,2010,118,48,70
40355,36,8,2010,171,21,150
40356,36,73,2010,538,226,312
40357,36,101,2010,59,16,43
40358,36,162,2010,781,150,631
40359,36,48,2010,687,374,313
40360,36,9,2010,714,146,568
40361,36,102,2010,24,4,20
40362,36,111,2010,36,20,16
40363,36,112,2010,271,76,195
40364,36,33,2010,28661,14981,13680
40365,36,61,2010,228,102,126
40366,36,158,2010,128,37,91
40367,36,22,2010,25,11,14
40368,36,35,2010,3837,2144,1693
40369,36,126,2010,45,18,27
40370,36,75,2010,48,11,37
40371,36,62,2010,46,30,16
40372,36,23,2010,214,62,152
40373,36,164,2010,71,22,49
40374,36,37,2010,1798,852,946
40375,36,1,2010,13416,4998,8418
40376,36,64,2010,344,117,227
40377,36,128,2010,57,7,50
40378,36,115,2010,236,106,130
40379,36,133,2010,71,30,41
40380,36,65,2010,1368,631,737
40381,36,145,2010,254,25,229
40382,36,49,2010,467,222,245
40383,36,74,2010,569,282,287
40384,36,25,2010,3203,499,2704
40385,36,169,2010,457775,186650,271125
40386,36,27,2010,349,147,202
40387,36,146,2010,329,71,258
40388,36,26,2010,10045,2117,7928
40389,36,170,2010,182189,94816,87373
40390,36,130,2010,80,34,46
40391,36,38,2010,2978217,1602112,1376105
40392,36,60,2010,251,45,206
40393,36,142,2010,1041,321,720
40394,36,50,2010,1708,750,958
40395,36,131,2010,213,72,141
40396,36,152,2010,436,245,191
40397,36,114,2010,118,65,53
40398,36,171,2010,1125335,534248,591087
40399,36,28,2010,636,65,571
40400,36,132,2010,463,137,326
40401,126,116,2010,64931,30008,34923
40402,126,137,2010,207397,107077,100320
40403,126,121,2010,2598,1090,1508
40404,126,130,2010,92808,44731,48077
40405,126,131,2010,43060,21455,21605
40406,90,76,2010,393,202,191
40407,90,78,2010,21,8,13
40408,90,79,2010,94,51,43
40409,90,82,2010,195,90,105
40410,90,84,2010,56,26,30
40411,90,110,2010,756,355,401
40412,90,86,2010,138,70,68
40413,90,87,2010,418,208,210
40414,90,91,2010,102,46,56
40415,90,92,2010,166,80,86
40416,90,93,2010,259,111,148
40417,91,76,2010,94,47,47
40418,91,66,2010,11,5,6
40419,91,78,2010,12,3,9
40420,91,79,2010,440,222,218
40421,91,67,2010,10,4,6
40422,91,105,2010,9,3,6
40423,91,95,2010,1,0,1
40424,91,80,2010,11,2,9
40425,91,172,2010,55,28,27
40426,91,81,2010,87,50,37
40427,91,82,2010,273,133,140
40428,91,83,2010,40,24,16
40429,91,120,2010,3,2,1
40430,91,68,2010,57,18,39
40431,91,109,2010,149,97,52
40432,91,69,2010,53,33,20
40433,91,156,2010,19,7,12
40434,91,84,2010,176,72,104
40435,91,98,2010,4,1,3
40436,91,110,2010,2274,1256,1018
40437,91,85,2010,26,12,14
40438,91,5,2010,228,92,136
40439,91,44,2010,18,8,10
40440,91,57,2010,15,8,7
40441,91,86,2010,407,244,163
40442,91,177,2010,11,9,2
40443,91,20,2010,0,0,0
40444,91,100,2010,19,17,2
40445,91,87,2010,32,17,15
40446,91,73,2010,13,4,9
40447,91,77,2010,31,20,11
40448,91,162,2010,73,53,20
40449,91,9,2010,3,1,2
40450,91,102,2010,8,3,5
40451,91,88,2010,9,2,7
40452,91,90,2010,38,22,16
40453,91,75,2010,6,3,3
40454,91,92,2010,329,191,138
40455,91,115,2010,6,2,4
40456,91,133,2010,0,0,0
40457,91,113,2010,23,13,10
40458,91,74,2010,10,4,6
40459,91,25,2010,144,33,111
40460,91,93,2010,549,291,258
40461,91,50,2010,826,429,397
40462,92,76,2010,58,24,34
40463,92,79,2010,346,149,197
40464,92,82,2010,84,46,38
40465,92,84,2010,431,243,188
40466,92,110,2010,242,130,112
40467,92,86,2010,125,61,64
40468,92,90,2010,39,26,13
40469,92,91,2010,237,135,102
40470,92,93,2010,966,475,491
40471,92,50,2010,798,381,417
40472,62,57,2010,4288,1711,2577
40473,62,51,2010,30,23,7
40474,62,33,2010,25,22,3
40475,62,35,2010,109,89,20
40476,62,38,2010,53,50,3
40477,62,36,2010,29,27,2
40478,62,68,2010,24,15,9
40479,62,103,2010,69,33,36
40480,62,105,2010,24,21,3
40481,140,134,2010,404,241,163
40482,140,153,2010,1538,798,740
40483,140,138,2010,165,105,60
40484,140,139,2010,268,79,189
40485,140,125,2010,131,20,111
40486,140,61,2010,134,65,69
40487,23,2,2010,280395,83043,197352
40488,23,3,2010,808485,181979,626506
40489,23,10,2010,338283,100188,238095
40490,23,120,2010,102910,30783,72127
40491,23,5,2010,1579235,458362,1120873
40492,23,16,2010,5039,2251,2788
40493,23,18,2010,152257,45093,107164
40494,23,20,2010,96479,28573,67906
40495,23,8,2010,299632,66555,233077
40496,23,9,2010,938913,258609,680304
40497,23,145,2010,301500,89294,212206
40498,23,25,2010,515803,198592,317211
40499,23,142,2010,603000,178588,424412
40500,23,28,2010,482400,150014,332386
40501,164,141,2010,3940,2463,1477
40502,164,105,2010,609,308,301
40503,164,135,2010,953,574,379
40504,164,137,2010,238,115,123
40505,164,151,2010,3393,1621,1772
40506,164,68,2010,13027,6580,6447
40507,164,155,2010,4849,2660,2189
40508,164,69,2010,821,398,423
40509,164,156,2010,1678,368,1310
40510,164,157,2010,48426,17508,30918
40511,164,20,2010,1037,359,678
40512,164,159,2010,592,286,306
40513,164,160,2010,32035,14083,17952
40514,164,161,2010,50090,23361,26729
40515,164,144,2010,3873,1957,1916
40516,164,162,2010,797,206,591
40517,164,158,2010,27726,15273,12453
40518,164,126,2010,297,143,154
40519,164,23,2010,1340,687,653
40520,164,165,2010,14007,7329,6678
40521,164,166,2010,1570,515,1055
40522,164,26,2010,0,0,0
40523,63,51,2010,478,390,88
40524,63,141,2010,55,21,34
40525,63,103,2010,51,35,16
40526,63,66,2010,7160,3683,3477
40527,63,11,2010,162,129,33
40528,63,67,2010,223,97,126
40529,63,53,2010,343743,192207,151536
40530,63,105,2010,87,55,32
40531,63,30,2010,1161,852,309
40532,63,29,2010,138,121,17
40533,63,172,2010,1804,824,980
40534,63,54,2010,289781,159112,130669
40535,63,81,2010,30,15,15
40536,63,14,2010,177,82,95
40537,63,31,2010,526,369,157
40538,63,39,2010,188,96,92
40539,63,42,2010,35,20,15
40540,63,68,2010,5513,2886,2627
40541,63,15,2010,50,36,14
40542,63,69,2010,16455,8258,8197
40543,63,156,2010,30,11,19
40544,63,56,2010,936,474,462
40545,63,32,2010,1842,1243,599
40546,63,5,2010,302,175,127
40547,63,6,2010,67,7,60
40548,63,16,2010,181,63,118
40549,63,44,2010,54,26,28
40550,63,17,2010,112,55,57
40551,63,57,2010,1968,913,1055
40552,63,177,2010,40,23,17
40553,63,167,2010,100,81,19
40554,63,18,2010,102,23,79
40555,63,19,2010,69,28,41
40556,63,20,2010,47,21,26
40557,63,143,2010,383,163,220
40558,63,47,2010,29,22,7
40559,63,71,2010,93,37,56
40560,63,58,2010,55,27,28
40561,63,100,2010,27,16,11
40562,63,59,2010,72867,40721,32146
40563,63,144,2010,34,22,12
40564,63,73,2010,770,368,402
40565,63,48,2010,142,64,78
40566,63,112,2010,51,33,18
40567,63,33,2010,680,596,84
40568,63,61,2010,40,16,24
40569,63,35,2010,3691,3132,559
40570,63,36,2010,3012,2220,792
40571,63,37,2010,488,357,131
40572,63,64,2010,11183,6312,4871
40573,63,115,2010,145,79,66
40574,63,133,2010,29,17,12
40575,63,65,2010,162,73,89
40576,63,49,2010,1219,608,611
40577,63,74,2010,2922,1418,1504
40578,63,25,2010,126,25,101
40579,63,27,2010,25,13,12
40580,63,146,2010,41,11,30
40581,63,26,2010,397,131,266
40582,63,170,2010,30,24,6
40583,63,38,2010,1304,1118,186
40584,63,60,2010,47797,29008,18789
40585,63,142,2010,79,27,52
40586,63,50,2010,662,314,348
40587,63,171,2010,82,76,6
40588,63,132,2010,59,32,27
40589,127,3,2010,197,42,155
40590,127,67,2010,34,23,11
40591,127,10,2010,534,162,372
40592,127,172,2010,456,58,398
40593,127,81,2010,39,23,16
40594,127,68,2010,214,111,103
40595,127,69,2010,76,45,31
40596,127,5,2010,5788,1655,4133
40597,127,57,2010,109,45,64
40598,127,121,2010,366,241,125
40599,127,122,2010,716,146,570
40600,127,7,2010,34,13,21
40601,127,124,2010,495,136,359
40602,127,8,2010,157,19,138
40603,127,162,2010,122,88,34
40604,127,9,2010,22,5,17
40605,127,36,2010,86,54,32
40606,127,128,2010,58,21,37
40607,127,115,2010,228,95,133
40608,127,65,2010,22,17,5
40609,127,130,2010,25,14,11
40610,127,50,2010,259,127,132
40611,165,153,2010,6,4,2
40612,165,136,2010,1,0,1
40613,165,172,2010,207,19,188
40614,165,137,2010,0,0,0
40615,165,151,2010,18,8,10
40616,165,138,2010,3,1,2
40617,165,119,2010,0,0,0
40618,165,155,2010,1316,486,830
40619,165,69,2010,40,12,28
40620,165,156,2010,1107,395,712
40621,165,157,2010,47462,21074,26388
40622,165,5,2010,539,110,429
40623,165,16,2010,1,0,1
40624,165,177,2010,1,0,1
40625,165,121,2010,0,0,0
40626,165,176,2010,3,1,2
40627,165,20,2010,679,261,418
40628,165,159,2010,22552,11393,11159
40629,165,160,2010,472,140,332
40630,165,161,2010,109,40,69
40631,165,162,2010,2112,685,1427
40632,165,9,2010,107,36,71
40633,165,158,2010,47,20,27
40634,165,36,2010,61,27,34
40635,165,126,2010,1,0,1
40636,165,164,2010,463,146,317
40637,165,1,2010,1,0,1
40638,165,115,2010,97,33,64
40639,165,145,2010,11,5,6
40640,165,166,2010,29,9,20
40641,165,50,2010,229,92,137
40642,165,152,2010,11,4,7
40643,165,132,2010,0,0,0
40644,37,2,2010,139,20,119
40645,37,51,2010,76,11,65
40646,37,141,2010,84,14,70
40647,37,52,2010,0,0,0
40648,37,134,2010,20,2,18
40649,37,103,2010,68,38,30
40650,37,11,2010,118,58,60
40651,37,77,2010,0,0,0
40652,37,66,2010,2604,1134,1470
40653,37,12,2010,29,19,10
40654,37,13,2010,0,0,0
40655,37,3,2010,0,0,0
40656,37,79,2010,0,0,0
40657,37,29,2010,177,130,47
40658,37,67,2010,666,262,404
40659,37,95,2010,0,0,0
40660,37,151,2010,0,0,0
40661,37,53,2010,324,102,222
40662,37,147,2010,0,0,0
40663,37,105,2010,84,53,31
40664,37,30,2010,1808,636,1172
40665,37,152,2010,0,0,0
40666,37,116,2010,0,0,0
40667,37,135,2010,0,0,0
40668,37,80,2010,0,0,0
40669,37,136,2010,116,72,44
40670,37,106,2010,22,9,13
40671,37,172,2010,856,435,421
40672,37,107,2010,44,11,33
40673,37,137,2010,18,7,11
40674,37,96,2010,0,0,0
40675,37,54,2010,664,243,421
40676,37,81,2010,113,32,81
40677,37,14,2010,87,38,49
40678,37,31,2010,73744,43565,30179
40679,37,176,2010,0,0,0
40680,37,137,2010,0,0,0
40681,37,39,2010,199,73,126
40682,37,82,2010,0,0,0
40683,37,83,2010,0,0,0
40684,37,108,2010,28,11,17
40685,37,142,2010,149,6,143
40686,37,97,2010,0,0,0
40687,37,40,2010,42,31,11
40688,37,148,2010,0,0,0
40689,37,120,2010,25,7,18
40690,37,41,2010,0,0,0
40691,37,42,2010,124,59,65
40692,37,68,2010,2454,1256,1198
40693,37,155,2010,0,0,0
40694,37,15,2010,65,26,39
40695,37,69,2010,3856,1377,2479
40696,37,156,2010,16,3,13
40697,37,56,2010,330,122,208
40698,37,84,2010,0,0,0
40699,37,98,2010,0,0,0
40700,37,157,2010,0,0,0
40701,37,158,2010,0,0,0
40702,37,85,2010,0,0,0
40703,37,99,2010,0,0,0
40704,37,32,2010,14561,8193,6368
40705,37,43,2010,38,21,17
40706,37,5,2010,122,35,87
40707,37,6,2010,104,25,79
40708,37,16,2010,62,10,52
40709,37,44,2010,667,327,340
40710,37,45,2010,0,0,0
40711,37,17,2010,149,49,100
40712,37,57,2010,2217,601,1616
40713,37,86,2010,0,0,0
40714,37,177,2010,111,68,43
40715,37,18,2010,46,8,38
40716,37,167,2010,199,111,88
40717,37,121,2010,20,11,9
40718,37,19,2010,59,18,41
40719,37,168,2010,19,10,9
40720,37,46,2010,111,69,42
40721,37,20,2010,86,12,74
40722,37,149,2010,0,0,0
40723,37,159,2010,0,0,0
40724,37,143,2010,45,10,35
40725,37,70,2010,0,0,0
40726,37,47,2010,110,72,38
40727,37,71,2010,40,21,19
40728,37,122,2010,0,0,0
40729,37,123,2010,0,0,0
40730,37,7,2010,0,0,0
40731,37,58,2010,18,6,12
40732,37,124,2010,0,0,0
40733,37,100,2010,67,22,45
40734,37,72,2010,0,0,0
40735,37,59,2010,31,11,20
40736,37,144,2010,42,6,36
40737,37,125,2010,0,0,0
40738,37,150,2010,0,0,0
40739,37,8,2010,0,0,0
40740,37,73,2010,453,141,312
40741,37,101,2010,0,0,0
40742,37,162,2010,87,5,82
40743,37,60,2010,595,201,394
40744,37,48,2010,563,327,236
40745,37,21,2010,0,0,0
40746,37,9,2010,69,3,66
40747,37,102,2010,0,0,0
40748,37,111,2010,0,0,0
40749,37,112,2010,45,15,30
40750,37,33,2010,5564,3285,2279
40751,37,61,2010,131,44,87
40752,37,22,2010,0,0,0
40753,37,35,2010,6731,2773,3958
40754,37,36,2010,2287,1604,683
40755,37,126,2010,0,0,0
40756,37,90,2010,0,0,0
40757,37,91,2010,0,0,0
40758,37,62,2010,0,0,0
40759,37,140,2010,0,0,0
40760,37,23,2010,28,1,27
40761,37,164,2010,0,0,0
40762,37,63,2010,1547,613,934
40763,37,127,2010,0,0,0
40764,37,165,2010,0,0,0
40765,37,64,2010,255,84,171
40766,37,128,2010,0,0,0
40767,37,115,2010,88,29,59
40768,37,65,2010,676,322,354
40769,37,10,2010,0,0,0
40770,37,145,2010,0,0,0
40771,37,49,2010,211,92,119
40772,37,74,2010,512,226,286
40773,37,25,2010,187,37,150
40774,37,169,2010,0,0,0
40775,37,166,2010,0,0,0
40776,37,93,2010,0,0,0
40777,37,146,2010,118,9,109
40778,37,26,2010,253,44,209
40779,37,170,2010,0,0,0
40780,37,130,2010,0,0,0
40781,37,38,2010,8258,5476,2782
40782,37,27,2010,55,21,34
40783,37,50,2010,4037,1878,2159
40784,37,131,2010,0,0,0
40785,37,114,2010,0,0,0
40786,37,171,2010,37,22,15
40787,37,1,2010,1737,743,994
40788,37,28,2010,28,4,24
40789,37,132,2010,0,0,0
40790,37,133,2010,0,0,0
40791,64,2,2010,5,0,5
40792,64,51,2010,96,48,48
40793,64,141,2010,35,9,26
40794,64,134,2010,3,1,2
40795,64,103,2010,414,198,216
40796,64,11,2010,7,4,3
40797,64,77,2010,0,0,0
40798,64,66,2010,5475,2895,2580
40799,64,12,2010,4,1,3
40800,64,78,2010,1,0,1
40801,64,3,2010,3,1,2
40802,64,79,2010,1,1,0
40803,64,29,2010,104,75,29
40804,64,67,2010,367,195,172
40805,64,95,2010,1,0,1
40806,64,151,2010,0,0,0
40807,64,53,2010,102915,38761,64154
40808,64,147,2010,1,0,1
40809,64,105,2010,79,58,21
40810,64,30,2010,475,188,287
40811,64,152,2010,4,0,4
40812,64,116,2010,3,0,3
40813,64,153,2010,1,0,1
40814,64,135,2010,7,0,7
40815,64,136,2010,0,0,0
40816,64,106,2010,28,12,16
40817,64,172,2010,732,312,420
40818,64,107,2010,30,20,10
40819,64,117,2010,1,0,1
40820,64,137,2010,7,2,5
40821,64,96,2010,1,1,0
40822,64,54,2010,55964,28543,27421
40823,64,81,2010,41,23,18
40824,64,14,2010,7,4,3
40825,64,31,2010,333,226,107
40826,64,176,2010,2,0,2
40827,64,137,2010,2,0,2
40828,64,39,2010,47,23,24
40829,64,82,2010,1,1,0
40830,64,83,2010,151,141,10
40831,64,108,2010,13,6,7
40832,64,142,2010,91,31,60
40833,64,97,2010,1,1,0
40834,64,119,2010,3,0,3
40835,64,40,2010,18,7,11
40836,64,120,2010,13,8,5
40837,64,42,2010,29,20,9
40838,64,68,2010,1636,901,735
40839,64,139,2010,2,0,2
40840,64,155,2010,4,1,3
40841,64,15,2010,15,9,6
40842,64,69,2010,12284,6185,6099
40843,64,156,2010,19,8,11
40844,64,56,2010,79,42,37
40845,64,98,2010,1,1,0
40846,64,157,2010,8,3,5
40847,64,158,2010,2,0,2
40848,64,110,2010,3,2,1
40849,64,85,2010,1,1,0
40850,64,99,2010,0,0,0
40851,64,32,2010,450,266,184
40852,64,43,2010,9,6,3
40853,64,5,2010,83,26,57
40854,64,6,2010,54,19,35
40855,64,16,2010,56,15,41
40856,64,44,2010,27,14,13
40857,64,17,2010,39,14,25
40858,64,57,2010,4322,2179,2143
40859,64,86,2010,7,1,6
40860,64,177,2010,72,36,36
40861,64,18,2010,71,13,58
40862,64,167,2010,45,35,10
40863,64,121,2010,16,10,6
40864,64,19,2010,9,1,8
40865,64,168,2010,5,4,1
40866,64,46,2010,22,17,5
40867,64,20,2010,24,4,20
40868,64,159,2010,3,1,2
40869,64,143,2010,46,22,24
40870,64,70,2010,14,7,7
40871,64,47,2010,33,18,15
40872,64,71,2010,50,25,25
40873,64,122,2010,8,6,2
40874,64,123,2010,0,0,0
40875,64,7,2010,0,0,0
40876,64,160,2010,3,2,1
40877,64,58,2010,12,4,8
40878,64,161,2010,0,0,0
40879,64,124,2010,4,2,2
40880,64,100,2010,38,19,19
40881,64,59,2010,2763,1262,1501
40882,64,87,2010,0,0,0
40883,64,144,2010,18,4,14
40884,64,125,2010,2,1,1
40885,64,150,2010,0,0,0
40886,64,8,2010,12,3,9
40887,64,73,2010,385,178,207
40888,64,101,2010,3,3,0
40889,64,162,2010,27,9,18
40890,64,60,2010,14333,5061,9272
40891,64,48,2010,25,13,12
40892,64,21,2010,2,1,1
40893,64,9,2010,18,6,12
40894,64,102,2010,3,2,1
40895,64,111,2010,4,0,4
40896,64,112,2010,36,15,21
40897,64,33,2010,380,249,131
40898,64,61,2010,36,20,16
40899,64,22,2010,1,0,1
40900,64,35,2010,283,193,90
40901,64,36,2010,928,639,289
40902,64,126,2010,0,0,0
40903,64,62,2010,0,0,0
40904,64,140,2010,0,0,0
40905,64,23,2010,8,1,7
40906,64,164,2010,3,2,1
40907,64,63,2010,32867,11668,21199
40908,64,165,2010,7,0,7
40909,64,37,2010,432,253,179
40910,64,128,2010,1,0,1
40911,64,115,2010,35,17,18
40912,64,65,2010,106,48,58
40913,64,10,2010,10,4,6
40914,64,145,2010,13,3,10
40915,64,113,2010,1,1,0
40916,64,49,2010,389,195,194
40917,64,74,2010,1386,680,706
40918,64,25,2010,35,9,26
40919,64,169,2010,3,3,0
40920,64,166,2010,0,0,0
40921,64,93,2010,3,1,2
40922,64,146,2010,37,7,30
40923,64,26,2010,91,27,64
40924,64,170,2010,4,4,0
40925,64,130,2010,2,0,2
40926,64,38,2010,1382,1007,375
40927,64,27,2010,15,10,5
40928,64,50,2010,524,226,298
40929,64,131,2010,1,1,0
40930,64,114,2010,18,11,7
40931,64,171,2010,31,23,8
40932,64,1,2010,6,6,0
40933,64,28,2010,7,0,7
40934,64,132,2010,6,1,5
40935,64,133,2010,15,8,7
40936,128,120,2010,26183,12827,13356
40937,128,119,2010,37,18,19
40938,128,28,2010,0,0,0
40939,115,2,2010,75,33,42
40940,115,51,2010,131,78,53
40941,115,141,2010,359,95,264
40942,115,134,2010,32017,16005,16012
40943,115,103,2010,1907,1048,859
40944,115,66,2010,4338,1961,2377
40945,115,13,2010,132,59,73
40946,115,3,2010,12182,3690,8492
40947,115,79,2010,23,10,13
40948,115,29,2010,192,104,88
40949,115,67,2010,6396,3160,3236
40950,115,151,2010,155,60,95
40951,115,53,2010,163,101,62
40952,115,147,2010,33695,13104,20591
40953,115,105,2010,2361,1318,1043
40954,115,30,2010,3164,1584,1580
40955,115,116,2010,5272,2992,2280
40956,115,135,2010,1987,628,1359
40957,115,106,2010,537,272,265
40958,115,172,2010,10396,4955,5441
40959,115,107,2010,477,320,157
40960,115,117,2010,157,22,135
40961,115,137,2010,15832,6851,8981
40962,115,54,2010,805,400,405
40963,115,81,2010,1233,544,689
40964,115,14,2010,3953,2034,1919
40965,115,31,2010,1604,775,829
40966,115,176,2010,110,90,20
40967,115,137,2010,35647,17923,17724
40968,115,39,2010,2033,1012,1021
40969,115,142,2010,3716,1801,1915
40970,115,119,2010,460,204,256
40971,115,40,2010,116,22,94
40972,115,120,2010,19692,7789,11903
40973,115,42,2010,521,392,129
40974,115,68,2010,6093,3151,2942
40975,115,139,2010,250,113,137
40976,115,69,2010,22621,11580,11041
40977,115,156,2010,5365,1848,3517
40978,115,55,2010,43,10,33
40979,115,56,2010,7265,3450,3815
40980,115,98,2010,72,22,50
40981,115,157,2010,62,22,40
40982,115,158,2010,23,15,8
40983,115,110,2010,45,25,20
40984,115,173,2010,1298,675,623
40985,115,43,2010,24,4,20
40986,115,5,2010,34871,16692,18179
40987,115,6,2010,566,288,278
40988,115,16,2010,132,34,98
40989,115,44,2010,9738,5675,4063
40990,115,17,2010,3595,1783,1812
40991,115,57,2010,18764,9083,9681
40992,115,86,2010,155,98,57
40993,115,177,2010,1407,795,612
40994,115,18,2010,45,18,27
40995,115,121,2010,13282,7638,5644
40996,115,19,2010,72,21,51
40997,115,168,2010,29,18,11
40998,115,46,2010,337,114,223
40999,115,20,2010,745,361,384
41000,115,149,2010,234089,107984,126105
41001,115,159,2010,604,394,210
41002,115,143,2010,131,25,106
41003,115,47,2010,323,191,132
41004,115,71,2010,20,15,5
41005,115,122,2010,345,207,138
41006,115,123,2010,59208,16174,43034
41007,115,7,2010,45,15,30
41008,115,160,2010,85,42,43
41009,115,58,2010,273,193,80
41010,115,124,2010,6841,3488,3353
41011,115,100,2010,230,128,102
41012,115,72,2010,20,3,17
41013,115,144,2010,873,324,549
41014,115,125,2010,505820,147489,358331
41015,115,150,2010,91250,46565,44685
41016,115,8,2010,101,40,61
41017,115,73,2010,9822,4724,5098
41018,115,101,2010,87,57,30
41019,115,162,2010,25091,8324,16767
41020,115,48,2010,895,559,336
41021,115,21,2010,24,10,14
41022,115,9,2010,12444,3728,8716
41023,115,102,2010,46,22,24
41024,115,111,2010,94,49,45
41025,115,112,2010,163,77,86
41026,115,33,2010,7929,4094,3835
41027,115,61,2010,17495,8417,9078
41028,115,35,2010,1301,718,583
41029,115,36,2010,2732,1481,1251
41030,115,126,2010,3800,2345,1455
41031,115,90,2010,20,7,13
41032,115,23,2010,497,238,259
41033,115,164,2010,2221,204,2017
41034,115,63,2010,3119,1609,1510
41035,115,127,2010,535,336,199
41036,115,165,2010,398,142,256
41037,115,37,2010,339,95,244
41038,115,128,2010,29189,13921,15268
41039,115,65,2010,1171,592,579
41040,115,10,2010,793,396,397
41041,115,145,2010,2439,1171,1268
41042,115,148,2010,65384,29399,35985
41043,115,49,2010,193,89,104
41044,115,74,2010,1580,890,690
41045,115,25,2010,93,49,44
41046,115,60,2010,96,22,74
41047,115,93,2010,20,10,10
41048,115,146,2010,91,43,48
41049,115,26,2010,908,334,574
41050,115,130,2010,3902,1658,2244
41051,115,38,2010,3064,1752,1312
41052,115,27,2010,144,75,69
41053,115,50,2010,116052,60229,55823
41054,115,131,2010,7709,2818,4891
41055,115,114,2010,91,25,66
41056,115,1,2010,129,78,51
41057,115,28,2010,65,33,32
41058,115,132,2010,25171,13170,12001
41059,115,133,2010,306521,139352,167169
41060,129,136,2010,5327,2367,2960
41061,129,137,2010,60795,30481,30314
41062,129,142,2010,5243,2279,2964
41063,129,119,2010,3372,1573,1799
41064,129,120,2010,8509,4099,4410
41065,129,5,2010,1364,617,747
41066,129,121,2010,9298,3984,5314
41067,129,143,2010,162,79,83
41068,129,160,2010,178,86,92
41069,129,162,2010,3467,1567,1900
41070,129,145,2010,0,0,0
41071,129,130,2010,125406,60976,64430
41072,65,2,2010,439,95,344
41073,65,51,2010,1807,763,1044
41074,65,141,2010,60246,18627,41619
41075,65,52,2010,5578,2845,2733
41076,65,134,2010,4005,1723,2282
41077,65,103,2010,282553,136724,145829
41078,65,11,2010,10246,4786,5460
41079,65,66,2010,8714,4644,4070
41080,65,12,2010,499,261,238
41081,65,78,2010,53,26,27
41082,65,13,2010,43,15,28
41083,65,3,2010,10533,1966,8567
41084,65,79,2010,36,21,15
41085,65,29,2010,3530,2308,1222
41086,65,67,2010,41797,20817,20980
41087,65,95,2010,25,14,11
41088,65,151,2010,420,111,309
41089,65,53,2010,2162,1062,1100
41090,65,105,2010,132649,81338,51311
41091,65,30,2010,145061,67188,77873
41092,65,152,2010,1111,277,834
41093,65,116,2010,101,50,51
41094,65,153,2010,4499,2576,1923
41095,65,135,2010,5860,2144,3716
41096,65,136,2010,95,30,65
41097,65,106,2010,64296,32576,31720
41098,65,172,2010,154918,77941,76977
41099,65,107,2010,376161,212366,163795
41100,65,137,2010,2333,864,1469
41101,65,96,2010,3149,1683,1466
41102,65,54,2010,1691,856,835
41103,65,81,2010,103189,56536,46653
41104,65,14,2010,309,143,166
41105,65,31,2010,8540,4907,3633
41106,65,176,2010,103,57,46
41107,65,137,2010,1614,605,1009
41108,65,39,2010,11171,5556,5615
41109,65,118,2010,23,11,12
41110,65,82,2010,935,616,319
41111,65,83,2010,136976,83833,53143
41112,65,108,2010,496666,255819,240847
41113,65,142,2010,4053,1128,2925
41114,65,97,2010,7951,4883,3068
41115,65,138,2010,21552,13318,8234
41116,65,119,2010,140,51,89
41117,65,40,2010,1254,785,469
41118,65,120,2010,2695,1230,1465
41119,65,42,2010,10378,5772,4606
41120,65,68,2010,210047,107955,102092
41121,65,139,2010,271,136,135
41122,65,155,2010,18687,3265,15422
41123,65,15,2010,9792,4302,5490
41124,65,69,2010,212883,107406,105477
41125,65,156,2010,14894,2374,12520
41126,65,56,2010,3625,1367,2258
41127,65,84,2010,513,251,262
41128,65,98,2010,6440,3791,2649
41129,65,157,2010,12192,3653,8539
41130,65,158,2010,6554,1267,5287
41131,65,110,2010,108,50,58
41132,65,85,2010,610,268,342
41133,65,99,2010,26902,18492,8410
41134,65,32,2010,7773,4045,3728
41135,65,43,2010,1043,526,517
41136,65,5,2010,35224,10947,24277
41137,65,6,2010,4920,1893,3027
41138,65,16,2010,1694,614,1080
41139,65,44,2010,13455,6518,6937
41140,65,17,2010,2659,986,1673
41141,65,57,2010,87330,33125,54205
41142,65,86,2010,262,140,122
41143,65,177,2010,5638,3392,2246
41144,65,18,2010,2099,524,1575
41145,65,167,2010,1184,688,496
41146,65,121,2010,1327,890,437
41147,65,19,2010,405,147,258
41148,65,168,2010,255,168,87
41149,65,46,2010,3129,1801,1328
41150,65,20,2010,3125,992,2133
41151,65,159,2010,914,274,640
41152,65,143,2010,749,265,484
41153,65,70,2010,116,57,59
41154,65,47,2010,18531,9024,9507
41155,65,71,2010,1398,712,686
41156,65,122,2010,383,257,126
41157,65,123,2010,43,24,19
41158,65,160,2010,23680,1646,22034
41159,65,58,2010,263,125,138
41160,65,161,2010,11138,2048,9090
41161,65,124,2010,237,107,130
41162,65,100,2010,44801,25375,19426
41163,65,72,2010,234,122,112
41164,65,59,2010,138,68,70
41165,65,144,2010,763734,297655,466079
41166,65,125,2010,1239,626,613
41167,65,150,2010,112,60,52
41168,65,8,2010,2594,799,1795
41169,65,73,2010,46634,22512,24122
41170,65,101,2010,12892,9061,3831
41171,65,162,2010,36852,14027,22825
41172,65,60,2010,549,263,286
41173,65,48,2010,14587,7304,7283
41174,65,21,2010,20,6,14
41175,65,9,2010,56836,8823,48013
41176,65,102,2010,4381,2472,1909
41177,65,111,2010,80087,53476,26611
41178,65,112,2010,197827,104277,93550
41179,65,33,2010,74329,36008,38321
41180,65,61,2010,134592,53444,81148
41181,65,22,2010,52,21,31
41182,65,35,2010,727521,343340,384181
41183,65,36,2010,58461,38176,20285
41184,65,126,2010,254,109,145
41185,65,91,2010,60,27,33
41186,65,62,2010,24,11,13
41187,65,140,2010,203,104,99
41188,65,23,2010,527,195,332
41189,65,164,2010,56349,8924,47425
41190,65,63,2010,3726,1826,1900
41191,65,127,2010,43,25,18
41192,65,165,2010,1204,380,824
41193,65,37,2010,7312,3874,3438
41194,65,64,2010,1011,503,508
41195,65,128,2010,307,115,192
41196,65,115,2010,2437,1145,1292
41197,65,10,2010,565,214,351
41198,65,145,2010,396,111,285
41199,65,113,2010,196,121,75
41200,65,49,2010,18133,10032,8101
41201,65,74,2010,63693,31939,31754
41202,65,25,2010,4880,1397,3483
41203,65,169,2010,55,32,23
41204,65,166,2010,486,131,355
41205,65,93,2010,182,112,70
41206,65,146,2010,2644,834,1810
41207,65,26,2010,3276,1124,2152
41208,65,170,2010,27,20,7
41209,65,130,2010,195,91,104
41210,65,38,2010,79843,43084,36759
41211,65,27,2010,225,98,127
41212,65,50,2010,319145,158826,160319
41213,65,131,2010,293,132,161
41214,65,114,2010,84809,41355,43454
41215,65,171,2010,507,288,219
41216,65,1,2010,1112,565,547
41217,65,28,2010,96,22,74
41218,65,132,2010,149,80,69
41219,65,133,2010,303,156,147
41220,10,2,2010,129,61,68
41221,10,13,2010,393,187,206
41222,10,3,2010,658,170,488
41223,10,4,2010,229,99,130
41224,10,172,2010,2312,277,2035
41225,10,14,2010,247,118,129
41226,10,42,2010,61,40,21
41227,10,68,2010,294,137,157
41228,10,69,2010,547,245,302
41229,10,56,2010,89,39,50
41230,10,85,2010,38,21,17
41231,10,5,2010,10529,5026,5503
41232,10,6,2010,103,38,65
41233,10,16,2010,40,18,22
41234,10,17,2010,55,18,37
41235,10,57,2010,5236,2566,2670
41236,10,177,2010,828,434,394
41237,10,18,2010,271,144,127
41238,10,19,2010,1711,887,824
41239,10,20,2010,723,375,348
41240,10,143,2010,40,15,25
41241,10,7,2010,1474,820,654
41242,10,21,2010,325,171,154
41243,10,8,2010,337,111,226
41244,10,48,2010,116,57,59
41245,10,9,2010,809,360,449
41246,10,61,2010,13,8,5
41247,10,22,2010,270,120,150
41248,10,36,2010,147,91,56
41249,10,23,2010,1280,639,641
41250,10,127,2010,26,12,14
41251,10,115,2010,257,151,106
41252,10,65,2010,36,20,16
41253,10,49,2010,127,49,78
41254,10,74,2010,284,133,151
41255,10,25,2010,73,37,36
41256,10,27,2010,1645,812,833
41257,10,26,2010,45,21,24
41258,10,142,2010,128,42,86
41259,10,50,2010,1163,573,590
41260,145,136,2010,80202,37740,42462
41261,145,172,2010,1215,588,627
41262,145,137,2010,24549,12119,12430
41263,145,120,2010,73623,34930,38693
41264,145,119,2010,142187,69881,72306
41265,145,5,2010,1396,675,721
41266,145,121,2010,2814,1361,1453
41267,145,143,2010,1701,823,878
41268,145,160,2010,734,355,379
41269,145,162,2010,16214,7850,8364
41270,145,128,2010,86,45,41
41271,145,129,2010,212948,108164,104784
41272,145,130,2010,2079,1032,1047
41273,145,142,2010,14675,7099,7576
41274,113,105,2010,4626,2103,2523
41275,113,172,2010,4526,2058,2468
41276,113,110,2010,11264,5121,6143
41277,113,73,2010,2890,1314,1576
41278,49,2,2010,12697,5468,7229
41279,49,51,2010,1134,492,642
41280,49,141,2010,2462,844,1618
41281,49,52,2010,1,1,0
41282,49,134,2010,706,378,328
41283,49,76,2010,9,3,6
41284,49,103,2010,2823,1373,1450
41285,49,11,2010,1503,768,735
41286,49,66,2010,5869,2630,3239
41287,49,12,2010,1898,1024,874
41288,49,78,2010,27,6,21
41289,49,13,2010,69,26,43
41290,49,3,2010,5480,2176,3304
41291,49,79,2010,116,36,80
41292,49,29,2010,1866,1173,693
41293,49,67,2010,1843,861,982
41294,49,95,2010,12,2,10
41295,49,151,2010,66,20,46
41296,49,4,2010,30,9,21
41297,49,53,2010,55914,28339,27575
41298,49,147,2010,81,47,34
41299,49,105,2010,5741,3680,2061
41300,49,30,2010,6208,3012,3196
41301,49,152,2010,65,32,33
41302,49,116,2010,2492,1310,1182
41303,49,153,2010,345,185,160
41304,49,135,2010,1311,398,913
41305,49,136,2010,52,14,38
41306,49,106,2010,28213,14023,14190
41307,49,172,2010,21706,13412,8294
41308,49,173,2010,0,0,0
41309,49,107,2010,10181,4946,5235
41310,49,117,2010,7,2,5
41311,49,137,2010,591,301,290
41312,49,96,2010,344,171,173
41313,49,54,2010,6214,3135,3079
41314,49,81,2010,2257,1032,1225
41315,49,14,2010,525,216,309
41316,49,31,2010,1195,619,576
41317,49,176,2010,87,37,50
41318,49,137,2010,2077,999,1078
41319,49,39,2010,45828,21199,24629
41320,49,118,2010,93,54,39
41321,49,82,2010,46,21,25
41322,49,83,2010,539,270,269
41323,49,108,2010,1889,927,962
41324,49,142,2010,3367,1184,2183
41325,49,97,2010,2627,1304,1323
41326,49,138,2010,33,20,13
41327,49,119,2010,8929,4607,4322
41328,49,40,2010,9905,5910,3995
41329,49,148,2010,20,10,10
41330,49,120,2010,13003,6245,6758
41331,49,42,2010,171565,102018,69547
41332,49,68,2010,7769,3194,4575
41333,49,139,2010,10,5,5
41334,49,155,2010,3596,1498,2098
41335,49,15,2010,724,376,348
41336,49,69,2010,47622,25355,22267
41337,49,156,2010,1748,735,1013
41338,49,55,2010,6,2,4
41339,49,56,2010,11175,4542,6633
41340,49,84,2010,45,13,32
41341,49,98,2010,743,356,387
41342,49,157,2010,308,106,202
41343,49,158,2010,111,40,71
41344,49,110,2010,125,79,46
41345,49,85,2010,132,62,70
41346,49,99,2010,321,161,160
41347,49,32,2010,15062,7548,7514
41348,49,43,2010,4463,2194,2269
41349,49,5,2010,16395,8402,7993
41350,49,6,2010,59695,28256,31439
41351,49,16,2010,117472,53528,63944
41352,49,44,2010,1863,618,1245
41353,49,17,2010,2351,938,1413
41354,49,57,2010,7503,2551,4952
41355,49,86,2010,273,109,164
41356,49,177,2010,2884,1967,917
41357,49,18,2010,2633,1073,1560
41358,49,167,2010,1077,666,411
41359,49,121,2010,2121,1234,887
41360,49,19,2010,1391,585,806
41361,49,168,2010,506,294,212
41362,49,46,2010,4101,2520,1581
41363,49,20,2010,23612,10582,13030
41364,49,149,2010,22,16,6
41365,49,159,2010,841,435,406
41366,49,143,2010,1230,329,901
41367,49,70,2010,2,2,0
41368,49,47,2010,5551,2936,2615
41369,49,71,2010,223,107,116
41370,49,122,2010,88,56,32
41371,49,123,2010,77,44,33
41372,49,7,2010,11,6,5
41373,49,160,2010,95,42,53
41374,49,58,2010,126,56,70
41375,49,161,2010,42,5,37
41376,49,124,2010,167,99,68
41377,49,100,2010,1921,1022,899
41378,49,72,2010,24,6,18
41379,49,59,2010,335,146,189
41380,49,144,2010,7012,3285,3727
41381,49,125,2010,312,178,134
41382,49,150,2010,82,37,45
41383,49,8,2010,503,167,336
41384,49,73,2010,8293,3550,4743
41385,49,101,2010,609,340,269
41386,49,162,2010,2629,752,1877
41387,49,60,2010,4474,2172,2302
41388,49,48,2010,43653,24534,19119
41389,49,21,2010,33,19,14
41390,49,9,2010,9127,2648,6479
41391,49,102,2010,256,144,112
41392,49,111,2010,176,103,73
41393,49,112,2010,6517,3532,2985
41394,49,33,2010,67262,38850,28412
41395,49,61,2010,2866,1314,1552
41396,49,22,2010,77,36,41
41397,49,35,2010,18462,9722,8740
41398,49,36,2010,14389,9670,4719
41399,49,126,2010,356,183,173
41400,49,90,2010,1,0,1
41401,49,91,2010,29,10,19
41402,49,92,2010,15,2,13
41403,49,62,2010,5,2,3
41404,49,140,2010,10,3,7
41405,49,23,2010,1536,739,797
41406,49,164,2010,488,201,287
41407,49,63,2010,12866,6096,6770
41408,49,127,2010,59,42,17
41409,49,165,2010,663,319,344
41410,49,37,2010,1054,598,456
41411,49,64,2010,959,456,503
41412,49,128,2010,31594,15851,15743
41413,49,115,2010,1919,823,1096
41414,49,129,2010,0,0,0
41415,49,65,2010,6515,2776,3739
41416,49,10,2010,6627,3725,2902
41417,49,145,2010,1473,639,834
41418,49,113,2010,32,19,13
41419,49,74,2010,2973,1366,1607
41420,49,25,2010,19572,9725,9847
41421,49,169,2010,209,121,88
41422,49,166,2010,301,121,180
41423,49,93,2010,270,147,123
41424,49,146,2010,3860,1318,2542
41425,49,26,2010,40582,18600,21982
41426,49,170,2010,210,130,80
41427,49,130,2010,2843,1466,1377
41428,49,38,2010,4219,2951,1268
41429,49,27,2010,688,326,362
41430,49,50,2010,20291,6823,13468
41431,49,131,2010,1335,691,644
41432,49,114,2010,2270,1124,1146
41433,49,171,2010,2066,1052,1014
41434,49,1,2010,13942,7476,6466
41435,49,28,2010,489,206,283
41436,49,132,2010,394,232,162
41437,49,133,2010,419,203,216
41438,74,2,2010,3617,1429,2188
41439,74,51,2010,1721,967,754
41440,74,141,2010,8774,3598,5176
41441,74,52,2010,43,17,26
41442,74,134,2010,6215,3092,3123
41443,74,76,2010,106,50,56
41444,74,103,2010,7931,4158,3773
41445,74,11,2010,607,350,257
41446,74,66,2010,58733,36492,22241
41447,74,12,2010,440,249,191
41448,74,78,2010,111,55,56
41449,74,13,2010,296,150,146
41450,74,3,2010,1829,551,1278
41451,74,79,2010,69,30,39
41452,74,29,2010,1005,746,259
41453,74,67,2010,14184,7518,6666
41454,74,95,2010,63,33,30
41455,74,151,2010,503,192,311
41456,74,4,2010,75,36,39
41457,74,53,2010,51023,26488,24535
41458,74,147,2010,59,30,29
41459,74,105,2010,32264,22908,9356
41460,74,30,2010,4894,3344,1550
41461,74,152,2010,570,256,314
41462,74,116,2010,540,315,225
41463,74,153,2010,1975,1001,974
41464,74,135,2010,6439,4141,2298
41465,74,136,2010,286,149,137
41466,74,106,2010,6913,3665,3248
41467,74,172,2010,15226,9343,5883
41468,74,107,2010,10448,6493,3955
41469,74,117,2010,28,12,16
41470,74,137,2010,1261,612,649
41471,74,96,2010,794,475,319
41472,74,54,2010,19655,10901,8754
41473,74,81,2010,2828,1624,1204
41474,74,14,2010,351,150,201
41475,74,31,2010,12484,7387,5097
41476,74,176,2010,478,321,157
41477,74,137,2010,5799,2920,2879
41478,74,39,2010,5306,3076,2230
41479,74,118,2010,90,49,41
41480,74,82,2010,261,181,80
41481,74,83,2010,9532,6877,2655
41482,74,108,2010,4240,2607,1633
41483,74,142,2010,5766,2146,3620
41484,74,97,2010,648,386,262
41485,74,138,2010,32,17,15
41486,74,119,2010,8093,3115,4978
41487,74,40,2010,458,334,124
41488,74,148,2010,99,65,34
41489,74,120,2010,4352,2389,1963
41490,74,42,2010,4905,3535,1370
41491,74,68,2010,132145,70376,61769
41492,74,139,2010,238,152,86
41493,74,155,2010,625,77,548
41494,74,15,2010,593,345,248
41495,74,69,2010,318512,162674,155838
41496,74,156,2010,2520,1290,1230
41497,74,56,2010,7614,3540,4074
41498,74,84,2010,44,26,18
41499,74,98,2010,906,528,378
41500,74,157,2010,1028,306,722
41501,74,158,2010,272,87,185
41502,74,110,2010,132,89,43
41503,74,85,2010,1654,1096,558
41504,74,99,2010,505,340,165
41505,74,32,2010,14691,8077,6614
41506,74,43,2010,285,148,137
41507,74,5,2010,16687,8032,8655
41508,74,6,2010,8021,3676,4345
41509,74,16,2010,6509,2295,4214
41510,74,44,2010,3091,1591,1500
41511,74,17,2010,3349,1524,1825
41512,74,57,2010,232824,104428,128396
41513,74,86,2010,732,410,322
41514,74,177,2010,6590,4576,2014
41515,74,18,2010,603,247,356
41516,74,167,2010,1806,1089,717
41517,74,121,2010,3049,1787,1262
41518,74,19,2010,397,178,219
41519,74,168,2010,397,266,131
41520,74,46,2010,1329,1005,324
41521,74,20,2010,5573,1990,3583
41522,74,149,2010,72,42,30
41523,74,159,2010,401,181,220
41524,74,143,2010,970,410,560
41525,74,70,2010,2265,1398,867
41526,74,47,2010,944,685,259
41527,74,71,2010,2138,1160,978
41528,74,122,2010,1588,985,603
41529,74,123,2010,102,48,54
41530,74,7,2010,62,18,44
41531,74,160,2010,375,164,211
41532,74,58,2010,267,150,117
41533,74,161,2010,112,41,71
41534,74,124,2010,2616,1897,719
41535,74,100,2010,5684,3549,2135
41536,74,72,2010,240,123,117
41537,74,59,2010,2626,1333,1293
41538,74,144,2010,15707,8999,6708
41539,74,125,2010,1205,648,557
41540,74,150,2010,251,121,130
41541,74,8,2010,864,365,499
41542,74,73,2010,21430,11323,10107
41543,74,101,2010,554,347,207
41544,74,162,2010,3070,935,2135
41545,74,60,2010,51614,24984,26630
41546,74,48,2010,2145,1199,946
41547,74,21,2010,74,33,41
41548,74,9,2010,3889,1421,2468
41549,74,102,2010,460,273,187
41550,74,111,2010,884,530,354
41551,74,112,2010,8609,5674,2935
41552,74,33,2010,21440,12942,8498
41553,74,61,2010,172067,79154,92913
41554,74,22,2010,64,27,37
41555,74,35,2010,12293,7950,4343
41556,74,36,2010,16170,10750,5420
41557,74,126,2010,965,534,431
41558,74,90,2010,0,0,0
41559,74,91,2010,56,26,30
41560,74,92,2010,0,0,0
41561,74,62,2010,0,0,0
41562,74,140,2010,53,30,23
41563,74,23,2010,839,398,441
41564,74,164,2010,2058,838,1220
41565,74,63,2010,109422,53298,56124
41566,74,127,2010,219,160,59
41567,74,165,2010,315,131,184
41568,74,37,2010,7588,5032,2556
41569,74,64,2010,3380,2032,1348
41570,74,128,2010,4500,1915,2585
41571,74,115,2010,6862,3709,3153
41572,74,129,2010,0,0,0
41573,74,65,2010,53446,27081,26365
41574,74,10,2010,28566,13513,15053
41575,74,145,2010,906,389,517
41576,74,113,2010,101,63,38
41577,74,49,2010,9176,5106,4070
41578,74,25,2010,2817,1145,1672
41579,74,169,2010,161,100,61
41580,74,166,2010,1624,727,897
41581,74,93,2010,306,180,126
41582,74,146,2010,9838,3354,6484
41583,74,26,2010,75826,35491,40335
41584,74,170,2010,66,47,19
41585,74,130,2010,710,409,301
41586,74,38,2010,6121,4684,1437
41587,74,27,2010,347,159,188
41588,74,50,2010,41055,19389,21666
41589,74,131,2010,823,445,378
41590,74,114,2010,1552,841,711
41591,74,171,2010,597,381,216
41592,74,1,2010,10847,6102,4745
41593,74,28,2010,382,175,207
41594,74,132,2010,356,192,164
41595,74,133,2010,975,526,449
41596,25,2,2010,2605,1277,1328
41597,25,16,2010,1110642,544212,566430
41598,25,128,2010,3100,1518,1582
41599,25,145,2010,538,264,274
41600,169,2,2010,12606,6903,5703
41601,169,141,2010,132,72,60
41602,169,12,2010,172,107,65
41603,169,66,2010,65,35,30
41604,169,11,2010,198,121,77
41605,169,29,2010,692,408,284
41606,169,172,2010,49,18,31
41607,169,39,2010,133,52,81
41608,169,15,2010,676,327,349
41609,169,69,2010,136,60,76
41610,169,5,2010,628,234,394
41611,169,6,2010,1218,573,645
41612,169,16,2010,64,29,35
41613,169,167,2010,854,444,410
41614,169,176,2010,158,63,95
41615,169,168,2010,11495,5590,5905
41616,169,21,2010,37,19,18
41617,169,73,2010,51,33,18
41618,169,9,2010,107,52,55
41619,169,33,2010,38,19,19
41620,169,36,2010,238142,136807,101335
41621,169,74,2010,53,24,29
41622,169,26,2010,790,365,425
41623,169,170,2010,454,232,222
41624,169,38,2010,1230,477,753
41625,169,50,2010,320,83,237
41626,169,171,2010,7669,3936,3733
41627,169,132,2010,24,12,12
41628,131,134,2010,1186,478,708
41629,131,147,2010,136,42,94
41630,131,116,2010,111256,54271,56985
41631,131,117,2010,567,225,342
41632,131,137,2010,24354,12347,12007
41633,131,137,2010,62386,31912,30474
41634,131,69,2010,924,392,532
41635,131,5,2010,7629,3263,4366
41636,131,57,2010,550,232,318
41637,131,121,2010,27864,15965,11899
41638,131,149,2010,140,42,98
41639,131,123,2010,7011,3209,3802
41640,131,124,2010,187,70,117
41641,131,125,2010,28177,14052,14125
41642,131,150,2010,613,240,373
41643,131,9,2010,635,258,377
41644,131,126,2010,5246,2969,2277
41645,131,127,2010,355,141,214
41646,131,128,2010,2273,1065,1208
41647,131,115,2010,678,266,412
41648,131,148,2010,86,27,59
41649,131,130,2010,6938,3362,3576
41650,131,50,2010,1040,430,610
41651,131,132,2010,10265,5553,4712
41652,131,133,2010,809,323,486
41653,166,67,2010,56,18,38
41654,166,135,2010,619,223,396
41655,166,153,2010,36,16,20
41656,166,136,2010,633,205,428
41657,166,172,2010,459,85,374
41658,166,137,2010,229,89,140
41659,166,137,2010,589,298,291
41660,166,151,2010,67695,34923,32772
41661,166,138,2010,95,36,59
41662,166,68,2010,945,423,522
41663,166,139,2010,796,353,443
41664,166,155,2010,944,409,535
41665,166,69,2010,172,91,81
41666,166,156,2010,42991,24616,18375
41667,166,157,2010,2964,1341,1623
41668,166,159,2010,150,74,76
41669,166,160,2010,7641,3439,4202
41670,166,161,2010,129,71,58
41671,166,162,2010,29347,12626,16721
41672,166,158,2010,116,65,51
41673,166,126,2010,746,379,367
41674,166,140,2010,37,18,19
41675,166,164,2010,895,391,504
41676,166,165,2010,93,50,43
41677,166,152,2010,12075,5503,6572
41678,93,79,2010,1029,544,485
41679,93,172,2010,836,379,457
41680,93,81,2010,74,31,43
41681,93,69,2010,245,121,124
41682,93,84,2010,7748,4390,3358
41683,93,110,2010,9490,5093,4397
41684,93,5,2010,926,390,536
41685,93,86,2010,1445,697,748
41686,93,162,2010,485,176,309
41687,93,91,2010,850,447,403
41688,93,92,2010,6207,3490,2717
41689,93,50,2010,2286,1075,1211
41690,146,141,2010,8068,3912,4156
41691,146,135,2010,555,269,286
41692,146,68,2010,6669,3236,3433
41693,146,69,2010,1121,544,577
41694,146,16,2010,449,217,232
41695,146,57,2010,1705,827,878
41696,146,143,2010,7062,3426,3636
41697,146,160,2010,771,374,397
41698,146,161,2010,409,198,211
41699,146,144,2010,4480,2174,2306
41700,146,162,2010,420,204,216
41701,146,164,2010,317,154,163
41702,146,25,2010,829,402,427
41703,146,142,2010,880,427,453
41704,26,2,2010,11074,4918,6156
41705,26,51,2010,3292,1697,1595
41706,26,141,2010,643,183,460
41707,26,12,2010,16683,8408,8275
41708,26,103,2010,139,72,67
41709,26,66,2010,14247,7472,6775
41710,26,3,2010,327,28,299
41711,26,11,2010,789,515,274
41712,26,67,2010,8697,4768,3929
41713,26,53,2010,2352,1239,1113
41714,26,105,2010,341,218,123
41715,26,30,2010,477882,261278,216604
41716,26,29,2010,298,237,61
41717,26,10,2010,68,19,49
41718,26,106,2010,44,30,14
41719,26,172,2010,1736,916,820
41720,26,107,2010,47,32,15
41721,26,137,2010,41,14,27
41722,26,96,2010,54,27,27
41723,26,54,2010,221,130,91
41724,26,81,2010,44,22,22
41725,26,14,2010,10327,5786,4541
41726,26,31,2010,1127,586,541
41727,26,39,2010,3344,1805,1539
41728,26,120,2010,79,45,34
41729,26,40,2010,112,73,39
41730,26,42,2010,1660,930,730
41731,26,68,2010,15877,8445,7432
41732,26,15,2010,6470,3886,2584
41733,26,69,2010,271865,145511,126354
41734,26,156,2010,143,17,126
41735,26,56,2010,58854,33376,25478
41736,26,173,2010,57,31,26
41737,26,32,2010,517,314,203
41738,26,43,2010,43,24,19
41739,26,5,2010,517,201,316
41740,26,6,2010,14798,5852,8946
41741,26,16,2010,14135,5918,8217
41742,26,44,2010,534,283,251
41743,26,17,2010,2702,1357,1345
41744,26,57,2010,2825,1290,1535
41745,26,177,2010,1989,1142,847
41746,26,167,2010,4965,2857,2108
41747,26,18,2010,896,337,559
41748,26,121,2010,172,65,107
41749,26,176,2010,29,14,15
41750,26,19,2010,284,104,180
41751,26,168,2010,1741,789,952
41752,26,20,2010,1126,588,538
41753,26,46,2010,64,45,19
41754,26,143,2010,3052,1369,1683
41755,26,47,2010,259,163,96
41756,26,71,2010,45,26,19
41757,26,58,2010,43,29,14
41758,26,100,2010,152,82,70
41759,26,144,2010,472,196,276
41760,26,21,2010,25,15,10
41761,26,73,2010,21689,11439,10250
41762,26,162,2010,294,42,252
41763,26,48,2010,3531,1878,1653
41764,26,9,2010,1131,471,660
41765,26,112,2010,53,33,20
41766,26,33,2010,3393,1862,1531
41767,26,61,2010,223,120,103
41768,26,22,2010,31,12,19
41769,26,35,2010,20609,12787,7822
41770,26,36,2010,19740,12516,7224
41771,26,23,2010,4368,2155,2213
41772,26,164,2010,66,27,39
41773,26,37,2010,312,172,140
41774,26,1,2010,30,18,12
41775,26,64,2010,145,80,65
41776,26,128,2010,1267,537,730
41777,26,115,2010,293,147,146
41778,26,65,2010,1201,657,544
41779,26,145,2010,355,111,244
41780,26,148,2010,76,51,25
41781,26,49,2010,5301,2955,2346
41782,26,74,2010,10305,5621,4684
41783,26,25,2010,5336,2908,2428
41784,26,169,2010,265,67,198
41785,26,27,2010,44,16,28
41786,26,146,2010,508,206,302
41787,26,170,2010,2022,588,1434
41788,26,38,2010,4153,3026,1127
41789,26,60,2010,143057,77542,65515
41790,26,142,2010,770,330,440
41791,26,50,2010,18797,10459,8338
41792,26,131,2010,221,25,196
41793,26,114,2010,44,22,22
41794,26,171,2010,7904,4260,3644
41795,26,28,2010,69,29,40
41796,170,2,2010,345,189,156
41797,170,12,2010,7515,3996,3519
41798,170,11,2010,7172,3762,3410
41799,170,29,2010,2076,754,1322
41800,170,69,2010,997,600,397
41801,170,6,2010,1718,895,823
41802,170,167,2010,19806,10484,9322
41803,170,36,2010,75465,42257,33208
41804,170,169,2010,3401,1865,1536
41805,170,38,2010,8078,4076,4002
41806,170,171,2010,67903,36623,31280
41807,94,78,2010,251,121,130
41808,94,83,2010,1354,677,677
41809,94,85,2010,9756,4878,4878
41810,94,50,2010,410,183,227
41811,130,141,2010,0,0,0
41812,130,3,2010,133,110,23
41813,130,67,2010,38,19,19
41814,130,116,2010,20352,8990,11362
41815,130,172,2010,364,133,231
41816,130,137,2010,159519,82534,76985
41817,130,81,2010,16,1,15
41818,130,39,2010,154,79,75
41819,130,120,2010,1900,925,975
41820,130,119,2010,5923,2889,3034
41821,130,68,2010,221,85,136
41822,130,155,2010,0,0,0
41823,130,69,2010,208,101,107
41824,130,156,2010,0,0,0
41825,130,56,2010,36,19,17
41826,130,32,2010,8,8,0
41827,130,5,2010,3497,1297,2200
41828,130,57,2010,360,33,327
41829,130,177,2010,182,64,118
41830,130,121,2010,38271,21694,16577
41831,130,176,2010,131,31,100
41832,130,143,2010,0,0,0
41833,130,123,2010,6,1,5
41834,130,161,2010,0,0,0
41835,130,125,2010,26,12,14
41836,130,73,2010,190,98,92
41837,130,162,2010,3,0,3
41838,130,48,2010,7,0,7
41839,130,9,2010,630,159,471
41840,130,36,2010,271,159,112
41841,130,126,2010,70951,35547,35404
41842,130,164,2010,0,0,0
41843,130,128,2010,17425,8495,8930
41844,130,133,2010,2,0,2
41845,130,65,2010,53,36,17
41846,130,129,2010,0,0,0
41847,130,145,2010,145366,74043,71323
41848,130,49,2010,25,0,25
41849,130,166,2010,3,0,3
41850,130,142,2010,0,0,0
41851,130,50,2010,1067,498,569
41852,130,131,2010,21802,11121,10681
41853,130,132,2010,6,2,4
41854,38,2,2010,2605,583,2022
41855,38,12,2010,82025,36344,45681
41856,38,11,2010,47150,19853,27297
41857,38,30,2010,1727,559,1168
41858,38,29,2010,244715,144263,100452
41859,38,172,2010,6539,2353,4186
41860,38,40,2010,10188,5087,5101
41861,38,15,2010,64185,29351,34834
41862,38,69,2010,1080,498,582
41863,38,5,2010,3804,744,3060
41864,38,6,2010,2129,395,1734
41865,38,17,2010,3740,1819,1921
41866,38,167,2010,221504,121812,99692
41867,38,18,2010,3702,83,3619
41868,38,168,2010,26640,14415,12225
41869,38,20,2010,1759,97,1662
41870,38,46,2010,19432,9700,9732
41871,38,47,2010,24337,12150,12187
41872,38,144,2010,1732,488,1244
41873,38,33,2010,3068,1658,1410
41874,38,36,2010,3265811,1924799,1341012
41875,38,1,2010,12349,5250,7099
41876,38,25,2010,3708,144,3564
41877,38,169,2010,29270,14747,14523
41878,38,26,2010,1351,191,1160
41879,38,170,2010,22527,11990,10537
41880,38,171,2010,219081,110301,108780
41881,27,2,2010,6878,2060,4818
41882,27,13,2010,1679,921,758
41883,27,3,2010,919365,115523,803842
41884,27,10,2010,101145,43297,57848
41885,27,136,2010,4493,1341,3152
41886,27,120,2010,9276,2778,6498
41887,27,119,2010,16231,4864,11367
41888,27,68,2010,15230,5401,9829
41889,27,5,2010,2913858,649825,2264033
41890,27,18,2010,141838,47402,94436
41891,27,19,2010,56684,17120,39564
41892,27,20,2010,35184,10545,24639
41893,27,144,2010,7508,2249,5259
41894,27,8,2010,23410,7014,16396
41895,27,73,2010,2651,984,1667
41896,27,162,2010,13178,3950,9228
41897,27,9,2010,836310,178793,657517
41898,27,22,2010,2244,1369,875
41899,27,23,2010,5524,1612,3912
41900,27,128,2010,8173,2448,5725
41901,27,129,2010,13368,4486,8882
41902,27,145,2010,111835,37533,74302
41903,27,25,2010,44428,13372,31056
41904,27,146,2010,4932,1477,3455
41905,27,26,2010,32055,9606,22449
41906,27,142,2010,755158,240734,514424
41907,27,50,2010,24505,8025,16480
41908,27,28,2010,172602,51734,120868
41909,50,2,2010,38029,14167,23862
41910,50,51,2010,7743,2782,4961
41911,50,141,2010,17307,5493,11814
41912,50,52,2010,41,18,23
41913,50,134,2010,9973,5174,4799
41914,50,75,2010,599,305,294
41915,50,76,2010,3705,1999,1706
41916,50,103,2010,8428,4678,3750
41917,50,11,2010,1095,585,510
41918,50,77,2010,695,384,311
41919,50,66,2010,19316,12755,6561
41920,50,12,2010,1683,882,801
41921,50,78,2010,1810,946,864
41922,50,13,2010,4868,2341,2527
41923,50,3,2010,209581,101515,108066
41924,50,79,2010,19706,9993,9713
41925,50,29,2010,2693,1729,964
41926,50,67,2010,23729,13213,10516
41927,50,95,2010,1256,850,406
41928,50,151,2010,419,193,226
41929,50,4,2010,251,86,165
41930,50,53,2010,7090,3866,3224
41931,50,147,2010,2582,1292,1290
41932,50,105,2010,32699,18125,14574
41933,50,30,2010,25990,13134,12856
41934,50,152,2010,154,67,87
41935,50,116,2010,3159,1725,1434
41936,50,153,2010,737,410,327
41937,50,135,2010,6541,3276,3265
41938,50,80,2010,939,521,418
41939,50,136,2010,258,90,168
41940,50,106,2010,5969,3206,2763
41941,50,172,2010,155196,78563,76633
41942,50,173,2010,91875,43928,47947
41943,50,107,2010,18508,10755,7753
41944,50,117,2010,100,55,45
41945,50,137,2010,5907,3279,2628
41946,50,96,2010,529,282,247
41947,50,54,2010,7487,4288,3199
41948,50,81,2010,1728,887,841
41949,50,14,2010,76219,37313,38906
41950,50,31,2010,24725,15066,9659
41951,50,176,2010,8428,4780,3648
41952,50,137,2010,13639,7170,6469
41953,50,39,2010,20372,12025,8347
41954,50,118,2010,336,185,151
41955,50,82,2010,6385,3331,3054
41956,50,83,2010,923,437,486
41957,50,108,2010,5730,3058,2672
41958,50,142,2010,27264,11772,15492
41959,50,97,2010,715,425,290
41960,50,138,2010,167,106,61
41961,50,119,2010,11779,5987,5792
41962,50,40,2010,5200,3120,2080
41963,50,148,2010,1137,609,528
41964,50,120,2010,11310,6032,5278
41965,50,41,2010,326,195,131
41966,50,42,2010,11992,8643,3349
41967,50,68,2010,134393,72091,62302
41968,50,139,2010,241,135,106
41969,50,155,2010,7415,3336,4079
41970,50,15,2010,1798,920,878
41971,50,69,2010,298299,173627,124672
41972,50,156,2010,97035,46040,50995
41973,50,55,2010,9181,4603,4578
41974,50,56,2010,35098,15787,19311
41975,50,84,2010,9296,4914,4382
41976,50,98,2010,715,423,292
41977,50,157,2010,1268,568,700
41978,50,158,2010,1347,675,672
41979,50,110,2010,20782,11922,8860
41980,50,85,2010,231,128,103
41981,50,99,2010,516,314,202
41982,50,32,2010,31742,15706,16036
41983,50,43,2010,1757,951,806
41984,50,5,2010,684136,331218,352918
41985,50,6,2010,61831,25016,36815
41986,50,16,2010,52236,19240,32996
41987,50,44,2010,398201,222643,175558
41988,50,45,2010,8131,4072,4059
41989,50,17,2010,14655,6882,7773
41990,50,57,2010,111540,54313,57227
41991,50,86,2010,147673,85867,61806
41992,50,177,2010,36447,22479,13968
41993,50,18,2010,4366,1639,2727
41994,50,167,2010,2876,1768,1108
41995,50,121,2010,146627,72087,74540
41996,50,19,2010,9207,3876,5331
41997,50,168,2010,575,370,205
41998,50,46,2010,31846,16919,14927
41999,50,20,2010,12831,5338,7493
42000,50,149,2010,544,320,224
42001,50,159,2010,2503,1060,1443
42002,50,143,2010,12439,5252,7187
42003,50,70,2010,27,19,8
42004,50,47,2010,139497,76236,63261
42005,50,71,2010,1538,793,745
42006,50,122,2010,892,579,313
42007,50,123,2010,14091,7115,6976
42008,50,7,2010,277,134,143
42009,50,160,2010,244,102,142
42010,50,58,2010,29075,14968,14107
42011,50,161,2010,119,46,73
42012,50,124,2010,33580,16447,17133
42013,50,100,2010,7201,3913,3288
42014,50,72,2010,302,130,172
42015,50,59,2010,862,423,439
42016,50,87,2010,8048,4481,3567
42017,50,144,2010,16639,7712,8927
42018,50,125,2010,4510,2381,2129
42019,50,150,2010,1798,937,861
42020,50,8,2010,27546,11672,15874
42021,50,73,2010,50645,26699,23946
42022,50,101,2010,293,176,117
42023,50,162,2010,162051,83984,78067
42024,50,60,2010,2056,1175,881
42025,50,48,2010,14971,8700,6271
42026,50,21,2010,2534,1073,1461
42027,50,9,2010,460473,217188,243285
42028,50,102,2010,586,336,250
42029,50,111,2010,613,332,281
42030,50,112,2010,5499,3390,2109
42031,50,33,2010,537859,265126,272733
42032,50,61,2010,129340,70974,58366
42033,50,22,2010,1738,688,1050
42034,50,35,2010,173039,82395,90644
42035,50,36,2010,26798,17251,9547
42036,50,126,2010,3315,1808,1507
42037,50,90,2010,5922,3116,2806
42038,50,91,2010,8476,4571,3905
42039,50,92,2010,7077,3610,3467
42040,50,140,2010,506,314,192
42041,50,23,2010,20585,8668,11917
42042,50,164,2010,1315,563,752
42043,50,63,2010,6918,3674,3244
42044,50,127,2010,3168,1879,1289
42045,50,165,2010,19733,10551,9182
42046,50,37,2010,33115,18287,14828
42047,50,64,2010,1638,984,654
42048,50,128,2010,111360,68740,42620
42049,50,115,2010,220812,109008,111804
42050,50,65,2010,67738,37739,29999
42051,50,10,2010,109679,50238,59441
42052,50,145,2010,14123,5978,8145
42053,50,113,2010,343,203,140
42054,50,49,2010,26812,16692,10120
42055,50,74,2010,17506,10312,7194
42056,50,25,2010,6521,2503,4018
42057,50,169,2010,253,137,116
42058,50,166,2010,1053,442,611
42059,50,93,2010,21843,13195,8648
42060,50,146,2010,4478,1413,3065
42061,50,26,2010,71951,31659,40292
42062,50,170,2010,399,240,159
42063,50,94,2010,113,57,56
42064,50,130,2010,56501,28178,28323
42065,50,38,2010,16374,8664,7710
42066,50,27,2010,8192,3487,4705
42067,50,131,2010,33400,16438,16962
42068,50,114,2010,1136,601,535
42069,50,171,2010,1546,798,748
42070,50,1,2010,26032,13902,12130
42071,50,28,2010,14857,6507,8350
42072,50,132,2010,24456,13002,11454
42073,50,133,2010,126091,68688,57403
42074,114,103,2010,26782,15076,11706
42075,114,105,2010,11978,7166,4812
42076,114,106,2010,1248,653,595
42077,114,68,2010,456,238,218
42078,114,69,2010,1341,731,610
42079,114,57,2010,7095,3233,3862
42080,114,100,2010,516,288,228
42081,114,111,2010,995,679,316
42082,114,112,2010,88,28,60
42083,114,33,2010,1130,637,493
42084,114,61,2010,543,262,281
42085,114,35,2010,592,311,281
42086,114,65,2010,15718,8594,7124
42087,114,50,2010,440,255,185
42088,171,12,2010,21360,10260,11100
42089,171,11,2010,6291,3066,3225
42090,171,29,2010,27674,14446,13228
42091,171,69,2010,8998,4824,4174
42092,171,167,2010,14700,8169,6531
42093,171,168,2010,5085,2821,2264
42094,171,36,2010,913652,501449,412203
42095,171,169,2010,11945,5737,6208
42096,171,170,2010,792,329,463
42097,171,38,2010,129604,69778,59826
42098,1,3,2010,6540,2944,3596
42099,1,10,2010,101,41,60
42100,1,172,2010,2440,1013,1427
42101,1,68,2010,170,49,121
42102,1,5,2010,1614,656,958
42103,1,177,2010,1542,551,991
42104,1,176,2010,1246,538,708
42105,1,8,2010,1944,883,1061
42106,1,9,2010,490,220,270
42107,1,50,2010,927,423,504
42108,28,120,2010,6181,2587,3594
42109,28,119,2010,1515,572,943
42110,28,6,2010,10,4,6
42111,28,16,2010,10441,4877,5564
42112,28,1,2010,28,12,16
42113,28,128,2010,194353,87747,106606
42114,28,129,2010,0,0,0
42115,28,145,2010,23170,11138,12032
42116,28,25,2010,2822,1355,1467
42117,28,142,2010,10621,5109,5512
42118,132,134,2010,37306,18468,18838
42119,132,147,2010,918,495,423
42120,132,116,2010,3243,1561,1682
42121,132,135,2010,243,114,129
42122,132,172,2010,1007,306,701
42123,132,137,2010,8481,4219,4262
42124,132,137,2010,20933,10345,10588
42125,132,68,2010,70,41,29
42126,132,69,2010,279,128,151
42127,132,156,2010,175,56,119
42128,132,5,2010,4630,2112,2518
42129,132,177,2010,100,50,50
42130,132,121,2010,536,242,294
42131,132,123,2010,13467,6840,6627
42132,132,160,2010,217,75,142
42133,132,125,2010,1301,635,666
42134,132,150,2010,630,349,281
42135,132,162,2010,508,223,285
42136,132,126,2010,7462,3603,3859
42137,132,164,2010,142,35,107
42138,132,115,2010,3072,1509,1563
42139,132,133,2010,17226,9388,7838
42140,132,130,2010,456,177,279
42141,132,142,2010,164,60,104
42142,132,50,2010,1286,606,680
42143,132,131,2010,5918,2953,2965
42144,133,147,2010,3705,1592,2113
42145,133,123,2010,103681,44367,59314
42146,133,125,2010,117799,50665,67134
42147,133,115,2010,18910,8123,10787
42148,133,50,2010,12174,5230,6944
42149,133,132,2010,30373,13147,17226
42150,2,9,2015,268369,130434,137935
42151,2,169,2015,15031,8667,6364
42152,2,171,2015,751,433,318
42153,51,56,2015,31596,16433,15163
42154,51,57,2015,8896,4114,4782
42155,51,26,2015,1961,616,1345
42156,51,60,2015,534,272,262
42157,141,68,2015,523,298,225
42158,141,69,2015,733,490,243
42159,141,16,2015,7156,3752,3404
42160,141,57,2015,698,430,268
42161,141,18,2015,2132,1010,1122
42162,141,19,2015,1129,390,739
42163,141,20,2015,1155,711,444
42164,141,143,2015,2195,1043,1152
42165,141,36,2015,757,443,314
42166,141,23,2015,3706,1432,2274
42167,141,128,2015,10923,4931,5992
42168,141,145,2015,1506,711,795
42169,141,25,2015,6211,2943,3268
42170,141,50,2015,754,439,315
42171,141,28,2015,2232,947,1285
42172,52,103,2015,682,333,349
42173,52,67,2015,215,96,119
42174,52,106,2015,214,99,115
42175,52,39,2015,112,0,112
42176,52,68,2015,3890,1774,2116
42177,52,69,2015,339,157,182
42178,52,57,2015,458,215,243
42179,52,144,2015,470,218,252
42180,52,73,2015,244,110,134
42181,52,61,2015,10697,4981,5716
42182,52,65,2015,20577,10434,10143
42183,52,49,2015,49,0,49
42184,52,74,2015,80,0,80
42185,52,50,2015,1054,486,568
42186,52,114,2015,102,47,55
42187,134,153,2015,8662,4524,4138
42188,134,136,2015,31,18,13
42189,134,137,2015,997,605,392
42190,134,137,2015,75667,39082,36585
42191,134,157,2015,9252,5454,3798
42192,134,125,2015,235,123,112
42193,134,150,2015,839,447,392
42194,134,61,2015,5867,2931,2936
42195,134,126,2015,1186,691,495
42196,134,140,2015,6441,3477,2964
42197,134,115,2015,5917,3165,2752
42198,134,132,2015,290,190,100
42199,75,83,2015,653,233,420
42200,75,110,2015,382,157,225
42201,75,86,2015,464,199,265
42202,75,87,2015,285,84,201
42203,75,90,2015,903,315,588
42204,75,50,2015,418,275,143
42205,76,78,2015,2,1,1
42206,76,79,2015,302,125,177
42207,76,95,2015,14,6,8
42208,76,172,2015,134,69,65
42209,76,81,2015,20,11,9
42210,76,82,2015,4745,2656,2089
42211,76,83,2015,1784,1113,671
42212,76,120,2015,90,49,41
42213,76,68,2015,41,22,19
42214,76,109,2015,5,2,3
42215,76,69,2015,83,43,40
42216,76,156,2015,31,16,15
42217,76,84,2015,192,85,107
42218,76,110,2015,6472,3581,2891
42219,76,85,2015,33,17,16
42220,76,99,2015,7,3,4
42221,76,5,2015,79,40,39
42222,76,57,2015,72,36,36
42223,76,86,2015,3990,2659,1331
42224,76,177,2015,20,11,9
42225,76,20,2015,55,28,27
42226,76,100,2015,5,2,3
42227,76,87,2015,1138,566,572
42228,76,73,2015,16,9,7
42229,76,77,2015,5,2,3
42230,76,162,2015,40,22,18
42231,76,9,2015,0,0,0
42232,76,88,2015,53,27,26
42233,76,90,2015,476,254,222
42234,76,75,2015,39,20,19
42235,76,91,2015,676,384,292
42236,76,92,2015,918,370,548
42237,76,115,2015,45,24,21
42238,76,65,2015,12,6,6
42239,76,113,2015,45,24,21
42240,76,25,2015,244,126,118
42241,76,93,2015,720,372,348
42242,76,94,2015,6,3,3
42243,76,142,2015,10,5,5
42244,76,50,2015,994,507,487
42245,103,2,2015,9,7,2
42246,103,51,2015,66,27,39
42247,103,141,2015,104,40,64
42248,103,52,2015,1,0,1
42249,103,134,2015,9,6,3
42250,103,66,2015,1022,551,471
42251,103,13,2015,12,4,8
42252,103,11,2015,561,269,292
42253,103,79,2015,7,6,1
42254,103,67,2015,537,270,267
42255,103,105,2015,48792,28226,20566
42256,103,95,2015,6,5,1
42257,103,30,2015,295,157,138
42258,103,29,2015,304,163,141
42259,103,153,2015,24,14,10
42260,103,10,2015,2,0,2
42261,103,106,2015,213119,114891,98228
42262,103,172,2015,14397,6688,7709
42263,103,107,2015,8640,4307,4333
42264,103,137,2015,42,20,22
42265,103,96,2015,123,55,68
42266,103,54,2015,986,484,502
42267,103,81,2015,1106,511,595
42268,103,14,2015,47,24,23
42269,103,31,2015,1793,1072,721
42270,103,39,2015,245,126,119
42271,103,82,2015,4,4,0
42272,103,83,2015,684,499,185
42273,103,108,2015,955,476,479
42274,103,97,2015,73,36,37
42275,103,120,2015,32,17,15
42276,103,40,2015,49,31,18
42277,103,42,2015,70,48,22
42278,103,68,2015,8160,4042,4118
42279,103,69,2015,9242,4949,4293
42280,103,55,2015,14,9,5
42281,103,56,2015,1017,510,507
42282,103,84,2015,11,10,1
42283,103,98,2015,96,48,48
42284,103,157,2015,1,1,0
42285,103,85,2015,41,11,30
42286,103,99,2015,66,34,32
42287,103,173,2015,4,0,4
42288,103,32,2015,816,440,376
42289,103,43,2015,8,7,1
42290,103,5,2015,97,52,45
42291,103,6,2015,137,63,74
42292,103,16,2015,37,20,17
42293,103,44,2015,64,29,35
42294,103,17,2015,557,269,288
42295,103,57,2015,152338,86582,65756
42296,103,86,2015,11,0,11
42297,103,177,2015,4453,2321,2132
42298,103,18,2015,73,24,49
42299,103,121,2015,2,2,0
42300,103,176,2015,14,0,14
42301,103,20,2015,791,427,364
42302,103,46,2015,124,77,47
42303,103,143,2015,51,18,33
42304,103,70,2015,78,27,51
42305,103,47,2015,392,237,155
42306,103,71,2015,96,67,29
42307,103,122,2015,7,5,2
42308,103,58,2015,2,2,0
42309,103,100,2015,1450,696,754
42310,103,72,2015,10,9,1
42311,103,144,2015,212,119,93
42312,103,125,2015,11,10,1
42313,103,150,2015,2,0,2
42314,103,73,2015,387,170,217
42315,103,77,2015,1,1,0
42316,103,101,2015,91,43,48
42317,103,162,2015,43,29,14
42318,103,48,2015,58,13,45
42319,103,9,2015,5,0,5
42320,103,102,2015,161,68,93
42321,103,111,2015,679044,376908,302136
42322,103,112,2015,195320,106686,88634
42323,103,33,2015,7315,4049,3266
42324,103,61,2015,4961,2392,2569
42325,103,88,2015,75,41,34
42326,103,35,2015,1078,574,504
42327,103,36,2015,1884,991,893
42328,103,62,2015,16,2,14
42329,103,23,2015,80,29,51
42330,103,1,2015,5,2,3
42331,103,64,2015,810,403,407
42332,103,128,2015,2,0,2
42333,103,115,2015,126,64,62
42334,103,133,2015,2,2,0
42335,103,65,2015,98050,56136,41914
42336,103,145,2015,8,0,8
42337,103,113,2015,5,5,0
42338,103,49,2015,204,98,106
42339,103,74,2015,794,373,421
42340,103,25,2015,1125,533,592
42341,103,93,2015,34,11,23
42342,103,146,2015,45,14,31
42343,103,26,2015,635,312,323
42344,103,130,2015,1,1,0
42345,103,38,2015,4408,2243,2165
42346,103,60,2015,1489,799,690
42347,103,142,2015,238,103,135
42348,103,50,2015,943,472,471
42349,103,131,2015,1,0,1
42350,103,152,2015,11,9,2
42351,103,114,2015,132749,69904,62845
42352,103,132,2015,1,0,1
42353,11,12,2015,78908,46247,32661
42354,11,29,2015,306,188,118
42355,11,15,2015,38094,23400,14694
42356,11,69,2015,635,319,316
42357,11,56,2015,1021,566,455
42358,11,6,2015,8135,4179,3956
42359,11,16,2015,1033,603,430
42360,11,167,2015,791,536,255
42361,11,20,2015,853,456,397
42362,11,36,2015,19170,12979,6191
42363,11,25,2015,17538,9185,8353
42364,11,26,2015,542,352,190
42365,11,170,2015,816,509,307
42366,11,38,2015,2464,1826,638
42367,11,171,2015,989,650,339
42368,77,172,2015,1127,548,579
42369,77,107,2015,9762,6006,3756
42370,77,82,2015,107,75,32
42371,77,83,2015,4327,2708,1619
42372,77,84,2015,258,193,65
42373,77,110,2015,289,153,136
42374,77,85,2015,1632,1037,595
42375,77,5,2015,330,113,217
42376,77,86,2015,746,503,243
42377,77,73,2015,4585,2216,2369
42378,77,101,2015,107,58,49
42379,77,112,2015,1134,557,577
42380,77,61,2015,164,82,82
42381,77,92,2015,113,87,26
42382,77,113,2015,1337,709,628
42383,77,26,2015,10,3,7
42384,66,2,2015,41725,13239,28486
42385,66,51,2015,3230,1662,1568
42386,66,141,2015,1340,309,1031
42387,66,52,2015,2,1,1
42388,66,134,2015,397,189,208
42389,66,76,2015,5,5,0
42390,66,103,2015,1490,772,718
42391,66,11,2015,2998,1561,1437
42392,66,77,2015,2,1,1
42393,66,12,2015,1199,617,582
42394,66,78,2015,22,11,11
42395,66,13,2015,26,15,11
42396,66,3,2015,2632,904,1728
42397,66,79,2015,20,9,11
42398,66,29,2015,1756,1343,413
42399,66,67,2015,2446,1302,1144
42400,66,95,2015,7,5,2
42401,66,151,2015,97,32,65
42402,66,4,2015,25,12,13
42403,66,53,2015,152759,77618,75141
42404,66,147,2015,21,13,8
42405,66,105,2015,4761,3170,1591
42406,66,30,2015,20786,11791,8995
42407,66,152,2015,132,59,73
42408,66,116,2015,79,41,38
42409,66,153,2015,35,24,11
42410,66,135,2015,639,273,366
42411,66,80,2015,3,1,2
42412,66,136,2015,21,7,14
42413,66,106,2015,1153,623,530
42414,66,172,2015,14883,8645,6238
42415,66,173,2015,0,0,0
42416,66,174,2015,0,0,0
42417,66,107,2015,1604,991,613
42418,66,117,2015,2,1,1
42419,66,137,2015,268,130,138
42420,66,96,2015,177,104,73
42421,66,54,2015,40118,21683,18435
42422,66,81,2015,865,580,285
42423,66,14,2015,287,141,146
42424,66,31,2015,38777,24633,14144
42425,66,176,2015,118,58,60
42426,66,137,2015,888,432,456
42427,66,39,2015,1232,705,527
42428,66,118,2015,5,1,4
42429,66,82,2015,29,22,7
42430,66,83,2015,2915,2058,857
42431,66,108,2015,648,383,265
42432,66,142,2015,13000,4847,8153
42433,66,97,2015,92,52,40
42434,66,138,2015,10,5,5
42435,66,119,2015,228,94,134
42436,66,40,2015,471,332,139
42437,66,148,2015,25,13,12
42438,66,120,2015,1138,677,461
42439,66,41,2015,1,0,1
42440,66,42,2015,1490,1069,421
42441,66,68,2015,7943,4442,3501
42442,66,139,2015,35,12,23
42443,66,155,2015,599,92,507
42444,66,15,2015,3028,1711,1317
42445,66,69,2015,206750,112302,94448
42446,66,156,2015,2120,908,1212
42447,66,55,2015,9,5,4
42448,66,56,2015,5060,2098,2962
42449,66,84,2015,15,9,6
42450,66,98,2015,373,174,199
42451,66,157,2015,313,85,228
42452,66,158,2015,74,11,63
42453,66,110,2015,18,13,5
42454,66,85,2015,86,47,39
42455,66,99,2015,99,67,32
42456,66,32,2015,59149,32698,26451
42457,66,43,2015,176,89,87
42458,66,5,2015,12586,5333,7253
42459,66,6,2015,15582,7079,8503
42460,66,16,2015,15474,5975,9499
42461,66,44,2015,1047,454,593
42462,66,17,2015,2109,922,1187
42463,66,57,2015,28164,13595,14569
42464,66,86,2015,203,122,81
42465,66,177,2015,2511,1810,701
42466,66,18,2015,677,227,450
42467,66,167,2015,1825,1185,640
42468,66,121,2015,1015,719,296
42469,66,19,2015,258,92,166
42470,66,168,2015,777,523,254
42471,66,46,2015,1304,878,426
42472,66,20,2015,1566,660,906
42473,66,149,2015,4,4,0
42474,66,159,2015,239,48,191
42475,66,143,2015,741,321,420
42476,66,70,2015,317,192,125
42477,66,47,2015,1206,829,377
42478,66,71,2015,836,382,454
42479,66,122,2015,105,79,26
42480,66,123,2015,51,25,26
42481,66,7,2015,13,4,9
42482,66,160,2015,112,32,80
42483,66,58,2015,101,58,43
42484,66,161,2015,24,1,23
42485,66,124,2015,113,71,42
42486,66,100,2015,1705,1008,697
42487,66,72,2015,26,12,14
42488,66,59,2015,1643,847,796
42489,66,144,2015,1968,861,1107
42490,66,125,2015,91,53,38
42491,66,150,2015,214,130,84
42492,66,8,2015,610,255,355
42493,66,73,2015,7855,4068,3787
42494,66,101,2015,222,134,88
42495,66,162,2015,7170,2511,4659
42496,66,60,2015,22352,10695,11657
42497,66,48,2015,737,451,286
42498,66,21,2015,139,40,99
42499,66,9,2015,4985,1627,3358
42500,66,102,2015,63,40,23
42501,66,111,2015,207,120,87
42502,66,112,2015,1570,1064,506
42503,66,33,2015,67217,35831,31386
42504,66,61,2015,2303,968,1335
42505,66,88,2015,0,0,0
42506,66,22,2015,29,7,22
42507,66,35,2015,87770,48607,39163
42508,66,36,2015,30501,18273,12228
42509,66,126,2015,217,101,116
42510,66,90,2015,2,1,1
42511,66,91,2015,14,5,9
42512,66,92,2015,10,6,4
42513,66,62,2015,2,2,0
42514,66,140,2015,2,0,2
42515,66,23,2015,609,278,331
42516,66,164,2015,331,103,228
42517,66,63,2015,160038,83472,76566
42518,66,127,2015,29,17,12
42519,66,165,2015,227,62,165
42520,66,37,2015,34090,21998,12092
42521,66,64,2015,20300,11381,8919
42522,66,128,2015,6103,2089,4014
42523,66,115,2015,2336,1320,1016
42524,66,65,2015,5988,3108,2880
42525,66,10,2015,852,401,451
42526,66,145,2015,663,191,472
42527,66,113,2015,22,11,11
42528,66,49,2015,2808,1686,1122
42529,66,74,2015,13842,7657,6185
42530,66,25,2015,33563,9267,24296
42531,66,169,2015,472,251,221
42532,66,166,2015,202,78,124
42533,66,93,2015,107,63,44
42534,66,146,2015,3544,1132,2412
42535,66,26,2015,153899,73889,80010
42536,66,170,2015,199,148,51
42537,66,130,2015,292,141,151
42538,66,38,2015,10243,7251,2992
42539,66,27,2015,296,141,155
42540,66,50,2015,9925,4625,5300
42541,66,131,2015,187,86,101
42542,66,114,2015,224,120,104
42543,66,171,2015,978,566,412
42544,66,1,2015,2856,1612,1244
42545,66,28,2015,115,38,77
42546,66,132,2015,103,63,40
42547,66,133,2015,315,165,150
42548,12,2,2015,186,54,132
42549,12,11,2015,148503,73087,75416
42550,12,29,2015,459,348,111
42551,12,40,2015,486,255,231
42552,12,15,2015,51141,26408,24733
42553,12,69,2015,285,159,126
42554,12,6,2015,1530,560,970
42555,12,167,2015,3621,2107,1514
42556,12,168,2015,2556,1317,1239
42557,12,36,2015,28760,19362,9398
42558,12,169,2015,249,148,101
42559,12,26,2015,2121,543,1578
42560,12,170,2015,1724,963,761
42561,12,38,2015,2817,2054,763
42562,12,171,2015,17030,8811,8219
42563,78,76,2015,14,8,6
42564,78,103,2015,111,38,73
42565,78,66,2015,40,20,20
42566,78,79,2015,238,86,152
42567,78,67,2015,30,12,18
42568,78,147,2015,14,5,9
42569,78,105,2015,121,63,58
42570,78,95,2015,44,29,15
42571,78,30,2015,21,5,16
42572,78,80,2015,23,10,13
42573,78,10,2015,39,17,22
42574,78,106,2015,35,20,15
42575,78,172,2015,172,73,99
42576,78,107,2015,193,79,114
42577,78,96,2015,54,33,21
42578,78,81,2015,401,276,125
42579,78,39,2015,16,9,7
42580,78,82,2015,75,40,35
42581,78,83,2015,291,119,172
42582,78,108,2015,43,15,28
42583,78,97,2015,73,5,68
42584,78,40,2015,16,10,6
42585,78,68,2015,143,51,92
42586,78,69,2015,289,150,139
42587,78,156,2015,48,9,39
42588,78,56,2015,91,32,59
42589,78,84,2015,33,19,14
42590,78,98,2015,35,19,16
42591,78,110,2015,1335,754,581
42592,78,85,2015,27591,11948,15643
42593,78,99,2015,43,9,34
42594,78,173,2015,26,14,12
42595,78,5,2015,598,262,336
42596,78,44,2015,59,27,32
42597,78,57,2015,158,53,105
42598,78,86,2015,7503,5227,2276
42599,78,177,2015,35,27,8
42600,78,121,2015,21,13,8
42601,78,100,2015,134,49,85
42602,78,73,2015,54,23,31
42603,78,101,2015,10,4,6
42604,78,162,2015,160,77,83
42605,78,48,2015,12,8,4
42606,78,9,2015,0,0,0
42607,78,102,2015,52,35,17
42608,78,112,2015,314,176,138
42609,78,33,2015,20,13,7
42610,78,61,2015,16,3,13
42611,78,35,2015,102,4,98
42612,78,36,2015,56,46,10
42613,78,90,2015,34,21,13
42614,78,91,2015,78,39,39
42615,78,92,2015,40,11,29
42616,78,115,2015,104,49,55
42617,78,133,2015,15,8,7
42618,78,65,2015,111,23,88
42619,78,148,2015,12,7,5
42620,78,49,2015,29,15,14
42621,78,74,2015,307,213,94
42622,78,93,2015,390,211,179
42623,78,94,2015,1545,923,622
42624,78,130,2015,12,9,3
42625,78,38,2015,18,14,4
42626,78,142,2015,31,13,18
42627,78,50,2015,1993,844,1149
42628,78,114,2015,17,8,9
42629,13,2,2015,664,207,457
42630,13,3,2015,88813,11649,77164
42631,13,10,2015,9777,4365,5412
42632,13,136,2015,434,134,300
42633,13,120,2015,895,280,615
42634,13,119,2015,1569,490,1079
42635,13,68,2015,1475,547,928
42636,13,5,2015,281787,65595,216192
42637,13,18,2015,13715,4786,8929
42638,13,19,2015,5479,1727,3752
42639,13,20,2015,3406,1065,2341
42640,13,144,2015,725,227,498
42641,13,8,2015,2271,708,1563
42642,13,73,2015,255,99,156
42643,13,162,2015,1278,401,877
42644,13,9,2015,80807,18032,62775
42645,13,22,2015,217,137,80
42646,13,23,2015,533,162,371
42647,13,128,2015,788,247,541
42648,13,129,2015,1290,451,839
42649,13,145,2015,10792,3780,7012
42650,13,25,2015,4286,1341,2945
42651,13,27,2015,6139,2823,3316
42652,13,146,2015,477,149,328
42653,13,26,2015,3093,968,2125
42654,13,142,2015,73043,24305,48738
42655,13,50,2015,2364,805,1559
42656,13,28,2015,16675,5216,11459
42657,3,13,2015,30160,13873,16287
42658,3,105,2015,14919,6862,8057
42659,3,172,2015,162772,74875,87897
42660,3,5,2015,34431,15838,18593
42661,3,177,2015,13763,6330,7433
42662,3,8,2015,39059,17967,21092
42663,3,48,2015,14311,6583,7728
42664,3,1,2015,27521,12659,14862
42665,3,50,2015,33470,15396,18074
42666,79,76,2015,194,112,82
42667,79,78,2015,49,28,21
42668,79,95,2015,22,11,11
42669,79,172,2015,43,18,25
42670,79,81,2015,58,29,29
42671,79,82,2015,337,224,113
42672,79,84,2015,389,250,139
42673,79,110,2015,6594,3501,3093
42674,79,85,2015,33,23,10
42675,79,5,2015,463,237,226
42676,79,86,2015,994,650,344
42677,79,90,2015,109,60,49
42678,79,91,2015,2177,1313,864
42679,79,92,2015,3114,1862,1252
42680,79,113,2015,47,35,12
42681,79,93,2015,1490,945,545
42682,79,50,2015,2509,1417,1092
42683,29,2,2015,282,90,192
42684,29,141,2015,53,9,44
42685,29,12,2015,13493,5712,7781
42686,29,103,2015,102,67,35
42687,29,66,2015,59,41,18
42688,29,11,2015,5728,2294,3434
42689,29,67,2015,36,15,21
42690,29,105,2015,94,68,26
42691,29,30,2015,61,30,31
42692,29,81,2015,44,3,41
42693,29,31,2015,96,67,29
42694,29,39,2015,199,81,118
42695,29,120,2015,25,1,24
42696,29,40,2015,3243,2139,1104
42697,29,42,2015,2111,1132,979
42698,29,15,2015,8507,3596,4911
42699,29,69,2015,66,31,35
42700,29,56,2015,108,73,35
42701,29,32,2015,342,214,128
42702,29,5,2015,48,9,39
42703,29,6,2015,49,10,39
42704,29,44,2015,24,16,8
42705,29,17,2015,387,208,179
42706,29,57,2015,24,3,21
42707,29,167,2015,69957,36218,33739
42708,29,18,2015,30,1,29
42709,29,176,2015,60,41,19
42710,29,168,2015,5234,2702,2532
42711,29,20,2015,65,0,65
42712,29,46,2015,10486,7399,3087
42713,29,47,2015,17385,12793,4592
42714,29,48,2015,61,27,34
42715,29,9,2015,47,0,47
42716,29,33,2015,478,257,221
42717,29,35,2015,23,13,10
42718,29,36,2015,682362,377195,305167
42719,29,63,2015,35,13,22
42720,29,37,2015,27,18,9
42721,29,1,2015,366,194,172
42722,29,65,2015,35,19,16
42723,29,49,2015,340,163,177
42724,29,74,2015,29,16,13
42725,29,25,2015,83,0,83
42726,29,169,2015,5679,2774,2905
42727,29,27,2015,23,12,11
42728,29,26,2015,25,1,24
42729,29,170,2015,5464,2797,2667
42730,29,38,2015,225734,116506,109228
42731,29,50,2015,461,290,171
42732,29,114,2015,28,24,4
42733,29,171,2015,14788,7636,7152
42734,29,28,2015,33,6,27
42735,67,2,2015,12819,3869,8950
42736,67,51,2015,9380,4669,4711
42737,67,141,2015,25666,11127,14539
42738,67,52,2015,45,21,24
42739,67,134,2015,6327,3104,3223
42740,67,76,2015,2,1,1
42741,67,103,2015,2261,1190,1071
42742,67,11,2015,1413,644,769
42743,67,66,2015,3296,1890,1406
42744,67,12,2015,202,85,117
42745,67,78,2015,15,7,8
42746,67,13,2015,52,22,30
42747,67,3,2015,2706,974,1732
42748,67,79,2015,17,12,5
42749,67,29,2015,481,243,238
42750,67,95,2015,13,7,6
42751,67,151,2015,1387,565,822
42752,67,4,2015,280,87,193
42753,67,53,2015,521,258,263
42754,67,147,2015,45,25,20
42755,67,105,2015,12618,7679,4939
42756,67,30,2015,28749,14409,14340
42757,67,152,2015,1348,654,694
42758,67,116,2015,6824,3796,3028
42759,67,153,2015,735,401,334
42760,67,135,2015,16056,8373,7683
42761,67,80,2015,1,0,1
42762,67,136,2015,496,218,278
42763,67,106,2015,4223,2208,2015
42764,67,172,2015,19048,11014,8034
42765,67,107,2015,6119,3629,2490
42766,67,117,2015,88,58,30
42767,67,137,2015,4084,2141,1943
42768,67,96,2015,284,155,129
42769,67,54,2015,249,138,111
42770,67,81,2015,1724,1064,660
42771,67,14,2015,488,237,251
42772,67,31,2015,657,338,319
42773,67,176,2015,131,65,66
42774,67,137,2015,83629,45189,38440
42775,67,39,2015,2405,1321,1084
42776,67,118,2015,1212,606,606
42777,67,82,2015,147,98,49
42778,67,83,2015,2666,1697,969
42779,67,108,2015,6145,3676,2469
42780,67,142,2015,4322,1370,2952
42781,67,97,2015,547,311,236
42782,67,138,2015,82,60,22
42783,67,119,2015,248,74,174
42784,67,40,2015,729,488,241
42785,67,148,2015,66,39,27
42786,67,120,2015,4056,1838,2218
42787,67,42,2015,2560,1672,888
42788,67,68,2015,182214,99672,82542
42789,67,139,2015,614,330,284
42790,67,155,2015,711,265,446
42791,67,15,2015,499,248,251
42792,67,69,2015,81532,44600,36932
42793,67,156,2015,8956,4293,4663
42794,67,55,2015,11,6,5
42795,67,56,2015,16193,8148,8045
42796,67,84,2015,3,1,2
42797,67,98,2015,832,432,400
42798,67,157,2015,12984,6226,6758
42799,67,158,2015,276,114,162
42800,67,110,2015,92,55,37
42801,67,85,2015,1925,1072,853
42802,67,99,2015,261,184,77
42803,67,32,2015,8032,4392,3640
42804,67,43,2015,233,134,99
42805,67,5,2015,19815,9495,10320
42806,67,6,2015,10554,4642,5912
42807,67,16,2015,11076,4066,7010
42808,67,44,2015,3333,1667,1666
42809,67,17,2015,3532,1437,2095
42810,67,57,2015,119955,58295,61660
42811,67,86,2015,397,242,155
42812,67,177,2015,4677,2683,1994
42813,67,18,2015,1061,392,669
42814,67,167,2015,1051,524,527
42815,67,121,2015,1420,899,521
42816,67,19,2015,258,78,180
42817,67,168,2015,334,162,172
42818,67,46,2015,1218,770,448
42819,67,20,2015,6349,2453,3896
42820,67,149,2015,17,14,3
42821,67,159,2015,916,334,582
42822,67,143,2015,737,296,441
42823,67,70,2015,5,4,1
42824,67,47,2015,1512,959,553
42825,67,71,2015,13351,7064,6287
42826,67,122,2015,2079,1495,584
42827,67,123,2015,95,47,48
42828,67,7,2015,4,2,2
42829,67,160,2015,940,432,508
42830,67,58,2015,435,239,196
42831,67,161,2015,2172,469,1703
42832,67,124,2015,3334,2507,827
42833,67,100,2015,2375,1463,912
42834,67,72,2015,134,72,62
42835,67,59,2015,15,10,5
42836,67,144,2015,208071,100651,107420
42837,67,125,2015,447,245,202
42838,67,150,2015,67,36,31
42839,67,8,2015,3529,1646,1883
42840,67,73,2015,128544,64732,63812
42841,67,101,2015,302,175,127
42842,67,162,2015,5539,2826,2713
42843,67,60,2015,1290,624,666
42844,67,48,2015,1164,621,543
42845,67,21,2015,32,13,19
42846,67,9,2015,11995,4356,7639
42847,67,102,2015,171,112,59
42848,67,111,2015,447,291,156
42849,67,112,2015,3593,2326,1267
42850,67,33,2015,73447,41440,32007
42851,67,61,2015,34303,16804,17499
42852,67,22,2015,68,22,46
42853,67,35,2015,65150,31229,33921
42854,67,36,2015,6904,3311,3593
42855,67,126,2015,13990,7658,6332
42856,67,90,2015,1,1,0
42857,67,91,2015,16,9,7
42858,67,92,2015,4,1,3
42859,67,62,2015,14,7,7
42860,67,140,2015,85,40,45
42861,67,23,2015,485,209,276
42862,67,164,2015,5404,2317,3087
42863,67,63,2015,548,270,278
42864,67,127,2015,76,47,29
42865,67,165,2015,1964,676,1288
42866,67,37,2015,1307,633,674
42867,67,64,2015,154,84,70
42868,67,128,2015,3319,1556,1763
42869,67,115,2015,3596,1905,1691
42870,67,65,2015,46030,24653,21377
42871,67,10,2015,1901,924,977
42872,67,145,2015,1047,358,689
42873,67,113,2015,3017,1642,1375
42874,67,49,2015,3342,1849,1493
42875,67,74,2015,5048,2764,2284
42876,67,25,2015,10860,4219,6641
42877,67,169,2015,48,20,28
42878,67,166,2015,5502,2257,3245
42879,67,93,2015,83,55,28
42880,67,146,2015,13996,5059,8937
42881,67,26,2015,98250,47326,50924
42882,67,170,2015,9,4,5
42883,67,130,2015,667,370,297
42884,67,38,2015,1394,680,714
42885,67,27,2015,405,204,201
42886,67,50,2015,22484,10640,11844
42887,67,131,2015,615,317,298
42888,67,114,2015,490,242,248
42889,67,171,2015,395,200,195
42890,67,1,2015,8206,4612,3594
42891,67,28,2015,201,67,134
42892,67,132,2015,338,202,136
42893,67,133,2015,459,245,214
42894,95,172,2015,2048,924,1124
42895,95,97,2015,8828,4303,4525
42896,95,69,2015,68,24,44
42897,95,98,2015,23580,12187,11393
42898,95,85,2015,54,24,30
42899,95,99,2015,8624,4295,4329
42900,95,173,2015,71,34,37
42901,95,5,2015,592,266,326
42902,95,86,2015,496,194,302
42903,95,20,2015,54,15,39
42904,95,100,2015,3523,1663,1860
42905,95,162,2015,44,7,37
42906,95,50,2015,409,158,251
42907,151,136,2015,969,362,607
42908,151,137,2015,3783,1828,1955
42909,151,68,2015,1304,645,659
42910,151,156,2015,15076,8666,6410
42911,151,160,2015,3260,1286,1974
42912,151,162,2015,80960,40356,40604
42913,151,166,2015,105441,67338,38103
42914,151,152,2015,12004,5229,6775
42915,4,3,2015,52,17,35
42916,4,10,2015,33,15,18
42917,4,172,2015,906,233,673
42918,4,39,2015,38,13,25
42919,4,68,2015,30,15,15
42920,4,69,2015,27,12,15
42921,4,5,2015,44732,6223,38509
42922,4,57,2015,13,4,9
42923,4,177,2015,127,46,81
42924,4,8,2015,717,291,426
42925,4,73,2015,20,6,14
42926,4,9,2015,22,0,22
42927,4,49,2015,23,10,13
42928,4,74,2015,24,5,19
42929,4,50,2015,36,21,15
42930,53,66,2015,209,109,100
42931,53,54,2015,12776,6530,6246
42932,53,68,2015,174,92,82
42933,53,69,2015,554,291,263
42934,53,32,2015,160,109,51
42935,53,57,2015,116,67,49
42936,53,59,2015,4398,2253,2145
42937,53,35,2015,406,319,87
42938,53,36,2015,177,134,43
42939,53,63,2015,10222,5223,4999
42940,53,37,2015,3389,1716,1673
42941,53,64,2015,1961,1184,777
42942,53,60,2015,3079,1629,1450
42943,147,134,2015,730,382,348
42944,147,10,2015,926,447,479
42945,147,172,2015,4466,905,3561
42946,147,137,2015,1056,426,630
42947,147,39,2015,324,156,168
42948,147,69,2015,316,174,142
42949,147,5,2015,5282,2202,3080
42950,147,44,2015,587,270,317
42951,147,57,2015,511,183,328
42952,147,121,2015,1133,371,762
42953,147,149,2015,261,185,76
42954,147,122,2015,525,221,304
42955,147,123,2015,1384,523,861
42956,147,124,2015,218,109,109
42957,147,125,2015,566,240,326
42958,147,150,2015,926,284,642
42959,147,73,2015,597,244,353
42960,147,162,2015,1154,556,598
42961,147,48,2015,367,161,206
42962,147,9,2015,436,207,229
42963,147,61,2015,436,171,265
42964,147,127,2015,10,0,10
42965,147,115,2015,5359,2463,2896
42966,147,133,2015,60080,25606,34474
42967,147,148,2015,570,206,364
42968,147,49,2015,410,160,250
42969,147,130,2015,305,120,185
42970,147,50,2015,1231,447,784
42971,147,131,2015,763,338,425
42972,147,132,2015,4128,1832,2296
42973,105,2,2015,68,24,44
42974,105,141,2015,215,107,108
42975,105,52,2015,12,0,12
42976,105,134,2015,7533,3693,3840
42977,105,103,2015,33971,14309,19662
42978,105,66,2015,2733,1510,1223
42979,105,78,2015,18,12,6
42980,105,13,2015,31,0,31
42981,105,3,2015,53,0,53
42982,105,11,2015,62,11,51
42983,105,79,2015,33,24,9
42984,105,67,2015,1980,566,1414
42985,105,53,2015,81,45,36
42986,105,95,2015,6,6,0
42987,105,30,2015,279,140,139
42988,105,116,2015,25,0,25
42989,105,29,2015,10,0,10
42990,105,135,2015,163,70,93
42991,105,153,2015,1397,781,616
42992,105,106,2015,18036,7305,10731
42993,105,172,2015,22671,10474,12197
42994,105,107,2015,8008,4006,4002
42995,105,137,2015,94,10,84
42996,105,137,2015,1993,532,1461
42997,105,96,2015,452,181,271
42998,105,54,2015,669,415,254
42999,105,81,2015,2427,996,1431
43000,105,31,2015,522,237,285
43001,105,151,2015,31,10,21
43002,105,39,2015,577,188,389
43003,105,82,2015,25,13,12
43004,105,83,2015,365,285,80
43005,105,108,2015,2022,1006,1016
43006,105,97,2015,267,71,196
43007,105,138,2015,65,49,16
43008,105,120,2015,12,12,0
43009,105,40,2015,213,152,61
43010,105,42,2015,605,285,320
43011,105,68,2015,11172,4146,7026
43012,105,109,2015,827,343,484
43013,105,139,2015,36,0,36
43014,105,15,2015,75,51,24
43015,105,69,2015,18983,8030,10953
43016,105,156,2015,72,23,49
43017,105,56,2015,1801,803,998
43018,105,84,2015,31,5,26
43019,105,98,2015,341,162,179
43020,105,157,2015,68,30,38
43021,105,110,2015,2217,1158,1059
43022,105,85,2015,64,43,21
43023,105,99,2015,148,60,88
43024,105,32,2015,1783,935,848
43025,105,43,2015,564,189,375
43026,105,5,2015,1030,366,664
43027,105,6,2015,625,297,328
43028,105,16,2015,597,216,381
43029,105,44,2015,201,43,158
43030,105,17,2015,2351,931,1420
43031,105,57,2015,43436,18003,25433
43032,105,86,2015,162,25,137
43033,105,177,2015,57336,28344,28992
43034,105,167,2015,29,29,0
43035,105,18,2015,1232,346,886
43036,105,121,2015,53,51,2
43037,105,176,2015,169,67,102
43038,105,19,2015,24,24,0
43039,105,20,2015,14418,5322,9096
43040,105,46,2015,166,133,33
43041,105,159,2015,41,18,23
43042,105,143,2015,112,54,58
43043,105,70,2015,19,0,19
43044,105,47,2015,739,570,169
43045,105,71,2015,63,17,46
43046,105,122,2015,42,37,5
43047,105,123,2015,11,0,11
43048,105,7,2015,11,11,0
43049,105,160,2015,7,0,7
43050,105,58,2015,33,0,33
43051,105,100,2015,3131,1462,1669
43052,105,72,2015,148,94,54
43053,105,59,2015,26,14,12
43054,105,144,2015,594,229,365
43055,105,125,2015,1667,946,721
43056,105,21,2015,23,10,13
43057,105,150,2015,57,11,46
43058,105,8,2015,59,0,59
43059,105,73,2015,3885,1139,2746
43060,105,101,2015,429,205,224
43061,105,162,2015,2181,561,1620
43062,105,48,2015,671,183,488
43063,105,9,2015,301,127,174
43064,105,102,2015,608,214,394
43065,105,111,2015,45874,25108,20766
43066,105,112,2015,17555,6945,10610
43067,105,33,2015,4070,2119,1951
43068,105,61,2015,161250,80632,80618
43069,105,158,2015,1105,373,732
43070,105,35,2015,1994,1136,858
43071,105,36,2015,1622,1007,615
43072,105,126,2015,16,0,16
43073,105,90,2015,36,5,31
43074,105,91,2015,170,115,55
43075,105,92,2015,35,35,0
43076,105,62,2015,41,41,0
43077,105,140,2015,69,54,15
43078,105,23,2015,383,106,277
43079,105,164,2015,5219,587,4632
43080,105,63,2015,507,331,176
43081,105,127,2015,35,0,35
43082,105,165,2015,7,0,7
43083,105,37,2015,248,130,118
43084,105,1,2015,149,53,96
43085,105,64,2015,207,94,113
43086,105,115,2015,1855,537,1318
43087,105,133,2015,120,52,68
43088,105,65,2015,35922,16461,19461
43089,105,113,2015,319,135,184
43090,105,49,2015,742,243,499
43091,105,74,2015,3489,1144,2345
43092,105,25,2015,3425,1455,1970
43093,105,169,2015,8,0,8
43094,105,166,2015,11,0,11
43095,105,93,2015,220,122,98
43096,105,27,2015,39,0,39
43097,105,146,2015,94,14,80
43098,105,26,2015,423,139,284
43099,105,170,2015,25,18,7
43100,105,130,2015,76,34,42
43101,105,38,2015,857,495,362
43102,105,60,2015,46,17,29
43103,105,142,2015,3642,1710,1932
43104,105,50,2015,5782,2246,3536
43105,105,131,2015,103,43,60
43106,105,152,2015,30,17,13
43107,105,114,2015,28106,13778,14328
43108,105,171,2015,31,30,1
43109,30,2,2015,3438,875,2563
43110,30,51,2015,990,470,520
43111,30,141,2015,347,153,194
43112,30,52,2015,0,0,0
43113,30,134,2015,8,6,2
43114,30,75,2015,29,10,19
43115,30,76,2015,5,1,4
43116,30,103,2015,99,55,44
43117,30,11,2015,1371,795,576
43118,30,77,2015,5,1,4
43119,30,66,2015,804,363,441
43120,30,12,2015,1652,964,688
43121,30,78,2015,4,4,0
43122,30,13,2015,14,9,5
43123,30,3,2015,478,243,235
43124,30,79,2015,4,3,1
43125,30,29,2015,704,556,148
43126,30,67,2015,1297,635,662
43127,30,95,2015,2,2,0
43128,30,151,2015,24,11,13
43129,30,4,2015,21,9,12
43130,30,53,2015,102,37,65
43131,30,147,2015,23,10,13
43132,30,105,2015,120,76,44
43133,30,152,2015,11,4,7
43134,30,116,2015,15,8,7
43135,30,153,2015,6,2,4
43136,30,135,2015,13,2,11
43137,30,80,2015,3,1,2
43138,30,136,2015,5,1,4
43139,30,106,2015,20,8,12
43140,30,172,2015,1083,558,525
43141,30,107,2015,36,17,19
43142,30,137,2015,10,6,4
43143,30,96,2015,7,0,7
43144,30,54,2015,95,41,54
43145,30,81,2015,241,99,142
43146,30,14,2015,883,422,461
43147,30,31,2015,1039,614,425
43148,30,176,2015,29,19,10
43149,30,137,2015,13,2,11
43150,30,39,2015,201,78,123
43151,30,118,2015,3,0,3
43152,30,82,2015,0,0,0
43153,30,83,2015,41,26,15
43154,30,108,2015,15,13,2
43155,30,142,2015,210,56,154
43156,30,97,2015,8,3,5
43157,30,119,2015,3,1,2
43158,30,40,2015,64,45,19
43159,30,148,2015,2,2,0
43160,30,120,2015,50,13,37
43161,30,42,2015,129,65,64
43162,30,68,2015,1560,739,821
43163,30,139,2015,10,7,3
43164,30,155,2015,8,5,3
43165,30,15,2015,354,209,145
43166,30,69,2015,4846,2329,2517
43167,30,156,2015,15,8,7
43168,30,55,2015,6,4,2
43169,30,56,2015,6276,2947,3329
43170,30,98,2015,4,2,2
43171,30,157,2015,9,1,8
43172,30,158,2015,4,2,2
43173,30,110,2015,4,1,3
43174,30,85,2015,5,1,4
43175,30,99,2015,2,1,1
43176,30,32,2015,312,188,124
43177,30,43,2015,15,8,7
43178,30,5,2015,251,85,166
43179,30,6,2015,303,87,216
43180,30,16,2015,4850,1302,3548
43181,30,44,2015,214,103,111
43182,30,45,2015,2,2,0
43183,30,17,2015,486,190,296
43184,30,57,2015,2479,1016,1463
43185,30,86,2015,5,3,2
43186,30,177,2015,159,91,68
43187,30,18,2015,201,53,148
43188,30,167,2015,1327,928,399
43189,30,121,2015,16,10,6
43190,30,19,2015,100,34,66
43191,30,168,2015,145,104,41
43192,30,46,2015,148,117,31
43193,30,20,2015,662,184,478
43194,30,159,2015,5,1,4
43195,30,143,2015,210,103,107
43196,30,70,2015,2,1,1
43197,30,47,2015,118,96,22
43198,30,71,2015,64,36,28
43199,30,122,2015,2,0,2
43200,30,123,2015,1,0,1
43201,30,7,2015,1,1,0
43202,30,160,2015,5,2,3
43203,30,58,2015,63,31,32
43204,30,161,2015,2,0,2
43205,30,124,2015,4,2,2
43206,30,100,2015,54,29,25
43207,30,72,2015,8,5,3
43208,30,59,2015,24,12,12
43209,30,144,2015,93,45,48
43210,30,125,2015,31,14,17
43211,30,150,2015,5,3,2
43212,30,8,2015,8,0,8
43213,30,73,2015,911,412,499
43214,30,101,2015,28,3,25
43215,30,162,2015,124,22,102
43216,30,60,2015,2402,1115,1287
43217,30,48,2015,230,116,114
43218,30,21,2015,4,0,4
43219,30,9,2015,137,52,85
43220,30,102,2015,7,1,6
43221,30,111,2015,2,0,2
43222,30,112,2015,26,11,15
43223,30,33,2015,1444,1007,437
43224,30,61,2015,339,180,159
43225,30,22,2015,29,9,20
43226,30,35,2015,4039,2538,1501
43227,30,36,2015,21381,16054,5327
43228,30,126,2015,2,1,1
43229,30,62,2015,6,5,1
43230,30,23,2015,56,19,37
43231,30,164,2015,11,4,7
43232,30,63,2015,1944,1026,918
43233,30,127,2015,0,0,0
43234,30,165,2015,1,0,1
43235,30,37,2015,299,228,71
43236,30,64,2015,83,40,43
43237,30,128,2015,16,8,8
43238,30,115,2015,188,98,90
43239,30,65,2015,4589,2288,2301
43240,30,10,2015,12,2,10
43241,30,145,2015,41,8,33
43242,30,113,2015,1,0,1
43243,30,49,2015,274,135,139
43244,30,74,2015,347,156,191
43245,30,25,2015,15502,5376,10126
43246,30,169,2015,133,79,54
43247,30,166,2015,1,1,0
43248,30,93,2015,4,0,4
43249,30,146,2015,97,24,73
43250,30,26,2015,8130,2448,5682
43251,30,170,2015,250,168,82
43252,30,94,2015,3,0,3
43253,30,130,2015,7,2,5
43254,30,38,2015,6164,4752,1412
43255,30,27,2015,133,66,67
43256,30,50,2015,5901,2786,3115
43257,30,131,2015,10,1,9
43258,30,114,2015,16,5,11
43259,30,171,2015,675,457,218
43260,30,1,2015,557,195,362
43261,30,28,2015,46,12,34
43262,30,132,2015,10,5,5
43263,30,133,2015,27,10,17
43264,152,151,2015,4178,2054,2124
43265,152,156,2015,32217,20803,11414
43266,152,160,2015,43815,25697,18118
43267,152,162,2015,5170,2769,2401
43268,152,164,2015,4033,1838,2195
43269,152,166,2015,15393,9867,5526
43270,116,67,2015,605,317,288
43271,116,137,2015,175768,86279,89489
43272,116,68,2015,302,157,145
43273,116,121,2015,1032,450,582
43274,116,126,2015,64363,35223,29140
43275,116,130,2015,891,371,520
43276,116,131,2015,28008,14971,13037
43277,153,134,2015,370,195,175
43278,153,103,2015,4,3,1
43279,153,67,2015,10,4,6
43280,153,105,2015,286,151,135
43281,153,172,2015,23,13,10
43282,153,81,2015,85,45,40
43283,153,68,2015,201,107,94
43284,153,139,2015,8,3,5
43285,153,155,2015,5,3,2
43286,153,69,2015,67,31,36
43287,153,156,2015,42,22,20
43288,153,157,2015,413,217,196
43289,153,57,2015,407,188,219
43290,153,177,2015,1,0,1
43291,153,71,2015,4,3,1
43292,153,160,2015,7,3,4
43293,153,100,2015,3,0,3
43294,153,125,2015,26,15,11
43295,153,73,2015,37,18,19
43296,153,162,2015,670,356,314
43297,153,112,2015,3,0,3
43298,153,61,2015,1159,606,553
43299,153,158,2015,5015,2235,2780
43300,153,36,2015,698,378,320
43301,153,140,2015,1712,962,750
43302,153,164,2015,1478,701,777
43303,153,165,2015,15,8,7
43304,153,65,2015,143,76,67
43305,153,74,2015,13,7,6
43306,153,38,2015,22,10,12
43307,153,50,2015,52,26,26
43308,135,134,2015,2555,1430,1125
43309,135,136,2015,33968,15994,17974
43310,135,137,2015,2953,1614,1339
43311,135,137,2015,4078,2118,1960
43312,135,151,2015,2400,1150,1250
43313,135,138,2015,3357,1916,1441
43314,135,68,2015,4615,2355,2260
43315,135,139,2015,1055,568,487
43316,135,69,2015,294,157,137
43317,135,56,2015,191,70,121
43318,135,157,2015,4577,2570,2007
43319,135,57,2015,508,235,273
43320,135,159,2015,4255,2412,1843
43321,135,160,2015,8202,2686,5516
43322,135,73,2015,159,70,89
43323,135,162,2015,131616,72460,59156
43324,135,164,2015,3153,659,2494
43325,135,50,2015,255,116,139
43326,80,103,2015,12,7,5
43327,80,66,2015,50,9,41
43328,80,78,2015,185,88,97
43329,80,79,2015,183,65,118
43330,80,67,2015,12,5,7
43331,80,105,2015,71,37,34
43332,80,95,2015,352,157,195
43333,80,107,2015,419,222,197
43334,80,96,2015,130,38,92
43335,80,81,2015,757,393,364
43336,80,39,2015,18,6,12
43337,80,83,2015,66,14,52
43338,80,42,2015,9,5,4
43339,80,68,2015,38,14,24
43340,80,69,2015,136,44,92
43341,80,84,2015,16,6,10
43342,80,110,2015,335,136,199
43343,80,85,2015,18,6,12
43344,80,99,2015,1833,1156,677
43345,80,5,2015,582,133,449
43346,80,6,2015,9,3,6
43347,80,44,2015,231,123,108
43348,80,17,2015,12,9,3
43349,80,57,2015,91,11,80
43350,80,86,2015,10354,5164,5190
43351,80,177,2015,20,5,15
43352,80,121,2015,36,26,10
43353,80,100,2015,40,20,20
43354,80,73,2015,38,5,33
43355,80,101,2015,396,235,161
43356,80,162,2015,9,0,9
43357,80,9,2015,110,39,71
43358,80,102,2015,136,62,74
43359,80,112,2015,15,9,6
43360,80,88,2015,48,26,22
43361,80,91,2015,9,5,4
43362,80,92,2015,32,7,25
43363,80,115,2015,38,18,20
43364,80,133,2015,18,5,13
43365,80,65,2015,29,16,13
43366,80,74,2015,81,18,63
43367,80,93,2015,314,165,149
43368,80,50,2015,2146,1012,1134
43369,80,131,2015,15,13,2
43370,80,132,2015,9,3,6
43371,136,135,2015,30702,16794,13908
43372,136,137,2015,846,457,389
43373,136,137,2015,304,164,140
43374,136,68,2015,1048,566,482
43375,136,139,2015,347,187,160
43376,136,143,2015,1297,700,597
43377,136,162,2015,6531,3523,3008
43378,136,145,2015,320988,174684,146304
43379,106,103,2015,56363,26586,29777
43380,106,105,2015,15247,7600,7647
43381,106,172,2015,7889,3348,4541
43382,106,107,2015,73601,38449,35152
43383,106,81,2015,2051,918,1133
43384,106,83,2015,821,418,403
43385,106,108,2015,22146,11628,10518
43386,106,68,2015,9403,4280,5123
43387,106,69,2015,16250,7765,8485
43388,106,85,2015,39825,16503,23322
43389,106,57,2015,11216,4767,6449
43390,106,100,2015,5155,2426,2729
43391,106,111,2015,3632,1789,1843
43392,106,112,2015,150885,87422,63463
43393,106,65,2015,17097,7743,9354
43394,106,114,2015,6786,3061,3725
43395,172,3,2015,2865,1314,1551
43396,172,105,2015,52956,18895,34061
43397,172,10,2015,3875,2014,1861
43398,172,173,2015,192643,72713,119930
43399,172,5,2015,6393,2134,4259
43400,172,177,2015,4866,1534,3332
43401,172,174,2015,17393,7382,10011
43402,172,9,2015,3140,1035,2105
43403,172,112,2015,9612,3429,6183
43404,172,36,2015,2113,740,1373
43405,172,1,2015,300896,116264,184632
43406,172,50,2015,6493,1953,4540
43407,107,103,2015,4464,1813,2651
43408,107,105,2015,3525,1884,1641
43409,107,106,2015,3388,1446,1942
43410,107,172,2015,1616,662,954
43411,107,96,2015,1442,724,718
43412,107,81,2015,2144,804,1340
43413,107,83,2015,714,333,381
43414,107,108,2015,16397,7998,8399
43415,107,97,2015,586,266,320
43416,107,68,2015,2603,1060,1543
43417,107,69,2015,2088,837,1251
43418,107,98,2015,661,303,358
43419,107,99,2015,523,276,247
43420,107,57,2015,2902,994,1908
43421,107,177,2015,658,283,375
43422,107,100,2015,4265,1942,2323
43423,107,73,2015,495,165,330
43424,107,102,2015,2573,1280,1293
43425,107,112,2015,5144,2054,3090
43426,107,36,2015,616,390,226
43427,107,65,2015,11877,5202,6675
43428,107,74,2015,704,246,458
43429,107,50,2015,1439,548,891
43430,107,114,2015,544,185,359
43431,117,68,2015,482,205,277
43432,117,121,2015,76,42,34
43433,117,122,2015,9651,5112,4539
43434,117,131,2015,145,74,71
43435,137,134,2015,41238,19785,21453
43436,137,135,2015,11300,4573,6727
43437,137,136,2015,10565,3639,6926
43438,137,172,2015,924,72,852
43439,137,137,2015,170368,83368,87000
43440,137,81,2015,536,369,167
43441,137,151,2015,15194,7188,8006
43442,137,138,2015,1582,721,861
43443,137,68,2015,10320,4677,5643
43444,137,139,2015,3163,1619,1544
43445,137,69,2015,579,310,269
43446,137,20,2015,1167,441,726
43447,137,160,2015,33918,11215,22703
43448,137,161,2015,3149,723,2426
43449,137,61,2015,1441,608,833
43450,137,36,2015,2576,1558,1018
43451,137,126,2015,25119,10873,14246
43452,137,164,2015,13265,3106,10159
43453,137,166,2015,2437,1310,1127
43454,137,134,2015,181954,89043,92911
43455,137,116,2015,38377,22362,16015
43456,137,137,2015,6431,5268,1163
43457,137,126,2015,275136,138208,136928
43458,137,129,2015,8596,6279,2317
43459,137,145,2015,5523,4845,678
43460,137,130,2015,6115,5001,1114
43461,96,2,2015,4,3,1
43462,96,51,2015,4,0,4
43463,96,141,2015,12,7,5
43464,96,134,2015,3,1,2
43465,96,12,2015,3,1,2
43466,96,103,2015,1468,763,705
43467,96,66,2015,128,36,92
43468,96,78,2015,12,3,9
43469,96,13,2015,1,0,1
43470,96,3,2015,3,0,3
43471,96,11,2015,7,3,4
43472,96,79,2015,11,4,7
43473,96,67,2015,292,121,171
43474,96,4,2015,4,1,3
43475,96,105,2015,544,277,267
43476,96,95,2015,139,56,83
43477,96,30,2015,71,39,32
43478,96,29,2015,5,3,2
43479,96,135,2015,9,5,4
43480,96,80,2015,8,1,7
43481,96,10,2015,1,0,1
43482,96,106,2015,1739,854,885
43483,96,172,2015,291,109,182
43484,96,107,2015,21270,10849,10421
43485,96,137,2015,8,3,5
43486,96,137,2015,3,3,0
43487,96,54,2015,24,11,13
43488,96,81,2015,5756,2741,3015
43489,96,14,2015,3,0,3
43490,96,151,2015,1,1,0
43491,96,39,2015,63,27,36
43492,96,82,2015,5,5,0
43493,96,83,2015,1098,733,365
43494,96,108,2015,1272,581,691
43495,96,97,2015,13900,7740,6160
43496,96,120,2015,1,0,1
43497,96,40,2015,3,3,0
43498,96,42,2015,22,15,7
43499,96,68,2015,873,390,483
43500,96,109,2015,12,7,5
43501,96,139,2015,1,1,0
43502,96,15,2015,12,7,5
43503,96,69,2015,1866,795,1071
43504,96,156,2015,1,0,1
43505,96,55,2015,4,4,0
43506,96,56,2015,33,11,22
43507,96,84,2015,8,3,5
43508,96,98,2015,2660,1304,1356
43509,96,110,2015,28,12,16
43510,96,85,2015,71,29,42
43511,96,99,2015,3924,2248,1676
43512,96,173,2015,3285,1542,1743
43513,96,32,2015,74,33,41
43514,96,43,2015,1,1,0
43515,96,5,2015,54,21,33
43516,96,6,2015,100,19,81
43517,96,16,2015,15,5,10
43518,96,44,2015,29,15,14
43519,96,17,2015,170,61,109
43520,96,57,2015,2132,817,1315
43521,96,86,2015,217,125,92
43522,96,177,2015,283,121,162
43523,96,167,2015,5,5,0
43524,96,18,2015,11,3,8
43525,96,121,2015,8,0,8
43526,96,176,2015,36,19,17
43527,96,20,2015,88,29,59
43528,96,46,2015,1,1,0
43529,96,143,2015,11,5,6
43530,96,70,2015,4,1,3
43531,96,47,2015,9,4,5
43532,96,71,2015,15,11,4
43533,96,174,2015,1,0,1
43534,96,122,2015,3,3,0
43535,96,7,2015,1,1,0
43536,96,100,2015,3100,1677,1423
43537,96,72,2015,1,0,1
43538,96,87,2015,4,3,1
43539,96,144,2015,4,3,1
43540,96,125,2015,4,3,1
43541,96,21,2015,3,0,3
43542,96,8,2015,8,1,7
43543,96,73,2015,586,238,348
43544,96,77,2015,32,11,21
43545,96,101,2015,292232,154943,137289
43546,96,162,2015,3,3,0
43547,96,48,2015,76,29,47
43548,96,9,2015,9,0,9
43549,96,102,2015,11424,5596,5828
43550,96,111,2015,83,58,25
43551,96,112,2015,3783,1842,1941
43552,96,33,2015,302,172,130
43553,96,61,2015,78,32,46
43554,96,88,2015,356,140,216
43555,96,22,2015,3,1,2
43556,96,35,2015,99,52,47
43557,96,36,2015,599,395,204
43558,96,126,2015,1,1,0
43559,96,90,2015,1,1,0
43560,96,91,2015,1,1,0
43561,96,92,2015,1,0,1
43562,96,23,2015,13,4,9
43563,96,164,2015,1,1,0
43564,96,37,2015,22,8,14
43565,96,1,2015,1,0,1
43566,96,128,2015,1,1,0
43567,96,115,2015,57,32,25
43568,96,133,2015,1,0,1
43569,96,65,2015,2163,956,1207
43570,96,145,2015,1,0,1
43571,96,113,2015,20,9,11
43572,96,148,2015,1,0,1
43573,96,49,2015,137,61,76
43574,96,74,2015,672,298,374
43575,96,25,2015,11,1,10
43576,96,93,2015,34,24,10
43577,96,146,2015,4,3,1
43578,96,26,2015,8,4,4
43579,96,130,2015,9,3,6
43580,96,38,2015,155,101,54
43581,96,60,2015,26,12,14
43582,96,142,2015,11,1,10
43583,96,50,2015,519,216,303
43584,96,131,2015,4,3,1
43585,96,114,2015,313,152,161
43586,96,171,2015,1,1,0
43587,54,51,2015,173,97,76
43588,54,141,2015,56,29,27
43589,54,103,2015,200,124,76
43590,54,66,2015,5148,2550,2598
43591,54,29,2015,94,78,16
43592,54,67,2015,375,199,176
43593,54,53,2015,404874,213933,190941
43594,54,105,2015,193,126,67
43595,54,30,2015,305,207,98
43596,54,106,2015,126,77,49
43597,54,172,2015,446,227,219
43598,54,107,2015,45,29,16
43599,54,31,2015,949,697,252
43600,54,39,2015,102,50,52
43601,54,142,2015,247,134,113
43602,54,40,2015,20,13,7
43603,54,42,2015,39,25,14
43604,54,68,2015,1760,918,842
43605,54,69,2015,33774,16864,16910
43606,54,56,2015,147,76,71
43607,54,32,2015,1044,714,330
43608,54,5,2015,67,26,41
43609,54,6,2015,48,21,27
43610,54,16,2015,82,18,64
43611,54,44,2015,53,28,25
43612,54,17,2015,55,18,37
43613,54,57,2015,3140,1536,1604
43614,54,177,2015,56,42,14
43615,54,18,2015,68,8,60
43616,54,167,2015,67,54,13
43617,54,46,2015,27,24,3
43618,54,20,2015,65,15,50
43619,54,143,2015,150,73,77
43620,54,47,2015,26,21,5
43621,54,71,2015,31,19,12
43622,54,100,2015,39,23,16
43623,54,59,2015,6181,3295,2886
43624,54,144,2015,29,18,11
43625,54,73,2015,809,431,378
43626,54,162,2015,29,12,17
43627,54,60,2015,10055,5143,4912
43628,54,48,2015,113,56,57
43629,54,112,2015,86,53,33
43630,54,33,2015,737,589,148
43631,54,61,2015,50,23,27
43632,54,35,2015,499,331,168
43633,54,36,2015,1311,1068,243
43634,54,63,2015,51185,29811,21374
43635,54,37,2015,644,498,146
43636,54,64,2015,19587,12435,7152
43637,54,115,2015,203,109,94
43638,54,65,2015,188,108,80
43639,54,145,2015,66,17,49
43640,54,49,2015,628,332,296
43641,54,74,2015,3009,1486,1523
43642,54,25,2015,180,23,157
43643,54,26,2015,86,34,52
43644,54,38,2015,758,596,162
43645,54,50,2015,670,312,358
43646,54,132,2015,46,19,27
43647,81,51,2015,1,0,1
43648,81,141,2015,13,8,5
43649,81,134,2015,44,27,17
43650,81,103,2015,58,37,21
43651,81,30,2015,27,21,6
43652,81,106,2015,92,38,54
43653,81,172,2015,76,27,49
43654,81,107,2015,65,35,30
43655,81,31,2015,44,31,13
43656,81,83,2015,27,21,6
43657,81,108,2015,53,31,22
43658,81,68,2015,90,43,47
43659,81,69,2015,155,83,72
43660,81,84,2015,0,0,0
43661,81,98,2015,27,15,12
43662,81,85,2015,126,58,68
43663,81,32,2015,16,9,7
43664,81,57,2015,337,127,210
43665,81,86,2015,71,40,31
43666,81,20,2015,14,4,10
43667,81,100,2015,161,88,73
43668,81,101,2015,109,69,40
43669,81,102,2015,21,15,6
43670,81,112,2015,52,30,22
43671,81,33,2015,21,16,5
43672,81,88,2015,21,14,7
43673,81,35,2015,66,47,19
43674,81,36,2015,593,428,165
43675,81,65,2015,999,544,455
43676,81,38,2015,212,157,55
43677,81,50,2015,37,20,17
43678,14,2,2015,7,1,6
43679,14,51,2015,266,113,153
43680,14,141,2015,34,16,18
43681,14,103,2015,80,34,46
43682,14,11,2015,1130,539,591
43683,14,66,2015,340,197,143
43684,14,12,2015,34,20,14
43685,14,13,2015,103,46,57
43686,14,3,2015,626,11,615
43687,14,29,2015,326,255,71
43688,14,67,2015,250,133,117
43689,14,151,2015,7,0,7
43690,14,53,2015,64,34,30
43691,14,147,2015,7,2,5
43692,14,105,2015,55,34,21
43693,14,30,2015,5930,4186,1744
43694,14,116,2015,2,0,2
43695,14,135,2015,54,24,30
43696,14,106,2015,45,27,18
43697,14,172,2015,1541,788,753
43698,14,107,2015,120,90,30
43699,14,96,2015,2,2,0
43700,14,54,2015,80,46,34
43701,14,81,2015,34,16,18
43702,14,31,2015,649,430,219
43703,14,176,2015,31,20,11
43704,14,137,2015,657,361,296
43705,14,39,2015,161,93,68
43706,14,118,2015,2,2,0
43707,14,83,2015,9,7,2
43708,14,108,2015,7,2,5
43709,14,142,2015,4995,2096,2899
43710,14,97,2015,9,2,7
43711,14,119,2015,2,2,0
43712,14,40,2015,26,20,6
43713,14,120,2015,77,46,31
43714,14,42,2015,474,357,117
43715,14,68,2015,881,530,351
43716,14,15,2015,14727,6990,7737
43717,14,69,2015,2501,1432,1069
43718,14,156,2015,80,38,42
43719,14,55,2015,2,0,2
43720,14,56,2015,22844,10108,12736
43721,14,85,2015,2,2,0
43722,14,99,2015,2,0,2
43723,14,32,2015,332,202,130
43724,14,43,2015,31,24,7
43725,14,5,2015,2648,1096,1552
43726,14,6,2015,1158,446,712
43727,14,16,2015,1234,561,673
43728,14,44,2015,747,500,247
43729,14,17,2015,368,166,202
43730,14,57,2015,463,239,224
43731,14,86,2015,13,7,6
43732,14,177,2015,80,46,34
43733,14,18,2015,425,158,267
43734,14,167,2015,227,140,87
43735,14,121,2015,80,38,42
43736,14,19,2015,223,96,127
43737,14,168,2015,22,11,11
43738,14,46,2015,157,113,44
43739,14,20,2015,2651,1211,1440
43740,14,143,2015,219,93,126
43741,14,47,2015,89,71,18
43742,14,71,2015,9,7,2
43743,14,122,2015,7,2,5
43744,14,123,2015,7,2,5
43745,14,58,2015,31,11,20
43746,14,124,2015,9,2,7
43747,14,100,2015,59,38,21
43748,14,144,2015,59,27,32
43749,14,125,2015,9,7,2
43750,14,150,2015,2,0,2
43751,14,8,2015,54,7,47
43752,14,73,2015,463,276,187
43753,14,101,2015,9,2,7
43754,14,162,2015,292,129,163
43755,14,60,2015,18,11,7
43756,14,48,2015,191,124,67
43757,14,21,2015,59,24,35
43758,14,9,2015,499,34,465
43759,14,102,2015,18,2,16
43760,14,111,2015,7,7,0
43761,14,112,2015,31,20,11
43762,14,33,2015,680,516,164
43763,14,61,2015,59,43,16
43764,14,88,2015,2,0,2
43765,14,22,2015,9,2,7
43766,14,35,2015,5209,3747,1462
43767,14,36,2015,12530,7431,5099
43768,14,23,2015,223,103,120
43769,14,164,2015,7,2,5
43770,14,63,2015,2439,1328,1111
43771,14,127,2015,7,2,5
43772,14,165,2015,2,0,2
43773,14,37,2015,131,81,50
43774,14,64,2015,13,7,6
43775,14,128,2015,9,2,7
43776,14,115,2015,4784,2641,2143
43777,14,65,2015,149,108,41
43778,14,10,2015,9514,7720,1794
43779,14,145,2015,499,255,244
43780,14,113,2015,2,2,0
43781,14,49,2015,878,582,296
43782,14,74,2015,362,236,126
43783,14,25,2015,6949,3244,3705
43784,14,169,2015,7,2,5
43785,14,93,2015,13,11,2
43786,14,146,2015,34,11,23
43787,14,26,2015,587,313,274
43788,14,170,2015,9,7,2
43789,14,130,2015,18,2,16
43790,14,38,2015,3156,2144,1012
43791,14,27,2015,145,58,87
43792,14,50,2015,34762,19142,15620
43793,14,131,2015,138,71,67
43794,14,114,2015,2,2,0
43795,14,171,2015,69,38,31
43796,14,1,2015,59,51,8
43797,14,28,2015,13,7,6
43798,14,132,2015,131,85,46
43799,14,133,2015,292,173,119
43800,31,2,2015,418,150,268
43801,31,51,2015,309,100,209
43802,31,141,2015,686,103,583
43803,31,52,2015,0,0,0
43804,31,134,2015,168,28,140
43805,31,76,2015,0,0,0
43806,31,103,2015,199,83,116
43807,31,11,2015,1865,847,1018
43808,31,77,2015,0,0,0
43809,31,66,2015,2618,408,2210
43810,31,12,2015,1142,479,663
43811,31,78,2015,2,1,1
43812,31,13,2015,14,5,9
43813,31,3,2015,183,23,160
43814,31,79,2015,1,0,1
43815,31,29,2015,4097,2387,1710
43816,31,67,2015,613,145,468
43817,31,95,2015,0,0,0
43818,31,151,2015,43,12,31
43819,31,4,2015,2,1,1
43820,31,53,2015,2504,843,1661
43821,31,147,2015,97,35,62
43822,31,105,2015,462,182,280
43823,31,30,2015,9276,3455,5821
43824,31,152,2015,17,6,11
43825,31,116,2015,5,2,3
43826,31,153,2015,11,3,8
43827,31,135,2015,99,16,83
43828,31,80,2015,1,0,1
43829,31,136,2015,6,1,5
43830,31,106,2015,122,47,75
43831,31,172,2015,4807,2276,2531
43832,31,173,2015,0,0,0
43833,31,107,2015,250,116,134
43834,31,117,2015,0,0,0
43835,31,137,2015,62,20,42
43836,31,96,2015,54,22,32
43837,31,54,2015,1632,509,1123
43838,31,81,2015,431,143,288
43839,31,14,2015,106,22,84
43840,31,176,2015,13,5,8
43841,31,137,2015,88,35,53
43842,31,39,2015,308,79,229
43843,31,118,2015,3,2,1
43844,31,82,2015,2,0,2
43845,31,83,2015,58,26,32
43846,31,108,2015,93,36,57
43847,31,142,2015,728,74,654
43848,31,97,2015,26,8,18
43849,31,138,2015,0,0,0
43850,31,119,2015,9,3,6
43851,31,40,2015,175,103,72
43852,31,148,2015,0,0,0
43853,31,120,2015,105,33,72
43854,31,42,2015,298,126,172
43855,31,68,2015,2791,814,1977
43856,31,139,2015,3,0,3
43857,31,155,2015,16,2,14
43858,31,15,2015,1070,454,616
43859,31,69,2015,15567,2812,12755
43860,31,156,2015,197,34,163
43861,31,55,2015,3,2,1
43862,31,56,2015,724,212,512
43863,31,84,2015,1,0,1
43864,31,98,2015,35,17,18
43865,31,157,2015,78,20,58
43866,31,158,2015,21,3,18
43867,31,110,2015,5,0,5
43868,31,85,2015,7,3,4
43869,31,99,2015,21,9,12
43870,31,32,2015,1202,494,708
43871,31,43,2015,30,8,22
43872,31,5,2015,1707,465,1242
43873,31,6,2015,502,180,322
43874,31,16,2015,519,164,355
43875,31,44,2015,584,128,456
43876,31,17,2015,510,146,364
43877,31,57,2015,3364,484,2880
43878,31,86,2015,22,8,14
43879,31,177,2015,1519,752,767
43880,31,18,2015,169,35,134
43881,31,167,2015,6563,3194,3369
43882,31,121,2015,93,29,64
43883,31,19,2015,103,24,79
43884,31,168,2015,810,410,400
43885,31,46,2015,450,241,209
43886,31,20,2015,345,71,274
43887,31,149,2015,2,0,2
43888,31,159,2015,10,2,8
43889,31,143,2015,188,43,145
43890,31,70,2015,1,0,1
43891,31,47,2015,610,326,284
43892,31,71,2015,22,6,16
43893,31,122,2015,24,9,15
43894,31,123,2015,5,0,5
43895,31,7,2015,2,0,2
43896,31,160,2015,27,8,19
43897,31,58,2015,22,7,15
43898,31,161,2015,7,0,7
43899,31,124,2015,32,12,20
43900,31,100,2015,432,161,271
43901,31,72,2015,6,1,5
43902,31,59,2015,91,35,56
43903,31,144,2015,303,50,253
43904,31,125,2015,12,2,10
43905,31,150,2015,24,10,14
43906,31,8,2015,182,48,134
43907,31,73,2015,2593,754,1839
43908,31,101,2015,13,4,9
43909,31,162,2015,604,90,514
43910,31,60,2015,1925,471,1454
43911,31,48,2015,168,44,124
43912,31,21,2015,2,1,1
43913,31,9,2015,533,121,412
43914,31,102,2015,44,13,31
43915,31,111,2015,27,7,20
43916,31,112,2015,234,85,149
43917,31,33,2015,18796,9293,9503
43918,31,61,2015,310,90,220
43919,31,22,2015,4,2,2
43920,31,35,2015,5446,1768,3678
43921,31,36,2015,32735,18129,14606
43922,31,126,2015,8,2,6
43923,31,90,2015,0,0,0
43924,31,91,2015,7,3,4
43925,31,92,2015,1,0,1
43926,31,62,2015,1,1,0
43927,31,140,2015,2,0,2
43928,31,23,2015,208,47,161
43929,31,164,2015,59,3,56
43930,31,63,2015,1534,514,1020
43931,31,127,2015,3,2,1
43932,31,165,2015,16,2,14
43933,31,37,2015,89301,40791,48510
43934,31,64,2015,337,112,225
43935,31,128,2015,28,13,15
43936,31,115,2015,338,134,204
43937,31,65,2015,962,281,681
43938,31,10,2015,135,28,107
43939,31,145,2015,58,10,48
43940,31,113,2015,7,4,3
43941,31,49,2015,464,139,325
43942,31,74,2015,518,148,370
43943,31,25,2015,922,288,634
43944,31,169,2015,255,100,155
43945,31,166,2015,14,4,10
43946,31,93,2015,7,3,4
43947,31,146,2015,776,50,726
43948,31,26,2015,1617,415,1202
43949,31,170,2015,162,94,68
43950,31,130,2015,35,16,19
43951,31,38,2015,100664,45141,55523
43952,31,27,2015,67,17,50
43953,31,50,2015,4851,988,3863
43954,31,131,2015,20,6,14
43955,31,114,2015,31,10,21
43956,31,171,2015,2166,698,1468
43957,31,1,2015,45525,19259,26266
43958,31,28,2015,158,58,100
43959,31,132,2015,62,17,45
43960,31,133,2015,60,24,36
43961,39,2,2015,12293,5476,6817
43962,39,51,2015,347,185,162
43963,39,141,2015,913,362,551
43964,39,52,2015,2,1,1
43965,39,134,2015,164,83,81
43966,39,76,2015,3,2,1
43967,39,103,2015,1259,620,639
43968,39,11,2015,677,373,304
43969,39,77,2015,0,0,0
43970,39,66,2015,1815,940,875
43971,39,12,2015,314,181,133
43972,39,78,2015,17,11,6
43973,39,13,2015,95,45,50
43974,39,3,2015,1320,583,737
43975,39,79,2015,42,14,28
43976,39,29,2015,696,475,221
43977,39,67,2015,1974,962,1012
43978,39,95,2015,8,5,3
43979,39,151,2015,52,24,28
43980,39,4,2015,642,310,332
43981,39,53,2015,17162,8623,8539
43982,39,147,2015,63,39,24
43983,39,105,2015,3352,2231,1121
43984,39,30,2015,7183,3076,4107
43985,39,152,2015,106,47,59
43986,39,116,2015,511,297,214
43987,39,153,2015,31,15,16
43988,39,135,2015,717,279,438
43989,39,136,2015,17,7,10
43990,39,106,2015,1520,778,742
43991,39,172,2015,11988,7548,4440
43992,39,173,2015,0,0,0
43993,39,174,2015,0,0,0
43994,39,107,2015,3397,1630,1767
43995,39,117,2015,14,9,5
43996,39,137,2015,594,311,283
43997,39,96,2015,164,68,96
43998,39,54,2015,1098,536,562
43999,39,81,2015,489,276,213
44000,39,14,2015,207,111,96
44001,39,31,2015,1288,709,579
44002,39,176,2015,375,202,173
44003,39,137,2015,1254,621,633
44004,39,118,2015,20,12,8
44005,39,82,2015,13,8,5
44006,39,83,2015,158,103,55
44007,39,108,2015,592,335,257
44008,39,142,2015,1731,571,1160
44009,39,97,2015,82,48,34
44010,39,138,2015,6,3,3
44011,39,119,2015,3389,1356,2033
44012,39,40,2015,1461,995,466
44013,39,148,2015,51,21,30
44014,39,120,2015,2091,893,1198
44015,39,41,2015,11472,6730,4742
44016,39,42,2015,3677,2557,1120
44017,39,68,2015,6673,3024,3649
44018,39,109,2015,0,0,0
44019,39,139,2015,7,5,2
44020,39,155,2015,643,294,349
44021,39,15,2015,208,123,85
44022,39,69,2015,34299,17657,16642
44023,39,156,2015,1917,826,1091
44024,39,56,2015,2540,947,1593
44025,39,84,2015,14,7,7
44026,39,98,2015,236,118,118
44027,39,157,2015,124,47,77
44028,39,158,2015,76,22,54
44029,39,110,2015,99,68,31
44030,39,85,2015,144,59,85
44031,39,99,2015,128,76,52
44032,39,32,2015,4550,2308,2242
44033,39,43,2015,7620,4066,3554
44034,39,5,2015,10006,4943,5063
44035,39,6,2015,14600,6198,8402
44036,39,16,2015,20879,9449,11430
44037,39,44,2015,1602,642,960
44038,39,17,2015,1624,605,1019
44039,39,57,2015,7213,2529,4684
44040,39,86,2015,164,88,76
44041,39,177,2015,1734,1162,572
44042,39,18,2015,1204,527,677
44043,39,167,2015,209,142,67
44044,39,121,2015,1640,964,676
44045,39,19,2015,1334,565,769
44046,39,168,2015,53,38,15
44047,39,46,2015,4518,2512,2006
44048,39,20,2015,12321,5661,6660
44049,39,149,2015,44,29,15
44050,39,159,2015,158,89,69
44051,39,143,2015,248,95,153
44052,39,70,2015,19,13,6
44053,39,47,2015,9640,4783,4857
44054,39,71,2015,497,246,251
44055,39,122,2015,57,32,25
44056,39,123,2015,82,42,40
44057,39,7,2015,0,0,0
44058,39,160,2015,48,21,27
44059,39,58,2015,103,36,67
44060,39,161,2015,26,13,13
44061,39,124,2015,142,76,66
44062,39,100,2015,1182,643,539
44063,39,72,2015,17,6,11
44064,39,59,2015,228,122,106
44065,39,144,2015,5393,2654,2739
44066,39,125,2015,217,136,81
44067,39,150,2015,73,46,27
44068,39,8,2015,2644,1141,1503
44069,39,73,2015,6830,2931,3899
44070,39,101,2015,198,116,82
44071,39,162,2015,1434,586,848
44072,39,60,2015,3061,1419,1642
44073,39,48,2015,19189,11775,7414
44074,39,21,2015,33,15,18
44075,39,9,2015,13144,6065,7079
44076,39,102,2015,87,54,33
44077,39,111,2015,80,44,36
44078,39,112,2015,1044,689,355
44079,39,33,2015,34569,16805,17764
44080,39,61,2015,1927,843,1084
44081,39,88,2015,0,0,0
44082,39,22,2015,109,64,45
44083,39,35,2015,18745,8164,10581
44084,39,36,2015,5872,4084,1788
44085,39,126,2015,371,209,162
44086,39,90,2015,2,1,1
44087,39,91,2015,11,6,5
44088,39,92,2015,4,2,2
44089,39,62,2015,3,1,2
44090,39,140,2015,0,0,0
44091,39,23,2015,306,142,164
44092,39,164,2015,177,74,103
44093,39,63,2015,2637,1275,1362
44094,39,127,2015,21,12,9
44095,39,165,2015,327,168,159
44096,39,37,2015,1789,899,890
44097,39,64,2015,341,180,161
44098,39,128,2015,11007,5208,5799
44099,39,115,2015,1866,870,996
44100,39,129,2015,2,2,0
44101,39,65,2015,6173,2988,3185
44102,39,10,2015,7767,3935,3832
44103,39,145,2015,729,295,434
44104,39,113,2015,31,13,18
44105,39,49,2015,21806,12392,9414
44106,39,74,2015,2613,1271,1342
44107,39,25,2015,13813,5130,8683
44108,39,169,2015,28,20,8
44109,39,166,2015,140,51,89
44110,39,93,2015,161,94,67
44111,39,146,2015,880,296,584
44112,39,26,2015,31881,15309,16572
44113,39,170,2015,18,15,3
44114,39,130,2015,1485,917,568
44115,39,38,2015,7464,3804,3660
44116,39,27,2015,399,191,208
44117,39,50,2015,17830,6905,10925
44118,39,131,2015,1010,592,418
44119,39,114,2015,231,116,115
44120,39,171,2015,297,158,139
44121,39,1,2015,9781,5357,4424
44122,39,28,2015,170,86,84
44123,39,132,2015,594,380,214
44124,39,133,2015,396,216,180
44125,118,120,2015,11676,6491,5185
44126,118,128,2015,88152,40794,47358
44127,118,28,2015,6157,3183,2974
44128,82,76,2015,442,230,212
44129,82,78,2015,12,7,5
44130,82,79,2015,167,76,91
44131,82,172,2015,38,13,25
44132,82,81,2015,12,9,3
44133,82,68,2015,80,27,53
44134,82,109,2015,23,17,6
44135,82,69,2015,30,17,13
44136,82,110,2015,190,85,105
44137,82,85,2015,2453,1226,1227
44138,82,5,2015,28,12,16
44139,82,86,2015,129,85,44
44140,82,20,2015,34,7,27
44141,82,87,2015,162,76,86
44142,82,73,2015,10,5,5
44143,82,77,2015,47,30,17
44144,82,162,2015,50,30,20
44145,82,88,2015,16,1,15
44146,82,90,2015,63,37,26
44147,82,75,2015,19,5,14
44148,82,91,2015,281,139,142
44149,82,92,2015,125,55,70
44150,82,113,2015,19,7,12
44151,82,25,2015,16,5,11
44152,82,93,2015,306,123,183
44153,82,50,2015,633,304,329
44154,83,76,2015,179,84,95
44155,83,103,2015,1071,471,600
44156,83,66,2015,207,74,133
44157,83,78,2015,39,9,30
44158,83,13,2015,21,3,18
44159,83,67,2015,256,99,157
44160,83,4,2015,8,0,8
44161,83,53,2015,5,0,5
44162,83,105,2015,644,325,319
44163,83,30,2015,73,30,43
44164,83,116,2015,3,3,0
44165,83,135,2015,23,11,12
44166,83,153,2015,3,3,0
44167,83,136,2015,3,0,3
44168,83,106,2015,633,280,353
44169,83,172,2015,3776,1328,2448
44170,83,107,2015,2838,1392,1446
44171,83,96,2015,307,143,164
44172,83,81,2015,3259,1356,1903
44173,83,31,2015,29,13,16
44174,83,39,2015,25,9,16
44175,83,82,2015,14,8,6
44176,83,108,2015,581,283,298
44177,83,97,2015,267,140,127
44178,83,42,2015,27,16,11
44179,83,68,2015,3731,1109,2622
44180,83,69,2015,1857,687,1170
44181,83,56,2015,63,17,46
44182,83,98,2015,428,197,231
44183,83,110,2015,23,6,17
44184,83,85,2015,475084,164618,310466
44185,83,99,2015,424,220,204
44186,83,32,2015,21,6,15
44187,83,5,2015,94,24,70
44188,83,6,2015,30,6,24
44189,83,16,2015,27,8,19
44190,83,44,2015,32,12,20
44191,83,17,2015,61,17,44
44192,83,57,2015,4192,1072,3120
44193,83,86,2015,132,35,97
44194,83,177,2015,345,171,174
44195,83,167,2015,10,5,5
44196,83,20,2015,149,48,101
44197,83,58,2015,25,11,14
44198,83,100,2015,1497,717,780
44199,83,144,2015,33,8,25
44200,83,73,2015,593,209,384
44201,83,77,2015,160,62,98
44202,83,101,2015,292,165,127
44203,83,162,2015,25,5,20
44204,83,48,2015,54,23,31
44205,83,9,2015,79,20,59
44206,83,102,2015,756,363,393
44207,83,111,2015,25,11,14
44208,83,112,2015,1428,558,870
44209,83,33,2015,44,14,30
44210,83,61,2015,106,42,64
44211,83,88,2015,4578,2026,2552
44212,83,35,2015,43,24,19
44213,83,36,2015,482,284,198
44214,83,90,2015,137,54,83
44215,83,75,2015,33,12,21
44216,83,23,2015,17,3,14
44217,83,63,2015,72,40,32
44218,83,115,2015,10,7,3
44219,83,65,2015,6967,2618,4349
44220,83,113,2015,27,10,17
44221,83,49,2015,73,30,43
44222,83,74,2015,1044,354,690
44223,83,25,2015,25,9,16
44224,83,93,2015,23,9,14
44225,83,26,2015,30,9,21
44226,83,94,2015,34,20,14
44227,83,38,2015,75,50,25
44228,83,60,2015,26,10,16
44229,83,50,2015,482,226,256
44230,83,114,2015,182,89,93
44231,108,2,2015,112,53,59
44232,108,51,2015,71,33,38
44233,108,141,2015,48,11,37
44234,108,134,2015,42,26,16
44235,108,103,2015,5399,2250,3149
44236,108,66,2015,546,240,306
44237,108,78,2015,48,20,28
44238,108,11,2015,37,19,18
44239,108,67,2015,855,423,432
44240,108,105,2015,2654,1442,1212
44241,108,30,2015,194,106,88
44242,108,135,2015,45,13,32
44243,108,106,2015,11341,5193,6148
44244,108,172,2015,2928,1193,1735
44245,108,107,2015,194721,96870,97851
44246,108,96,2015,938,508,430
44247,108,54,2015,81,27,54
44248,108,81,2015,2994,1352,1642
44249,108,31,2015,315,86,229
44250,108,39,2015,183,57,126
44251,108,83,2015,353,199,154
44252,108,97,2015,522,276,246
44253,108,42,2015,126,79,47
44254,108,68,2015,2264,1130,1134
44255,108,155,2015,33,5,28
44256,108,69,2015,4405,2232,2173
44257,108,156,2015,37,11,26
44258,108,56,2015,71,13,58
44259,108,98,2015,430,224,206
44260,108,85,2015,96,27,69
44261,108,99,2015,469,260,209
44262,108,173,2015,97,41,56
44263,108,32,2015,216,133,83
44264,108,5,2015,228,74,154
44265,108,6,2015,192,55,137
44266,108,16,2015,36,17,19
44267,108,44,2015,199,84,115
44268,108,17,2015,520,202,318
44269,108,57,2015,3845,1582,2263
44270,108,86,2015,37,20,17
44271,108,177,2015,734,312,422
44272,108,18,2015,71,13,58
44273,108,176,2015,485,221,264
44274,108,20,2015,443,158,285
44275,108,100,2015,2258,1230,1028
44276,108,144,2015,48,19,29
44277,108,73,2015,829,370,459
44278,108,101,2015,392,194,198
44279,108,162,2015,25,11,14
44280,108,48,2015,235,121,114
44281,108,9,2015,29,13,16
44282,108,102,2015,964,474,490
44283,108,111,2015,242,114,128
44284,108,112,2015,13705,5660,8045
44285,108,33,2015,312,158,154
44286,108,61,2015,366,137,229
44287,108,88,2015,500,246,254
44288,108,35,2015,302,169,133
44289,108,36,2015,1495,962,533
44290,108,23,2015,88,33,55
44291,108,37,2015,49,26,23
44292,108,1,2015,48,20,28
44293,108,115,2015,122,35,87
44294,108,65,2015,7473,3706,3767
44295,108,49,2015,349,165,184
44296,108,74,2015,1962,672,1290
44297,108,25,2015,64,19,45
44298,108,93,2015,45,26,19
44299,108,38,2015,401,228,173
44300,108,60,2015,1,1,0
44301,108,142,2015,84,26,58
44302,108,50,2015,2158,1024,1134
44303,108,114,2015,958,360,598
44304,142,2,2015,135,27,108
44305,142,51,2015,77,26,51
44306,142,141,2015,569,324,245
44307,142,134,2015,19,8,11
44308,142,76,2015,11,5,6
44309,142,12,2015,21,0,21
44310,142,103,2015,161,55,106
44311,142,66,2015,389,188,201
44312,142,78,2015,10,7,3
44313,142,13,2015,259,115,144
44314,142,3,2015,164,17,147
44315,142,11,2015,103,55,48
44316,142,67,2015,362,159,203
44317,142,53,2015,40,17,23
44318,142,105,2015,85,43,42
44319,142,30,2015,45,22,23
44320,142,116,2015,24,1,23
44321,142,29,2015,180,90,90
44322,142,135,2015,82,11,71
44323,142,10,2015,144,54,90
44324,142,136,2015,215,67,148
44325,142,106,2015,18,7,11
44326,142,172,2015,495,139,356
44327,142,107,2015,37,8,29
44328,142,117,2015,585,92,493
44329,142,137,2015,48,13,35
44330,142,137,2015,85,26,59
44331,142,54,2015,66,13,53
44332,142,14,2015,56,22,34
44333,142,31,2015,130,64,66
44334,142,151,2015,24,0,24
44335,142,39,2015,194,83,111
44336,142,108,2015,8,5,3
44337,142,97,2015,137,66,71
44338,142,120,2015,6931,3464,3467
44339,142,119,2015,3836,1918,1918
44340,142,40,2015,17,7,10
44341,142,42,2015,160,81,79
44342,142,68,2015,1838,749,1089
44343,142,118,2015,239,82,157
44344,142,155,2015,19,5,14
44345,142,69,2015,4970,1995,2975
44346,142,156,2015,151,32,119
44347,142,55,2015,6,1,5
44348,142,56,2015,822,411,411
44349,142,98,2015,6,2,4
44350,142,157,2015,93,7,86
44351,142,32,2015,86,44,42
44352,142,5,2015,800,253,547
44353,142,6,2015,97,35,62
44354,142,16,2015,12817,6343,6474
44355,142,44,2015,61,32,29
44356,142,17,2015,456,159,297
44357,142,57,2015,2691,1105,1586
44358,142,177,2015,742,308,434
44359,142,167,2015,137,54,83
44360,142,18,2015,3375,1334,2041
44361,142,121,2015,89,25,64
44362,142,176,2015,66,23,43
44363,142,19,2015,1925,617,1308
44364,142,168,2015,40,8,32
44365,142,20,2015,2045,999,1046
44366,142,159,2015,31,11,20
44367,142,143,2015,3228,1248,1980
44368,142,122,2015,26,1,25
44369,142,123,2015,19,2,17
44370,142,7,2015,19,5,14
44371,142,160,2015,139,27,112
44372,142,161,2015,100,23,77
44373,142,100,2015,42,23,19
44374,142,72,2015,53,23,30
44375,142,144,2015,683,447,236
44376,142,125,2015,11,4,7
44377,142,21,2015,350,104,246
44378,142,150,2015,172,97,75
44379,142,73,2015,639,285,354
44380,142,162,2015,1945,465,1480
44381,142,48,2015,78,31,47
44382,142,9,2015,398,120,278
44383,142,33,2015,244,108,136
44384,142,61,2015,29,14,15
44385,142,158,2015,60,0,60
44386,142,22,2015,257,87,170
44387,142,35,2015,157,78,79
44388,142,36,2015,4820,2604,2216
44389,142,126,2015,29,5,24
44390,142,23,2015,5268,1677,3591
44391,142,164,2015,273,45,228
44392,142,127,2015,13,4,9
44393,142,165,2015,40,19,21
44394,142,37,2015,40,21,19
44395,142,128,2015,13110,4808,8302
44396,142,115,2015,144,54,90
44397,142,133,2015,22,4,18
44398,142,65,2015,267,112,155
44399,142,129,2015,5762,2395,3367
44400,142,145,2015,38410,15967,22443
44401,142,49,2015,228,88,140
44402,142,74,2015,878,362,516
44403,142,25,2015,104635,47301,57334
44404,142,169,2015,84,21,63
44405,142,27,2015,460,164,296
44406,142,146,2015,503,238,265
44407,142,26,2015,576,143,433
44408,142,170,2015,31,7,24
44409,142,130,2015,56,8,48
44410,142,38,2015,110,63,47
44411,142,60,2015,77,27,50
44412,142,50,2015,2023,817,1206
44413,142,131,2015,94,19,75
44414,142,152,2015,42,5,37
44415,142,171,2015,73,13,60
44416,142,28,2015,3666,1295,2371
44417,142,132,2015,17,5,12
44418,97,103,2015,216,84,132
44419,97,66,2015,11,6,5
44420,97,3,2015,6,0,6
44421,97,79,2015,40,20,20
44422,97,67,2015,52,26,26
44423,97,105,2015,242,128,114
44424,97,95,2015,339,178,161
44425,97,106,2015,229,114,115
44426,97,172,2015,259,99,160
44427,97,107,2015,577,295,282
44428,97,96,2015,876,471,405
44429,97,81,2015,128,57,71
44430,97,83,2015,72,32,40
44431,97,108,2015,123,65,58
44432,97,68,2015,214,85,129
44433,97,69,2015,227,99,128
44434,97,98,2015,8885,4732,4153
44435,97,99,2015,11676,6901,4775
44436,97,173,2015,8,4,4
44437,97,5,2015,11,4,7
44438,97,6,2015,18,6,12
44439,97,44,2015,11,5,6
44440,97,17,2015,43,24,19
44441,97,57,2015,282,101,181
44442,97,86,2015,10,4,6
44443,97,177,2015,54,17,37
44444,97,100,2015,1714,928,786
44445,97,73,2015,33,11,22
44446,97,101,2015,7823,3679,4144
44447,97,102,2015,451,245,206
44448,97,111,2015,11,4,7
44449,97,112,2015,234,96,138
44450,97,61,2015,13,3,10
44451,97,88,2015,62,27,35
44452,97,36,2015,18,10,8
44453,97,65,2015,534,230,304
44454,97,49,2015,35,12,23
44455,97,74,2015,59,34,25
44456,97,50,2015,90,36,54
44457,97,114,2015,75,25,50
44458,138,135,2015,798,263,535
44459,138,68,2015,4561,2440,2121
44460,138,139,2015,256,110,146
44461,138,162,2015,359,164,195
44462,138,140,2015,1493,578,915
44463,138,65,2015,1279,514,765
44464,119,134,2015,346,144,202
44465,119,116,2015,1044,485,559
44466,119,172,2015,135,13,122
44467,119,117,2015,192,91,101
44468,119,137,2015,1685,763,922
44469,119,120,2015,108,50,58
44470,119,68,2015,436,207,229
44471,119,5,2015,119,73,46
44472,119,121,2015,351,148,203
44473,119,123,2015,771,343,428
44474,119,125,2015,1105,649,456
44475,119,126,2015,467,247,220
44476,119,128,2015,2485,1189,1296
44477,119,115,2015,122,53,69
44478,119,133,2015,324,95,229
44479,119,129,2015,1487,516,971
44480,119,145,2015,208,72,136
44481,119,130,2015,1521,523,998
44482,119,50,2015,56,35,21
44483,119,131,2015,525,254,271
44484,119,132,2015,241,85,156
44485,40,2,2015,26,6,20
44486,40,51,2015,20,5,15
44487,40,141,2015,24,4,20
44488,40,52,2015,0,0,0
44489,40,134,2015,5,1,4
44490,40,76,2015,2,0,2
44491,40,103,2015,27,9,18
44492,40,11,2015,687,288,399
44493,40,66,2015,118,65,53
44494,40,12,2015,1484,628,856
44495,40,13,2015,2,2,0
44496,40,3,2015,35,3,32
44497,40,79,2015,1,0,1
44498,40,29,2015,11119,6810,4309
44499,40,67,2015,150,59,91
44500,40,95,2015,0,0,0
44501,40,151,2015,0,0,0
44502,40,4,2015,0,0,0
44503,40,53,2015,5,3,2
44504,40,105,2015,93,39,54
44505,40,30,2015,268,55,213
44506,40,153,2015,2,1,1
44507,40,135,2015,16,3,13
44508,40,106,2015,13,1,12
44509,40,172,2015,348,171,177
44510,40,173,2015,0,0,0
44511,40,107,2015,27,6,21
44512,40,137,2015,4,1,3
44513,40,96,2015,3,0,3
44514,40,54,2015,28,15,13
44515,40,81,2015,16,8,8
44516,40,14,2015,20,7,13
44517,40,31,2015,190,109,81
44518,40,176,2015,4,1,3
44519,40,137,2015,3,0,3
44520,40,39,2015,168,31,137
44521,40,83,2015,3,0,3
44522,40,108,2015,11,4,7
44523,40,142,2015,68,7,61
44524,40,97,2015,1,0,1
44525,40,120,2015,7,0,7
44526,40,41,2015,1,1,0
44527,40,42,2015,3870,1445,2425
44528,40,68,2015,536,214,322
44529,40,155,2015,2,0,2
44530,40,15,2015,1642,814,828
44531,40,69,2015,1823,853,970
44532,40,156,2015,12,4,8
44533,40,55,2015,1,1,0
44534,40,56,2015,77,27,50
44535,40,98,2015,10,4,6
44536,40,157,2015,1,0,1
44537,40,110,2015,2,2,0
44538,40,99,2015,2,0,2
44539,40,32,2015,201,105,96
44540,40,43,2015,22,3,19
44541,40,5,2015,318,66,252
44542,40,6,2015,75,19,56
44543,40,16,2015,12,2,10
44544,40,44,2015,87,28,59
44545,40,17,2015,65,30,35
44546,40,57,2015,626,190,436
44547,40,86,2015,2,1,1
44548,40,177,2015,85,37,48
44549,40,18,2015,10,1,9
44550,40,167,2015,3752,2131,1621
44551,40,121,2015,7,2,5
44552,40,19,2015,9,2,7
44553,40,168,2015,537,305,232
44554,40,46,2015,4703,2572,2131
44555,40,20,2015,18,2,16
44556,40,143,2015,5,2,3
44557,40,70,2015,1,0,1
44558,40,47,2015,2028,1175,853
44559,40,71,2015,11,6,5
44560,40,122,2015,1,1,0
44561,40,123,2015,1,0,1
44562,40,58,2015,4,1,3
44563,40,161,2015,2,2,0
44564,40,124,2015,4,3,1
44565,40,100,2015,65,27,38
44566,40,72,2015,0,0,0
44567,40,59,2015,0,0,0
44568,40,144,2015,25,4,21
44569,40,125,2015,2,1,1
44570,40,150,2015,1,0,1
44571,40,8,2015,41,2,39
44572,40,73,2015,201,52,149
44573,40,101,2015,2,1,1
44574,40,162,2015,118,19,99
44575,40,60,2015,9,2,7
44576,40,48,2015,203,63,140
44577,40,21,2015,0,0,0
44578,40,9,2015,72,9,63
44579,40,102,2015,1,1,0
44580,40,111,2015,1,1,0
44581,40,112,2015,20,8,12
44582,40,33,2015,790,374,416
44583,40,61,2015,138,37,101
44584,40,22,2015,1,0,1
44585,40,35,2015,369,55,314
44586,40,36,2015,129187,81782,47405
44587,40,126,2015,1,0,1
44588,40,90,2015,1,1,0
44589,40,23,2015,5,1,4
44590,40,164,2015,2,1,1
44591,40,63,2015,22,6,16
44592,40,165,2015,1,0,1
44593,40,37,2015,121,67,54
44594,40,64,2015,31,14,17
44595,40,128,2015,2,0,2
44596,40,115,2015,31,10,21
44597,40,65,2015,393,162,231
44598,40,10,2015,21,3,18
44599,40,145,2015,12,1,11
44600,40,113,2015,2,1,1
44601,40,49,2015,539,132,407
44602,40,74,2015,58,9,49
44603,40,25,2015,10,1,9
44604,40,169,2015,362,187,175
44605,40,166,2015,0,0,0
44606,40,93,2015,3,3,0
44607,40,146,2015,15,2,13
44608,40,26,2015,205,36,169
44609,40,170,2015,345,220,125
44610,40,130,2015,6,3,3
44611,40,38,2015,21770,11257,10513
44612,40,27,2015,7,0,7
44613,40,50,2015,654,182,472
44614,40,131,2015,4,1,3
44615,40,114,2015,5,2,3
44616,40,171,2015,1091,592,499
44617,40,1,2015,32,10,22
44618,40,28,2015,5,2,3
44619,40,132,2015,2,0,2
44620,40,133,2015,4,2,2
44621,148,134,2015,131,66,65
44622,148,147,2015,41,27,14
44623,148,116,2015,402,205,197
44624,148,137,2015,72,36,36
44625,148,137,2015,570,288,282
44626,148,120,2015,30,14,16
44627,148,149,2015,221,198,23
44628,148,159,2015,46,24,22
44629,148,125,2015,9857,3862,5995
44630,148,126,2015,342,172,170
44631,148,128,2015,181,85,96
44632,148,115,2015,12511,7590,4921
44633,148,130,2015,55,28,27
44634,120,116,2015,180,90,90
44635,120,137,2015,1581,783,798
44636,120,119,2015,205821,101881,103940
44637,120,118,2015,3702,1815,1887
44638,120,126,2015,150,74,76
44639,120,128,2015,442461,216865,225596
44640,120,129,2015,394801,185711,209090
44641,120,145,2015,39499,19508,19991
44642,120,130,2015,218,107,111
44643,120,28,2015,1324,648,676
44644,41,105,2015,11,7,4
44645,41,30,2015,13,3,10
44646,41,172,2015,30,22,8
44647,41,107,2015,30,15,15
44648,41,54,2015,22,9,13
44649,41,39,2015,3547,1644,1903
44650,41,120,2015,36,12,24
44651,41,69,2015,22,9,13
44652,41,156,2015,18,12,6
44653,41,43,2015,242,110,132
44654,41,5,2015,63,39,24
44655,41,121,2015,15,8,7
44656,41,47,2015,13,9,4
44657,41,48,2015,178,90,88
44658,41,112,2015,15,10,5
44659,41,33,2015,72,20,52
44660,41,35,2015,62,30,32
44661,41,36,2015,30,22,8
44662,41,63,2015,51,24,27
44663,41,115,2015,20,9,11
44664,41,49,2015,76,31,45
44665,41,146,2015,11,3,8
44666,41,50,2015,100,52,48
44667,42,2,2015,4623,2102,2521
44668,42,51,2015,336,86,250
44669,42,141,2015,781,166,615
44670,42,52,2015,1,0,1
44671,42,134,2015,412,167,245
44672,42,76,2015,1,1,0
44673,42,103,2015,369,149,220
44674,42,11,2015,89,51,38
44675,42,77,2015,3,1,2
44676,42,66,2015,567,260,307
44677,42,12,2015,119,67,52
44678,42,78,2015,8,3,5
44679,42,13,2015,20,4,16
44680,42,3,2015,1885,607,1278
44681,42,79,2015,10,1,9
44682,42,29,2015,314,195,119
44683,42,67,2015,567,196,371
44684,42,95,2015,1,0,1
44685,42,151,2015,18,4,14
44686,42,4,2015,3,2,1
44687,42,53,2015,652,318,334
44688,42,147,2015,15,6,9
44689,42,105,2015,1221,725,496
44690,42,30,2015,1863,863,1000
44691,42,152,2015,15,2,13
44692,42,116,2015,51,24,27
44693,42,153,2015,11,3,8
44694,42,135,2015,759,282,477
44695,42,136,2015,7,2,5
44696,42,106,2015,408,205,203
44697,42,172,2015,9069,5369,3700
44698,42,107,2015,985,482,503
44699,42,117,2015,3,1,2
44700,42,137,2015,114,52,62
44701,42,96,2015,61,20,41
44702,42,54,2015,213,100,113
44703,42,81,2015,445,174,271
44704,42,14,2015,157,45,112
44705,42,31,2015,204,111,93
44706,42,176,2015,4,3,1
44707,42,137,2015,1465,790,675
44708,42,39,2015,923,361,562
44709,42,118,2015,7,4,3
44710,42,82,2015,5,0,5
44711,42,83,2015,157,72,85
44712,42,108,2015,180,79,101
44713,42,142,2015,1058,222,836
44714,42,97,2015,60,37,23
44715,42,138,2015,14,8,6
44716,42,119,2015,128,48,80
44717,42,40,2015,41006,21153,19853
44718,42,148,2015,14,6,8
44719,42,120,2015,1845,805,1040
44720,42,68,2015,2268,839,1429
44721,42,139,2015,10,6,4
44722,42,155,2015,648,132,516
44723,42,15,2015,67,34,33
44724,42,69,2015,6224,2739,3485
44725,42,156,2015,1334,422,912
44726,42,56,2015,1110,344,766
44727,42,84,2015,1,0,1
44728,42,98,2015,71,27,44
44729,42,157,2015,85,17,68
44730,42,158,2015,7,1,6
44731,42,110,2015,19,9,10
44732,42,85,2015,10,3,7
44733,42,99,2015,59,34,25
44734,42,32,2015,2068,965,1103
44735,42,43,2015,152,56,96
44736,42,5,2015,5159,2055,3104
44737,42,6,2015,5589,2449,3140
44738,42,16,2015,21027,7852,13175
44739,42,44,2015,553,150,403
44740,42,17,2015,715,212,503
44741,42,57,2015,2316,700,1616
44742,42,86,2015,75,29,46
44743,42,177,2015,1204,744,460
44744,42,18,2015,268,100,168
44745,42,167,2015,246,146,100
44746,42,121,2015,1238,657,581
44747,42,19,2015,121,44,77
44748,42,168,2015,43,27,16
44749,42,46,2015,1582,887,695
44750,42,20,2015,521,198,323
44751,42,159,2015,102,36,66
44752,42,143,2015,192,68,124
44753,42,47,2015,968,548,420
44754,42,71,2015,92,49,43
44755,42,122,2015,14,9,5
44756,42,123,2015,50,21,29
44757,42,7,2015,2,1,1
44758,42,160,2015,14,4,10
44759,42,58,2015,39,16,23
44760,42,161,2015,22,4,18
44761,42,124,2015,45,20,25
44762,42,100,2015,719,310,409
44763,42,72,2015,7,2,5
44764,42,59,2015,4,2,2
44765,42,144,2015,1952,598,1354
44766,42,125,2015,65,33,32
44767,42,150,2015,90,54,36
44768,42,8,2015,2298,640,1658
44769,42,73,2015,1381,356,1025
44770,42,101,2015,99,55,44
44771,42,162,2015,2093,529,1564
44772,42,60,2015,157,82,75
44773,42,48,2015,1607,767,840
44774,42,21,2015,10,6,4
44775,42,9,2015,2129,660,1469
44776,42,102,2015,23,9,14
44777,42,111,2015,24,9,15
44778,42,112,2015,471,261,210
44779,42,33,2015,3983,1795,2188
44780,42,61,2015,521,169,352
44781,42,22,2015,16,4,12
44782,42,35,2015,2478,1133,1345
44783,42,36,2015,11542,6437,5105
44784,42,126,2015,436,218,218
44785,42,90,2015,1,0,1
44786,42,91,2015,4,1,3
44787,42,92,2015,2,0,2
44788,42,62,2015,1,1,0
44789,42,23,2015,315,151,164
44790,42,164,2015,168,28,140
44791,42,63,2015,149,68,81
44792,42,127,2015,6,5,1
44793,42,165,2015,125,33,92
44794,42,37,2015,180,85,95
44795,42,64,2015,50,24,26
44796,42,128,2015,9666,4640,5026
44797,42,115,2015,805,315,490
44798,42,129,2015,0,0,0
44799,42,65,2015,2567,1039,1528
44800,42,10,2015,908,412,496
44801,42,145,2015,872,403,469
44802,42,113,2015,1,0,1
44803,42,49,2015,30578,14783,15795
44804,42,74,2015,977,391,586
44805,42,25,2015,1326,534,792
44806,42,169,2015,42,18,24
44807,42,166,2015,75,17,58
44808,42,93,2015,35,17,18
44809,42,146,2015,625,124,501
44810,42,26,2015,6082,1813,4269
44811,42,170,2015,21,13,8
44812,42,94,2015,1,1,0
44813,42,130,2015,183,95,88
44814,42,38,2015,1540,854,686
44815,42,27,2015,137,56,81
44816,42,50,2015,5328,1495,3833
44817,42,131,2015,508,203,305
44818,42,114,2015,99,42,57
44819,42,171,2015,127,60,67
44820,42,1,2015,5754,3228,2526
44821,42,28,2015,63,25,38
44822,42,132,2015,184,103,81
44823,42,133,2015,88,30,58
44824,68,2,2015,6510,3335,3175
44825,68,51,2015,6967,3417,3550
44826,68,141,2015,1489151,701319,787832
44827,68,52,2015,1020,600,420
44828,68,134,2015,22153,11155,10998
44829,68,75,2015,10,3,7
44830,68,76,2015,63,49,14
44831,68,103,2015,13472,7996,5476
44832,68,11,2015,19860,11703,8157
44833,68,77,2015,11,7,4
44834,68,66,2015,10916,6634,4282
44835,68,12,2015,4278,2279,1999
44836,68,78,2015,46,29,17
44837,68,13,2015,166,95,71
44838,68,3,2015,7726,3958,3768
44839,68,79,2015,79,44,35
44840,68,29,2015,3537,2297,1240
44841,68,67,2015,153120,83400,69720
44842,68,95,2015,9,8,1
44843,68,151,2015,21245,10344,10901
44844,68,4,2015,149,76,73
44845,68,53,2015,14506,7822,6684
44846,68,147,2015,41,24,17
44847,68,105,2015,59744,38101,21643
44848,68,30,2015,26463,14523,11940
44849,68,152,2015,9096,4450,4646
44850,68,116,2015,1941,1143,798
44851,68,153,2015,23200,13402,9798
44852,68,135,2015,84591,53589,31002
44853,68,136,2015,7719,3588,4131
44854,68,106,2015,14988,8255,6733
44855,68,172,2015,114531,69820,44711
44856,68,173,2015,535,312,223
44857,68,174,2015,17,9,8
44858,68,107,2015,28340,16999,11341
44859,68,117,2015,38126,21083,17043
44860,68,137,2015,72306,36536,35770
44861,68,96,2015,782,461,321
44862,68,54,2015,9265,4732,4533
44863,68,81,2015,4974,3106,1868
44864,68,14,2015,1003,541,462
44865,68,31,2015,8998,5856,3142
44866,68,176,2015,63,39,24
44867,68,137,2015,79851,43770,36081
44868,68,39,2015,5792,3479,2313
44869,68,118,2015,6838,3471,3367
44870,68,82,2015,6704,4693,2011
44871,68,83,2015,3632,2542,1090
44872,68,108,2015,4304,2907,1397
44873,68,142,2015,32197,12238,19959
44874,68,97,2015,1158,728,430
44875,68,138,2015,404,244,160
44876,68,119,2015,3129,1602,1527
44877,68,40,2015,1203,796,407
44878,68,148,2015,21,15,6
44879,68,120,2015,9028,5942,3086
44880,68,41,2015,3,3,0
44881,68,42,2015,3813,2749,1064
44882,68,139,2015,20586,11535,9051
44883,68,155,2015,1982,1017,965
44884,68,15,2015,7891,4336,3555
44885,68,69,2015,208751,119421,89330
44886,68,156,2015,6968,3546,3422
44887,68,55,2015,72,53,19
44888,68,56,2015,13221,6764,6457
44889,68,98,2015,3115,1711,1404
44890,68,157,2015,31439,15044,16395
44891,68,158,2015,3189,1402,1787
44892,68,110,2015,4912,3063,1849
44893,68,85,2015,77368,45973,31395
44894,68,99,2015,609,378,231
44895,68,32,2015,11468,6367,5101
44896,68,43,2015,398,263,135
44897,68,5,2015,50020,27621,22399
44898,68,6,2015,23716,11585,12131
44899,68,16,2015,6369,2893,3476
44900,68,44,2015,9748,5259,4489
44901,68,45,2015,13,11,2
44902,68,17,2015,9571,5138,4433
44903,68,57,2015,324629,166918,157711
44904,68,86,2015,537,351,186
44905,68,177,2015,22247,16462,5785
44906,68,18,2015,1500,519,981
44907,68,167,2015,2687,1642,1045
44908,68,121,2015,1818,1315,503
44909,68,19,2015,762,322,440
44910,68,168,2015,749,543,206
44911,68,46,2015,3503,2029,1474
44912,68,20,2015,49084,21981,27103
44913,68,149,2015,50,20,30
44914,68,159,2015,816,342,474
44915,68,143,2015,2446,1224,1222
44916,68,70,2015,28,13,15
44917,68,47,2015,3463,2165,1298
44918,68,71,2015,16082,8416,7666
44919,68,122,2015,125308,79798,45510
44920,68,123,2015,110,59,51
44921,68,7,2015,6,2,4
44922,68,160,2015,78635,32420,46215
44923,68,58,2015,518,296,222
44924,68,161,2015,18491,6573,11918
44925,68,124,2015,46144,29178,16966
44926,68,100,2015,13092,8708,4384
44927,68,72,2015,25963,13768,12195
44928,68,59,2015,1459,745,714
44929,68,87,2015,6,5,1
44930,68,144,2015,964250,470887,493363
44931,68,125,2015,1341,784,557
44932,68,150,2015,178,103,75
44933,68,8,2015,1377,784,593
44934,68,73,2015,40496,21532,18964
44935,68,101,2015,672,461,211
44936,68,162,2015,6000,2881,3119
44937,68,60,2015,4670,2473,2197
44938,68,48,2015,4235,2929,1306
44939,68,21,2015,112,49,63
44940,68,9,2015,24748,9904,14844
44941,68,102,2015,530,329,201
44942,68,111,2015,1073,628,445
44943,68,112,2015,12158,7597,4561
44944,68,33,2015,100694,61897,38797
44945,68,61,2015,649325,317376,331949
44946,68,88,2015,53,28,25
44947,68,22,2015,153,88,65
44948,68,35,2015,117505,60373,57132
44949,68,36,2015,66601,44390,22211
44950,68,126,2015,6445,3705,2740
44951,68,90,2015,3,3,0
44952,68,91,2015,4942,3555,1387
44953,68,92,2015,29,22,7
44954,68,62,2015,228,119,109
44955,68,140,2015,232,144,88
44956,68,23,2015,2589,1247,1342
44957,68,164,2015,122676,55088,67588
44958,68,63,2015,88154,46231,41923
44959,68,127,2015,620,464,156
44960,68,165,2015,1352,746,606
44961,68,37,2015,5443,3382,2061
44962,68,64,2015,2574,1435,1139
44963,68,128,2015,3282,1681,1601
44964,68,115,2015,5390,3369,2021
44965,68,65,2015,286813,159424,127389
44966,68,10,2015,49814,24646,25168
44967,68,145,2015,8011,4104,3907
44968,68,113,2015,25376,15488,9888
44969,68,49,2015,9455,6165,3290
44970,68,74,2015,99151,60636,38515
44971,68,25,2015,17440,7606,9834
44972,68,169,2015,253,150,103
44973,68,166,2015,24730,12194,12536
44974,68,93,2015,427,320,107
44975,68,146,2015,404445,183910,220535
44976,68,26,2015,309559,150836,158723
44977,68,170,2015,218,129,89
44978,68,94,2015,8,3,5
44979,68,130,2015,603,371,232
44980,68,38,2015,16527,11653,4874
44981,68,27,2015,815,375,440
44982,68,50,2015,167087,84055,83032
44983,68,131,2015,669,404,265
44984,68,114,2015,2534,1450,1084
44985,68,171,2015,1146,692,454
44986,68,1,2015,130958,73970,56988
44987,68,28,2015,506,290,216
44988,68,132,2015,358,207,151
44989,68,133,2015,729,430,299
44990,109,141,2015,359,150,209
44991,109,67,2015,189,92,97
44992,109,105,2015,22921,10212,12709
44993,109,172,2015,1466,784,682
44994,109,82,2015,414,310,104
44995,109,68,2015,20934,9905,11029
44996,109,110,2015,3522,1922,1600
44997,109,85,2015,19651,11291,8360
44998,109,57,2015,160,62,98
44999,109,112,2015,584,287,297
45000,109,91,2015,785,444,341
45001,109,113,2015,23185,12265,10920
45002,139,141,2015,100,35,65
45003,139,134,2015,1011,344,667
45004,139,67,2015,457,172,285
45005,139,116,2015,153,51,102
45006,139,135,2015,46269,19364,26905
45007,139,136,2015,4132,1368,2764
45008,139,172,2015,316,76,240
45009,139,137,2015,14905,6638,8267
45010,139,137,2015,8135,3116,5019
45011,139,151,2015,47682,19613,28069
45012,139,138,2015,79434,33495,45939
45013,139,68,2015,14678,5305,9373
45014,139,69,2015,80,29,51
45015,139,156,2015,5811,712,5099
45016,139,157,2015,4546,988,3558
45017,139,17,2015,15,4,11
45018,139,177,2015,29,11,18
45019,139,176,2015,146,50,96
45020,139,20,2015,2284,579,1705
45021,139,160,2015,50384,15048,35336
45022,139,144,2015,653,276,377
45023,139,162,2015,21840,4990,16850
45024,139,126,2015,191,79,112
45025,139,140,2015,5944,2629,3315
45026,139,164,2015,27861,4721,23140
45027,139,115,2015,12,0,12
45028,139,25,2015,26,10,16
45029,139,166,2015,21023,8805,12218
45030,139,146,2015,204,76,128
45031,139,152,2015,6386,2115,4271
45032,155,157,2015,40369,17022,23347
45033,155,159,2015,968,457,511
45034,155,160,2015,9251,3402,5849
45035,155,161,2015,3257,483,2774
45036,155,158,2015,12328,6370,5958
45037,155,164,2015,118452,59984,58468
45038,155,165,2015,2330,1092,1238
45039,15,2,2015,40,18,22
45040,15,51,2015,10,6,4
45041,15,141,2015,17,10,7
45042,15,12,2015,5821,3823,1998
45043,15,103,2015,15,7,8
45044,15,66,2015,25,11,14
45045,15,11,2015,12358,5587,6771
45046,15,67,2015,22,13,9
45047,15,30,2015,225,123,102
45048,15,29,2015,1066,863,203
45049,15,172,2015,73,37,36
45050,15,81,2015,12,5,7
45051,15,31,2015,33,20,13
45052,15,40,2015,119,81,38
45053,15,42,2015,11,8,3
45054,15,68,2015,39,26,13
45055,15,69,2015,610,335,275
45056,15,56,2015,159,75,84
45057,15,32,2015,48,27,21
45058,15,5,2015,31,12,19
45059,15,6,2015,119,52,67
45060,15,17,2015,31,11,20
45061,15,57,2015,17,6,11
45062,15,167,2015,1662,722,940
45063,15,168,2015,242,162,80
45064,15,20,2015,9,5,4
45065,15,46,2015,199,130,69
45066,15,47,2015,204,157,47
45067,15,8,2015,17,0,17
45068,15,73,2015,11,7,4
45069,15,9,2015,85,6,79
45070,15,112,2015,20,18,2
45071,15,33,2015,175,125,50
45072,15,35,2015,214,161,53
45073,15,36,2015,35936,20590,15346
45074,15,65,2015,18,9,9
45075,15,74,2015,14,7,7
45076,15,169,2015,144,91,53
45077,15,26,2015,457,139,318
45078,15,170,2015,197,128,69
45079,15,38,2015,11792,6723,5069
45080,15,50,2015,33,9,24
45081,15,171,2015,740,478,262
45082,69,2,2015,82361,36386,45975
45083,69,51,2015,32767,15727,17040
45084,69,141,2015,19237,5630,13607
45085,69,134,2015,0,0,0
45086,69,103,2015,15323,8030,7293
45087,69,11,2015,10423,5448,4975
45088,69,66,2015,212921,110298,102623
45089,69,12,2015,15855,7883,7972
45090,69,3,2015,6262,2164,4098
45091,69,29,2015,21105,13918,7187
45092,69,67,2015,28887,14650,14237
45093,69,151,2015,1770,524,1246
45094,69,53,2015,165187,83111,82076
45095,69,105,2015,52814,34824,17990
45096,69,30,2015,87068,44830,42238
45097,69,152,2015,1277,383,894
45098,69,116,2015,579,263,316
45099,69,135,2015,16447,7068,9379
45100,69,136,2015,262,73,189
45101,69,106,2015,13178,6845,6333
45102,69,172,2015,84616,45375,39241
45103,69,107,2015,18281,11338,6943
45104,69,137,2015,3475,1717,1758
45105,69,96,2015,1564,873,691
45106,69,54,2015,173156,92975,80181
45107,69,81,2015,12009,6881,5128
45108,69,14,2015,1531,664,867
45109,69,31,2015,449284,256629,192655
45110,69,176,2015,2473,1615,858
45111,69,137,2015,7214,3434,3780
45112,69,39,2015,21469,11908,9561
45113,69,83,2015,9168,6219,2949
45114,69,108,2015,7015,4346,2669
45115,69,142,2015,19301,5459,13842
45116,69,97,2015,1101,633,468
45117,69,119,2015,27696,14282,13414
45118,69,40,2015,9692,5880,3812
45119,69,120,2015,17201,8591,8610
45120,69,42,2015,13466,9748,3718
45121,69,68,2015,120524,65196,55328
45122,69,139,2015,432,175,257
45123,69,155,2015,5196,1325,3871
45124,69,15,2015,18916,11412,7504
45125,69,156,2015,24916,12497,12419
45126,69,56,2015,177770,81474,96296
45127,69,98,2015,1730,943,787
45128,69,157,2015,3497,1052,2445
45129,69,85,2015,1308,707,601
45130,69,99,2015,1191,758,433
45131,69,32,2015,142801,68574,74227
45132,69,43,2015,1490,699,791
45133,69,5,2015,56450,21434,35016
45134,69,6,2015,113685,48475,65210
45135,69,16,2015,95094,36802,58292
45136,69,44,2015,9401,4279,5122
45137,69,17,2015,12317,4341,7976
45138,69,57,2015,342610,131020,211590
45139,69,86,2015,1886,1048,838
45140,69,177,2015,27345,16349,10996
45141,69,18,2015,10467,3616,6851
45142,69,167,2015,832107,423484,408623
45143,69,121,2015,12427,8845,3582
45144,69,168,2015,69165,35718,33447
45145,69,46,2015,25387,14590,10797
45146,69,20,2015,65743,25663,40080
45147,69,159,2015,1628,523,1105
45148,69,143,2015,3695,1447,2248
45149,69,70,2015,253,148,105
45150,69,47,2015,41195,26295,14900
45151,69,71,2015,17310,8599,8711
45152,69,122,2015,1316,880,436
45153,69,160,2015,1199,491,708
45154,69,58,2015,621,339,282
45155,69,100,2015,15100,9057,6043
45156,69,59,2015,15923,9215,6708
45157,69,144,2015,94690,40740,53950
45158,69,8,2015,3243,1394,1849
45159,69,73,2015,115140,55447,59693
45160,69,101,2015,1257,701,556
45161,69,162,2015,22007,7402,14605
45162,69,60,2015,67229,35538,31691
45163,69,48,2015,7306,4089,3217
45164,69,9,2015,41474,15321,26153
45165,69,102,2015,606,347,259
45166,69,111,2015,4206,2360,1846
45167,69,112,2015,15349,9940,5409
45168,69,33,2015,1561763,830260,731503
45169,69,61,2015,81392,37896,43496
45170,69,35,2015,487856,259371,228485
45171,69,36,2015,876302,477653,398649
45172,69,126,2015,1020,510,510
45173,69,23,2015,3096,1247,1849
45174,69,164,2015,3445,1131,2314
45175,69,63,2015,88177,44615,43562
45176,69,165,2015,2691,802,1889
45177,69,37,2015,35425,21098,14327
45178,69,64,2015,32848,17648,15200
45179,69,128,2015,16282,6475,9807
45180,69,115,2015,15183,7905,7278
45181,69,65,2015,83124,43378,39746
45182,69,10,2015,38616,18047,20569
45183,69,145,2015,0,0,0
45184,69,49,2015,16524,9277,7247
45185,69,74,2015,69678,37363,32315
45186,69,25,2015,197186,79396,117790
45187,69,169,2015,23959,12178,11781
45188,69,166,2015,11780,4550,7230
45189,69,93,2015,758,467,291
45190,69,146,2015,34166,10945,23221
45191,69,26,2015,1343522,641596,701926
45192,69,170,2015,5475,2950,2525
45193,69,130,2015,2143,1190,953
45194,69,38,2015,215866,127524,88342
45195,69,50,2015,85431,33827,51604
45196,69,131,2015,1114,520,594
45197,69,114,2015,2820,1505,1315
45198,69,171,2015,34941,18528,16413
45199,69,1,2015,93372,49107,44265
45200,69,28,2015,2391,661,1730
45201,69,132,2015,832,489,343
45202,156,141,2015,13,3,10
45203,156,105,2015,13,6,7
45204,156,135,2015,116,39,77
45205,156,10,2015,20,9,11
45206,156,136,2015,15,3,12
45207,156,172,2015,232,38,194
45208,156,137,2015,30,14,16
45209,156,151,2015,17183,7691,9492
45210,156,120,2015,30,14,16
45211,156,68,2015,223,96,127
45212,156,155,2015,1645,768,877
45213,156,157,2015,140,51,89
45214,156,5,2015,871,338,533
45215,156,17,2015,46,19,27
45216,156,57,2015,236,91,145
45217,156,177,2015,56,19,37
45218,156,121,2015,15,3,12
45219,156,20,2015,1006,392,614
45220,156,159,2015,30418,14207,16211
45221,156,160,2015,5137,1511,3626
45222,156,161,2015,13,4,9
45223,156,73,2015,187,82,105
45224,156,162,2015,70214,29843,40371
45225,156,9,2015,67,32,35
45226,156,33,2015,47,25,22
45227,156,36,2015,67,38,29
45228,156,126,2015,382,247,135
45229,156,164,2015,75,28,47
45230,156,165,2015,2386,1198,1188
45231,156,145,2015,25,6,19
45232,156,74,2015,148,65,83
45233,156,25,2015,52,24,28
45234,156,166,2015,90343,42196,48147
45235,156,142,2015,39,17,22
45236,156,50,2015,1390,713,677
45237,156,131,2015,8,4,4
45238,156,152,2015,58704,27418,31286
45239,55,144,2015,996,371,625
45240,55,65,2015,2072,1305,767
45241,55,50,2015,5673,2661,3012
45242,56,2,2015,5810,2975,2835
45243,56,51,2015,436566,213844,222722
45244,56,141,2015,1099,167,932
45245,56,52,2015,3,1,2
45246,56,134,2015,8,4,4
45247,56,75,2015,10,5,5
45248,56,76,2015,29,13,16
45249,56,103,2015,639,424,215
45250,56,11,2015,14257,8311,5946
45251,56,77,2015,0,0,0
45252,56,66,2015,2247,1585,662
45253,56,12,2015,504,320,184
45254,56,78,2015,21,11,10
45255,56,13,2015,22,8,14
45256,56,3,2015,9791,619,9172
45257,56,79,2015,10,2,8
45258,56,29,2015,1453,1127,326
45259,56,67,2015,5112,3107,2005
45260,56,95,2015,4,4,0
45261,56,151,2015,7,2,5
45262,56,4,2015,1,0,1
45263,56,53,2015,439,311,128
45264,56,147,2015,7,4,3
45265,56,105,2015,2211,1570,641
45266,56,30,2015,72744,48043,24701
45267,56,152,2015,24,12,12
45268,56,116,2015,132,63,69
45269,56,153,2015,13,7,6
45270,56,135,2015,460,227,233
45271,56,80,2015,0,0,0
45272,56,136,2015,17,10,7
45273,56,106,2015,366,243,123
45274,56,172,2015,3388,1663,1725
45275,56,173,2015,0,0,0
45276,56,107,2015,397,314,83
45277,56,117,2015,73,16,57
45278,56,137,2015,1410,805,605
45279,56,96,2015,37,32,5
45280,56,54,2015,427,310,117
45281,56,81,2015,351,258,93
45282,56,14,2015,21562,12549,9013
45283,56,31,2015,4420,2808,1612
45284,56,176,2015,33,16,17
45285,56,137,2015,208,116,92
45286,56,39,2015,899,617,282
45287,56,118,2015,38,22,16
45288,56,82,2015,17,17,0
45289,56,83,2015,564,482,82
45290,56,108,2015,83,68,15
45291,56,142,2015,28209,12842,15367
45292,56,97,2015,49,40,9
45293,56,138,2015,0,0,0
45294,56,119,2015,395,202,193
45295,56,40,2015,128,103,25
45296,56,148,2015,20,5,15
45297,56,120,2015,2414,1712,702
45298,56,41,2015,0,0,0
45299,56,42,2015,768,673,95
45300,56,68,2015,6680,4236,2444
45301,56,109,2015,0,0,0
45302,56,139,2015,7,5,2
45303,56,155,2015,27,13,14
45304,56,15,2015,83218,50794,32424
45305,56,69,2015,114110,64264,49846
45306,56,156,2015,595,168,427
45307,56,55,2015,4,1,3
45308,56,84,2015,1,0,1
45309,56,98,2015,30,25,5
45310,56,157,2015,54,27,27
45311,56,158,2015,2,1,1
45312,56,110,2015,10,7,3
45313,56,85,2015,37,22,15
45314,56,99,2015,49,40,9
45315,56,32,2015,1724,1194,530
45316,56,43,2015,53,32,21
45317,56,5,2015,10130,2034,8096
45318,56,6,2015,1900,530,1370
45319,56,16,2015,4745,2429,2316
45320,56,44,2015,588,412,176
45321,56,45,2015,4,1,3
45322,56,17,2015,710,332,378
45323,56,57,2015,6289,3785,2504
45324,56,86,2015,11,7,4
45325,56,177,2015,507,404,103
45326,56,18,2015,810,212,598
45327,56,167,2015,26926,15095,11831
45328,56,121,2015,452,277,175
45329,56,19,2015,138,61,77
45330,56,168,2015,546,315,231
45331,56,46,2015,351,295,56
45332,56,20,2015,2047,902,1145
45333,56,149,2015,0,0,0
45334,56,159,2015,30,13,17
45335,56,143,2015,639,267,372
45336,56,70,2015,9,6,3
45337,56,47,2015,543,482,61
45338,56,71,2015,137,77,60
45339,56,122,2015,129,79,50
45340,56,7,2015,2,1,1
45341,56,160,2015,29,11,18
45342,56,58,2015,89,67,22
45343,56,161,2015,45,23,22
45344,56,124,2015,37,32,5
45345,56,100,2015,395,325,70
45346,56,72,2015,44,22,22
45347,56,87,2015,77,43,34
45348,56,144,2015,2070,603,1467
45349,56,125,2015,63,39,24
45350,56,150,2015,7,2,5
45351,56,8,2015,49,12,37
45352,56,73,2015,3737,2528,1209
45353,56,101,2015,159,85,74
45354,56,162,2015,2851,1047,1804
45355,56,60,2015,2164,1280,884
45356,56,48,2015,515,353,162
45357,56,21,2015,4,2,2
45358,56,9,2015,31230,1250,29980
45359,56,102,2015,155,85,70
45360,56,111,2015,78,66,12
45361,56,112,2015,290,214,76
45362,56,33,2015,15630,10417,5213
45363,56,61,2015,323,219,104
45364,56,88,2015,0,0,0
45365,56,22,2015,1100,614,486
45366,56,35,2015,46098,27273,18825
45367,56,36,2015,54081,36080,18001
45368,56,126,2015,96,21,75
45369,56,90,2015,1,0,1
45370,56,92,2015,6,5,1
45371,56,62,2015,0,0,0
45372,56,140,2015,6,1,5
45373,56,23,2015,424,214,210
45374,56,164,2015,638,55,583
45375,56,63,2015,4372,2972,1400
45376,56,127,2015,24,22,2
45377,56,165,2015,174,60,114
45378,56,37,2015,860,730,130
45379,56,64,2015,129,103,26
45380,56,128,2015,739,176,563
45381,56,115,2015,6894,4052,2842
45382,56,65,2015,1177,816,361
45383,56,10,2015,886,567,319
45384,56,145,2015,1850,768,1082
45385,56,113,2015,8,6,2
45386,56,49,2015,5408,3332,2076
45387,56,74,2015,3689,2243,1446
45388,56,25,2015,9549,4889,4660
45389,56,169,2015,96,68,28
45390,56,166,2015,11,5,6
45391,56,93,2015,16,13,3
45392,56,146,2015,634,143,491
45393,56,26,2015,33420,19457,13963
45394,56,170,2015,115,71,44
45395,56,130,2015,138,89,49
45396,56,38,2015,19416,15671,3745
45397,56,27,2015,85,39,46
45398,56,50,2015,17643,10927,6716
45399,56,131,2015,394,187,207
45400,56,114,2015,111,70,41
45401,56,171,2015,8277,4946,3331
45402,56,1,2015,209,113,96
45403,56,28,2015,32,16,16
45404,56,132,2015,237,139,98
45405,56,133,2015,418,243,175
45406,84,76,2015,38,19,19
45407,84,78,2015,30,15,15
45408,84,79,2015,178,89,89
45409,84,82,2015,74,37,37
45410,84,110,2015,341,288,53
45411,84,86,2015,115,58,57
45412,84,87,2015,10,5,5
45413,84,90,2015,15,7,8
45414,84,91,2015,163,82,81
45415,84,92,2015,377,289,88
45416,84,93,2015,2196,1468,728
45417,98,103,2015,529,199,330
45418,98,105,2015,229,94,135
45419,98,95,2015,874,420,454
45420,98,106,2015,287,113,174
45421,98,172,2015,627,284,343
45422,98,107,2015,1102,503,599
45423,98,96,2015,1108,532,576
45424,98,81,2015,630,250,380
45425,98,83,2015,104,41,63
45426,98,108,2015,160,68,92
45427,98,97,2015,18301,14052,4249
45428,98,68,2015,246,72,174
45429,98,109,2015,20,9,11
45430,98,69,2015,611,217,394
45431,98,85,2015,14,5,9
45432,98,99,2015,7995,4307,3688
45433,98,6,2015,18,6,12
45434,98,17,2015,125,44,81
45435,98,57,2015,351,102,249
45436,98,177,2015,141,52,89
45437,98,20,2015,24,3,21
45438,98,100,2015,16720,6825,9895
45439,98,73,2015,134,66,68
45440,98,101,2015,8161,3759,4402
45441,98,9,2015,25,14,11
45442,98,102,2015,286,136,150
45443,98,111,2015,57,27,30
45444,98,112,2015,436,184,252
45445,98,61,2015,28,2,26
45446,98,88,2015,97,40,57
45447,98,23,2015,31,3,28
45448,98,65,2015,1259,463,796
45449,98,49,2015,45,14,31
45450,98,74,2015,147,48,99
45451,98,25,2015,75,24,51
45452,98,26,2015,24,15,9
45453,98,142,2015,31,30,1
45454,98,50,2015,213,74,139
45455,98,114,2015,134,47,87
45456,157,2,2015,3,0,3
45457,157,51,2015,11,4,7
45458,157,141,2015,7044,2739,4305
45459,157,52,2015,6,2,4
45460,157,134,2015,115,41,74
45461,157,76,2015,4452,1907,2545
45462,157,12,2015,5,0,5
45463,157,103,2015,112,47,65
45464,157,66,2015,1,0,1
45465,157,78,2015,13,7,6
45466,157,13,2015,3,1,2
45467,157,3,2015,1,0,1
45468,157,11,2015,9,0,9
45469,157,79,2015,11,1,10
45470,157,67,2015,40,14,26
45471,157,4,2015,3,1,2
45472,157,53,2015,2,0,2
45473,157,147,2015,50,20,30
45474,157,105,2015,14,4,10
45475,157,95,2015,2,0,2
45476,157,30,2015,3,1,2
45477,157,116,2015,39,13,26
45478,157,135,2015,196,54,142
45479,157,153,2015,34,13,21
45480,157,10,2015,2,0,2
45481,157,136,2015,389,114,275
45482,157,106,2015,11,3,8
45483,157,172,2015,169,35,134
45484,157,107,2015,2623,1106,1517
45485,157,117,2015,761,286,475
45486,157,137,2015,122,43,79
45487,157,137,2015,77,28,49
45488,157,96,2015,118,45,73
45489,157,54,2015,19,7,12
45490,157,81,2015,1786,722,1064
45491,157,151,2015,408,128,280
45492,157,39,2015,66,28,38
45493,157,82,2015,13,9,4
45494,157,83,2015,2,1,1
45495,157,108,2015,2,0,2
45496,157,97,2015,4,2,2
45497,157,138,2015,10695,4457,6238
45498,157,120,2015,12,5,7
45499,157,119,2015,23,8,15
45500,157,42,2015,6,2,4
45501,157,68,2015,248,75,173
45502,157,118,2015,18,4,14
45503,157,139,2015,74,27,47
45504,157,155,2015,281,111,170
45505,157,69,2015,27,9,18
45506,157,156,2015,588,109,479
45507,157,85,2015,25,12,13
45508,157,99,2015,298,132,166
45509,157,5,2015,49,3,46
45510,157,17,2015,11,4,7
45511,157,57,2015,82,35,47
45512,157,177,2015,54,21,33
45513,157,18,2015,2,0,2
45514,157,121,2015,1999,833,1166
45515,157,176,2015,1232,514,718
45516,157,20,2015,156,30,126
45517,157,149,2015,32,10,22
45518,157,46,2015,23,11,12
45519,157,159,2015,2765,1228,1537
45520,157,143,2015,44,15,29
45521,157,70,2015,4,3,1
45522,157,122,2015,10,5,5
45523,157,123,2015,17,5,12
45524,157,160,2015,46991,20713,26278
45525,157,161,2015,1154,378,776
45526,157,124,2015,15,4,11
45527,157,144,2015,333,128,205
45528,157,125,2015,19,6,13
45529,157,150,2015,3,1,2
45530,157,8,2015,25,6,19
45531,157,73,2015,38,12,26
45532,157,101,2015,5,2,3
45533,157,162,2015,381,67,314
45534,157,48,2015,2,0,2
45535,157,9,2015,19,4,15
45536,157,33,2015,1,1,0
45537,157,61,2015,14,0,14
45538,157,158,2015,4540,1948,2592
45539,157,35,2015,5,1,4
45540,157,36,2015,39,8,31
45541,157,126,2015,39,16,23
45542,157,92,2015,30,11,19
45543,157,140,2015,33,13,20
45544,157,23,2015,31,11,20
45545,157,164,2015,2139,843,1296
45546,157,63,2015,2,1,1
45547,157,127,2015,3,1,2
45548,157,165,2015,8683,3615,5068
45549,157,1,2015,5,1,4
45550,157,64,2015,28,11,17
45551,157,128,2015,6,2,4
45552,157,115,2015,1251,489,762
45553,157,133,2015,4,1,3
45554,157,65,2015,1187,487,700
45555,157,129,2015,3,1,2
45556,157,145,2015,7,2,5
45557,157,148,2015,5,1,4
45558,157,49,2015,3,0,3
45559,157,74,2015,17,6,11
45560,157,25,2015,8,1,7
45561,157,169,2015,1,0,1
45562,157,166,2015,533,146,387
45563,157,146,2015,533,236,297
45564,157,26,2015,35,11,24
45565,157,130,2015,1,0,1
45566,157,38,2015,9,3,6
45567,157,142,2015,27,6,21
45568,157,50,2015,8,3,5
45569,157,131,2015,2,0,2
45570,157,152,2015,588,70,518
45571,157,114,2015,1,0,1
45572,157,171,2015,1,0,1
45573,158,153,2015,552,337,215
45574,158,68,2015,110,33,77
45575,158,155,2015,1495,749,746
45576,158,157,2015,4938,2442,2496
45577,158,159,2015,898,333,565
45578,158,161,2015,559,278,281
45579,158,61,2015,823,425,398
45580,158,164,2015,11087,5929,5158
45581,158,165,2015,812,401,411
45582,110,76,2015,9,5,4
45583,110,78,2015,8,4,4
45584,110,79,2015,150,67,83
45585,110,105,2015,1201,448,753
45586,110,172,2015,645,248,397
45587,110,82,2015,24,9,15
45588,110,84,2015,107,46,61
45589,110,86,2015,166,72,94
45590,110,91,2015,122,48,74
45591,110,92,2015,206,88,118
45592,110,113,2015,2586,1240,1346
45593,110,93,2015,495,210,285
45594,110,50,2015,322,138,184
45595,85,103,2015,437,186,251
45596,85,66,2015,158,24,134
45597,85,106,2015,312,111,201
45598,85,172,2015,326,137,189
45599,85,107,2015,780,382,398
45600,85,96,2015,256,157,99
45601,85,81,2015,1133,498,635
45602,85,83,2015,2272,1000,1272
45603,85,68,2015,416,161,255
45604,85,69,2015,845,340,505
45605,85,57,2015,1157,338,819
45606,85,177,2015,206,94,112
45607,85,100,2015,287,163,124
45608,85,112,2015,330,133,197
45609,85,88,2015,1459,794,665
45610,85,65,2015,1224,445,779
45611,85,74,2015,354,127,227
45612,85,114,2015,268,162,106
45613,99,103,2015,191,82,109
45614,99,67,2015,25,8,17
45615,99,105,2015,237,140,97
45616,99,95,2015,365,171,194
45617,99,80,2015,90,43,47
45618,99,106,2015,309,152,157
45619,99,172,2015,596,217,379
45620,99,107,2015,868,377,491
45621,99,96,2015,861,399,462
45622,99,81,2015,612,195,417
45623,99,83,2015,135,50,85
45624,99,108,2015,461,149,312
45625,99,97,2015,8853,4752,4101
45626,99,68,2015,144,61,83
45627,99,69,2015,292,100,192
45628,99,98,2015,4607,2260,2347
45629,99,85,2015,43,5,38
45630,99,17,2015,90,30,60
45631,99,57,2015,260,64,196
45632,99,86,2015,27,4,23
45633,99,177,2015,139,63,76
45634,99,18,2015,40,19,21
45635,99,176,2015,62,19,43
45636,99,100,2015,1567,788,779
45637,99,73,2015,91,27,64
45638,99,101,2015,7767,3836,3931
45639,99,102,2015,398,170,228
45640,99,111,2015,35,13,22
45641,99,112,2015,384,163,221
45642,99,88,2015,129,49,80
45643,99,36,2015,25,10,15
45644,99,65,2015,525,226,299
45645,99,49,2015,31,13,18
45646,99,74,2015,61,17,44
45647,99,50,2015,102,30,72
45648,99,114,2015,66,24,42
45649,173,3,2015,444,174,270
45650,173,172,2015,2309769,1319176,990593
45651,173,174,2015,71366,40644,30722
45652,173,68,2015,2196,804,1392
45653,173,69,2015,1974,566,1408
45654,173,5,2015,18019,9838,8181
45655,173,44,2015,695,312,383
45656,173,57,2015,642,257,385
45657,173,177,2015,14197,7312,6885
45658,173,8,2015,9342,5072,4270
45659,173,73,2015,1020,383,637
45660,173,9,2015,7560,3251,4309
45661,173,61,2015,109,64,45
45662,173,36,2015,87,77,10
45663,173,65,2015,401,211,190
45664,173,10,2015,782,537,245
45665,173,74,2015,726,234,492
45666,173,50,2015,17681,7117,10564
45667,173,1,2015,10939,7162,3777
45668,32,2,2015,9411,2809,6602
45669,32,51,2015,228,99,129
45670,32,141,2015,684,197,487
45671,32,52,2015,1,1,0
45672,32,134,2015,78,29,49
45673,32,76,2015,1,1,0
45674,32,103,2015,368,160,208
45675,32,11,2015,173,94,79
45676,32,77,2015,1,0,1
45677,32,66,2015,8694,3999,4695
45678,32,12,2015,201,96,105
45679,32,78,2015,6,2,4
45680,32,13,2015,14,6,8
45681,32,3,2015,67,14,53
45682,32,79,2015,2,2,0
45683,32,29,2015,199,133,66
45684,32,67,2015,1853,892,961
45685,32,95,2015,3,1,2
45686,32,151,2015,9,2,7
45687,32,4,2015,1,0,1
45688,32,53,2015,234,92,142
45689,32,147,2015,3,0,3
45690,32,105,2015,1621,657,964
45691,32,30,2015,1294,719,575
45692,32,152,2015,5,3,2
45693,32,116,2015,5,0,5
45694,32,153,2015,5,2,3
45695,32,135,2015,249,59,190
45696,32,80,2015,1,1,0
45697,32,136,2015,1,0,1
45698,32,106,2015,132,65,67
45699,32,172,2015,13867,6907,6960
45700,32,107,2015,202,102,100
45701,32,117,2015,1,0,1
45702,32,137,2015,77,17,60
45703,32,96,2015,44,21,23
45704,32,54,2015,1921,1032,889
45705,32,81,2015,539,293,246
45706,32,14,2015,276,128,148
45707,32,31,2015,1455,895,560
45708,32,176,2015,16,11,5
45709,32,137,2015,36,10,26
45710,32,39,2015,435,168,267
45711,32,118,2015,2,1,1
45712,32,82,2015,1,0,1
45713,32,83,2015,33,16,17
45714,32,108,2015,107,44,63
45715,32,142,2015,1264,435,829
45716,32,97,2015,15,10,5
45717,32,138,2015,2,0,2
45718,32,119,2015,29,12,17
45719,32,40,2015,148,108,40
45720,32,148,2015,1,0,1
45721,32,120,2015,127,46,81
45722,32,41,2015,1,0,1
45723,32,42,2015,721,383,338
45724,32,68,2015,3896,1889,2007
45725,32,139,2015,7,3,4
45726,32,155,2015,11,3,8
45727,32,15,2015,191,102,89
45728,32,69,2015,28219,13800,14419
45729,32,156,2015,116,42,74
45730,32,56,2015,1140,587,553
45731,32,84,2015,3,1,2
45732,32,98,2015,16,7,9
45733,32,157,2015,38,6,32
45734,32,158,2015,3,0,3
45735,32,110,2015,8,2,6
45736,32,85,2015,4,3,1
45737,32,99,2015,10,3,7
45738,32,43,2015,125,69,56
45739,32,5,2015,1110,403,707
45740,32,6,2015,1997,796,1201
45741,32,16,2015,2661,773,1888
45742,32,44,2015,1120,548,572
45743,32,17,2015,1556,648,908
45744,32,57,2015,4428,1641,2787
45745,32,86,2015,25,12,13
45746,32,177,2015,1423,653,770
45747,32,18,2015,481,102,379
45748,32,167,2015,483,319,164
45749,32,121,2015,95,49,46
45750,32,19,2015,243,87,156
45751,32,168,2015,126,99,27
45752,32,46,2015,165,116,49
45753,32,20,2015,369,100,269
45754,32,149,2015,3,0,3
45755,32,159,2015,33,10,23
45756,32,143,2015,406,159,247
45757,32,70,2015,4,1,3
45758,32,47,2015,181,104,77
45759,32,71,2015,167,76,91
45760,32,122,2015,32,16,16
45761,32,123,2015,3,2,1
45762,32,160,2015,20,4,16
45763,32,58,2015,76,35,41
45764,32,161,2015,5,0,5
45765,32,124,2015,56,28,28
45766,32,100,2015,420,191,229
45767,32,72,2015,5,2,3
45768,32,59,2015,44,17,27
45769,32,144,2015,203,67,136
45770,32,125,2015,20,9,11
45771,32,150,2015,19,11,8
45772,32,8,2015,52,22,30
45773,32,73,2015,3076,1323,1753
45774,32,101,2015,20,9,11
45775,32,162,2015,1447,546,901
45776,32,60,2015,149,64,85
45777,32,48,2015,1158,722,436
45778,32,21,2015,20,8,12
45779,32,9,2015,3677,942,2735
45780,32,102,2015,28,15,13
45781,32,111,2015,15,9,6
45782,32,112,2015,188,96,92
45783,32,33,2015,3018,1986,1032
45784,32,61,2015,435,178,257
45785,32,22,2015,53,22,31
45786,32,35,2015,190203,100798,89405
45787,32,36,2015,3462,2174,1288
45788,32,126,2015,18,8,10
45789,32,90,2015,0,0,0
45790,32,91,2015,2,0,2
45791,32,92,2015,3,2,1
45792,32,62,2015,5,1,4
45793,32,23,2015,373,117,256
45794,32,164,2015,34,9,25
45795,32,63,2015,37115,17658,19457
45796,32,127,2015,7,4,3
45797,32,165,2015,31,1,30
45798,32,37,2015,19717,12575,7142
45799,32,64,2015,386,192,194
45800,32,128,2015,564,103,461
45801,32,115,2015,332,150,182
45802,32,65,2015,1788,865,923
45803,32,10,2015,61,24,37
45804,32,145,2015,167,35,132
45805,32,113,2015,13,3,10
45806,32,49,2015,1500,725,775
45807,32,74,2015,2477,1149,1328
45808,32,25,2015,19083,4916,14167
45809,32,169,2015,15,9,6
45810,32,166,2015,11,5,6
45811,32,93,2015,8,6,2
45812,32,146,2015,273,60,213
45813,32,26,2015,2075,653,1422
45814,32,170,2015,19,12,7
45815,32,130,2015,36,15,21
45816,32,38,2015,39189,21838,17351
45817,32,27,2015,263,119,144
45818,32,50,2015,7414,3377,4037
45819,32,131,2015,62,21,41
45820,32,114,2015,62,33,29
45821,32,171,2015,129,71,58
45822,32,1,2015,3091,1647,1444
45823,32,28,2015,271,88,183
45824,32,132,2015,16,8,8
45825,32,133,2015,33,13,20
45826,43,2,2015,13,6,7
45827,43,51,2015,45,20,25
45828,43,141,2015,40,9,31
45829,43,52,2015,2,0,2
45830,43,134,2015,34,13,21
45831,43,76,2015,1,1,0
45832,43,103,2015,46,16,30
45833,43,11,2015,8,5,3
45834,43,77,2015,1,0,1
45835,43,66,2015,126,68,58
45836,43,12,2015,13,9,4
45837,43,78,2015,6,3,3
45838,43,13,2015,1,0,1
45839,43,3,2015,4,0,4
45840,43,79,2015,1,0,1
45841,43,29,2015,41,31,10
45842,43,67,2015,120,62,58
45843,43,95,2015,0,0,0
45844,43,151,2015,1,0,1
45845,43,53,2015,150,71,79
45846,43,105,2015,139,103,36
45847,43,30,2015,241,119,122
45848,43,152,2015,1,0,1
45849,43,153,2015,33,18,15
45850,43,135,2015,7,2,5
45851,43,136,2015,0,0,0
45852,43,106,2015,77,31,46
45853,43,172,2015,582,399,183
45854,43,107,2015,189,121,68
45855,43,137,2015,3,1,2
45856,43,96,2015,7,3,4
45857,43,54,2015,169,77,92
45858,43,81,2015,57,31,26
45859,43,14,2015,5,2,3
45860,43,31,2015,246,105,141
45861,43,176,2015,0,0,0
45862,43,137,2015,2,0,2
45863,43,39,2015,3283,1664,1619
45864,43,118,2015,0,0,0
45865,43,82,2015,2,1,1
45866,43,83,2015,32,23,9
45867,43,108,2015,32,20,12
45868,43,142,2015,29,8,21
45869,43,97,2015,13,8,5
45870,43,138,2015,9,7,2
45871,43,119,2015,7,3,4
45872,43,40,2015,129,84,45
45873,43,120,2015,71,43,28
45874,43,41,2015,331,194,137
45875,43,42,2015,178,119,59
45876,43,68,2015,538,252,286
45877,43,139,2015,0,0,0
45878,43,155,2015,11,2,9
45879,43,15,2015,22,14,8
45880,43,69,2015,1649,1014,635
45881,43,156,2015,62,30,32
45882,43,55,2015,0,0,0
45883,43,56,2015,45,15,30
45884,43,98,2015,37,17,20
45885,43,157,2015,18,8,10
45886,43,158,2015,1,0,1
45887,43,110,2015,20,14,6
45888,43,85,2015,12,9,3
45889,43,99,2015,35,19,16
45890,43,32,2015,218,109,109
45891,43,5,2015,305,160,145
45892,43,6,2015,63,23,40
45893,43,16,2015,57,22,35
45894,43,44,2015,105,43,62
45895,43,17,2015,37,14,23
45896,43,57,2015,260,111,149
45897,43,86,2015,18,13,5
45898,43,177,2015,98,65,33
45899,43,18,2015,13,7,6
45900,43,167,2015,21,16,5
45901,43,121,2015,90,61,29
45902,43,19,2015,2,0,2
45903,43,168,2015,1,0,1
45904,43,46,2015,735,383,352
45905,43,20,2015,30,10,20
45906,43,159,2015,1,1,0
45907,43,143,2015,4,2,2
45908,43,70,2015,1,1,0
45909,43,47,2015,1499,763,736
45910,43,71,2015,142,74,68
45911,43,122,2015,2,0,2
45912,43,123,2015,4,1,3
45913,43,160,2015,2,0,2
45914,43,58,2015,8,3,5
45915,43,161,2015,1,0,1
45916,43,124,2015,5,4,1
45917,43,100,2015,92,48,44
45918,43,72,2015,1,1,0
45919,43,59,2015,8,6,2
45920,43,144,2015,166,63,103
45921,43,125,2015,23,15,8
45922,43,150,2015,35,19,16
45923,43,8,2015,98,42,56
45924,43,73,2015,288,136,152
45925,43,101,2015,7,5,2
45926,43,162,2015,72,26,46
45927,43,60,2015,40,19,21
45928,43,48,2015,1036,550,486
45929,43,21,2015,2,0,2
45930,43,9,2015,38,17,21
45931,43,102,2015,6,3,3
45932,43,111,2015,4,1,3
45933,43,112,2015,75,49,26
45934,43,33,2015,10967,5128,5839
45935,43,61,2015,576,214,362
45936,43,88,2015,0,0,0
45937,43,22,2015,2,2,0
45938,43,35,2015,400,189,211
45939,43,36,2015,364,233,131
45940,43,126,2015,2,0,2
45941,43,92,2015,2,1,1
45942,43,62,2015,0,0,0
45943,43,23,2015,8,4,4
45944,43,164,2015,21,9,12
45945,43,63,2015,523,267,256
45946,43,165,2015,15,5,10
45947,43,37,2015,243,89,154
45948,43,64,2015,32,14,18
45949,43,128,2015,2,1,1
45950,43,115,2015,81,50,31
45951,43,65,2015,540,220,320
45952,43,10,2015,164,100,64
45953,43,145,2015,0,0,0
45954,43,49,2015,1920,971,949
45955,43,74,2015,158,85,73
45956,43,25,2015,35,9,26
45957,43,169,2015,2,2,0
45958,43,166,2015,5,1,4
45959,43,93,2015,3,2,1
45960,43,146,2015,28,8,20
45961,43,26,2015,73,28,45
45962,43,170,2015,1,1,0
45963,43,130,2015,37,26,11
45964,43,38,2015,274,184,90
45965,43,27,2015,6,2,4
45966,43,50,2015,1307,524,783
45967,43,131,2015,28,17,11
45968,43,114,2015,9,3,6
45969,43,171,2015,10,6,4
45970,43,1,2015,613,338,275
45971,43,28,2015,0,0,0
45972,43,132,2015,8,7,1
45973,43,133,2015,11,8,3
45974,5,2,2015,16851,8869,7982
45975,5,3,2015,2660632,1310926,1349706
45976,5,4,2015,10092,5137,4955
45977,5,172,2015,110098,53365,56733
45978,5,68,2015,1856,992,864
45979,5,69,2015,2547,1335,1212
45980,5,6,2015,2346,1255,1091
45981,5,16,2015,717,302,415
45982,5,177,2015,1922,1107,815
45983,5,167,2015,463,273,190
45984,5,121,2015,8268,4413,3855
45985,5,19,2015,12597,6491,6106
45986,5,7,2015,924,457,467
45987,5,124,2015,371,234,137
45988,5,8,2015,784497,517433,267064
45989,5,162,2015,966,396,570
45990,5,9,2015,890966,434995,455971
45991,5,61,2015,356,196,160
45992,5,23,2015,15448,7441,8007
45993,5,10,2015,197564,100840,96724
45994,5,26,2015,140,68,72
45995,5,36,2015,1335,748,587
45996,5,130,2015,48444,32243,16201
45997,5,27,2015,41132,20093,21039
45998,5,50,2015,11761,6114,5647
45999,5,1,2015,1416,881,535
46000,5,132,2015,1552,991,561
46001,6,2,2015,2621236,1191658,1429578
46002,6,11,2015,1185,607,578
46003,6,12,2015,5744,2950,2794
46004,6,16,2015,68735,30537,38198
46005,6,9,2015,16032,6718,9314
46006,6,26,2015,910,372,538
46007,6,170,2015,2344,956,1388
46008,16,2,2015,312,134,178
46009,16,119,2015,806,238,568
46010,16,5,2015,232,83,149
46011,16,6,2015,14405,6154,8251
46012,16,18,2015,10336,2829,7507
46013,16,19,2015,400,120,280
46014,16,20,2015,1522,583,939
46015,16,161,2015,200,48,152
46016,16,144,2015,586,203,383
46017,16,9,2015,682,166,516
46018,16,36,2015,273,78,195
46019,16,23,2015,674,176,498
46020,16,128,2015,414,107,307
46021,16,129,2015,295,36,259
46022,16,145,2015,3792,463,3329
46023,16,25,2015,252036,111875,140161
46024,16,27,2015,288,62,226
46025,16,146,2015,312,42,270
46026,16,26,2015,17514,7706,9808
46027,16,142,2015,14363,2516,11847
46028,16,28,2015,2001,380,1621
46029,44,2,2015,148,29,119
46030,44,51,2015,297,124,173
46031,44,141,2015,588,172,416
46032,44,52,2015,2,2,0
46033,44,134,2015,480,242,238
46034,44,75,2015,1,1,0
46035,44,76,2015,2,1,1
46036,44,103,2015,327,175,152
46037,44,11,2015,53,26,27
46038,44,77,2015,7,4,3
46039,44,66,2015,784,529,255
46040,44,12,2015,50,24,26
46041,44,78,2015,27,12,15
46042,44,13,2015,82,43,39
46043,44,3,2015,3232,956,2276
46044,44,79,2015,18,10,8
46045,44,29,2015,611,350,261
46046,44,67,2015,1638,908,730
46047,44,95,2015,2,2,0
46048,44,151,2015,34,22,12
46049,44,4,2015,7,2,5
46050,44,53,2015,640,342,298
46051,44,147,2015,80,37,43
46052,44,105,2015,10292,4313,5979
46053,44,30,2015,1974,1072,902
46054,44,152,2015,9,3,6
46055,44,116,2015,48,24,24
46056,44,153,2015,4,1,3
46057,44,135,2015,346,203,143
46058,44,80,2015,25,14,11
46059,44,136,2015,10,3,7
46060,44,106,2015,142,84,58
46061,44,172,2015,12683,6545,6138
46062,44,173,2015,1887,1137,750
46063,44,137,2015,2519,1298,1221
46064,44,96,2015,11,7,4
46065,44,54,2015,506,248,258
46066,44,81,2015,83,46,37
46067,44,14,2015,288,146,142
46068,44,31,2015,6081,2822,3259
46069,44,176,2015,131,80,51
46070,44,137,2015,52,28,24
46071,44,39,2015,980,578,402
46072,44,118,2015,1,1,0
46073,44,82,2015,1,1,0
46074,44,83,2015,10,4,6
46075,44,108,2015,39,27,12
46076,44,142,2015,532,172,360
46077,44,97,2015,27,16,11
46078,44,119,2015,38,14,24
46079,44,40,2015,2744,1621,1123
46080,44,148,2015,21,12,9
46081,44,120,2015,154,86,68
46082,44,41,2015,3,2,1
46083,44,42,2015,966,749,217
46084,44,68,2015,11147,6521,4626
46085,44,139,2015,4,2,2
46086,44,155,2015,57,27,30
46087,44,15,2015,255,117,138
46088,44,69,2015,14368,8936,5432
46089,44,156,2015,504,281,223
46090,44,55,2015,39,21,18
46091,44,56,2015,636,285,351
46092,44,84,2015,14,7,7
46093,44,98,2015,125,66,59
46094,44,157,2015,50,23,27
46095,44,158,2015,1,1,0
46096,44,110,2015,29,18,11
46097,44,85,2015,4,3,1
46098,44,99,2015,12,8,4
46099,44,32,2015,8206,3796,4410
46100,44,43,2015,38,21,17
46101,44,5,2015,19764,10224,9540
46102,44,6,2015,445,154,291
46103,44,16,2015,453,178,275
46104,44,17,2015,220,102,118
46105,44,57,2015,7910,3963,3947
46106,44,86,2015,120,83,37
46107,44,177,2015,529,359,170
46108,44,18,2015,111,50,61
46109,44,167,2015,259,143,116
46110,44,121,2015,482,283,199
46111,44,19,2015,201,83,118
46112,44,168,2015,32,18,14
46113,44,46,2015,22126,12000,10126
46114,44,20,2015,133,58,75
46115,44,149,2015,39,22,17
46116,44,159,2015,107,48,59
46117,44,143,2015,439,191,248
46118,44,70,2015,2,1,1
46119,44,47,2015,38572,19990,18582
46120,44,71,2015,156,75,81
46121,44,122,2015,12,8,4
46122,44,123,2015,76,36,40
46123,44,7,2015,2,2,0
46124,44,160,2015,29,16,13
46125,44,58,2015,372,208,164
46126,44,161,2015,8,3,5
46127,44,124,2015,3231,1427,1804
46128,44,100,2015,305,215,90
46129,44,72,2015,7,2,5
46130,44,87,2015,1,1,0
46131,44,144,2015,274,85,189
46132,44,125,2015,39,20,19
46133,44,150,2015,38,24,14
46134,44,8,2015,136,44,92
46135,44,73,2015,4980,2687,2293
46136,44,101,2015,16,9,7
46137,44,162,2015,21894,12655,9239
46138,44,60,2015,655,283,372
46139,44,48,2015,305,164,141
46140,44,21,2015,49,25,24
46141,44,9,2015,9219,3427,5792
46142,44,102,2015,16,10,6
46143,44,111,2015,27,19,8
46144,44,112,2015,127,85,42
46145,44,33,2015,127507,57588,69919
46146,44,61,2015,2486,1093,1393
46147,44,22,2015,35,18,17
46148,44,35,2015,19919,10655,9264
46149,44,36,2015,6570,3610,2960
46150,44,126,2015,80,49,31
46151,44,90,2015,2,1,1
46152,44,91,2015,7,2,5
46153,44,92,2015,2,1,1
46154,44,23,2015,429,214,215
46155,44,164,2015,22,12,10
46156,44,127,2015,11,7,4
46157,44,165,2015,196,82,114
46158,44,37,2015,11838,5014,6824
46159,44,64,2015,210,103,107
46160,44,128,2015,531,254,277
46161,44,115,2015,8983,4793,4190
46162,44,65,2015,7751,5212,2539
46163,44,10,2015,238,101,137
46164,44,145,2015,588,216,372
46165,44,113,2015,12,8,4
46166,44,49,2015,1868,1312,556
46167,44,74,2015,553,340,213
46168,44,25,2015,507,202,305
46169,44,169,2015,21,12,9
46170,44,166,2015,114,47,67
46171,44,93,2015,111,72,39
46172,44,146,2015,100,21,79
46173,44,26,2015,489,120,369
46174,44,170,2015,4,3,1
46175,44,94,2015,1,0,1
46176,44,130,2015,149,84,65
46177,44,38,2015,4564,2191,2373
46178,44,27,2015,201,99,102
46179,44,50,2015,267364,131782,135582
46180,44,131,2015,125,71,54
46181,44,114,2015,55,32,23
46182,44,171,2015,92,55,37
46183,44,1,2015,635,405,230
46184,44,28,2015,31,13,18
46185,44,132,2015,340,184,156
46186,44,133,2015,3098,1691,1407
46187,45,44,2015,1540,891,649
46188,45,115,2015,807,409,398
46189,45,50,2015,33553,16906,16647
46190,17,2,2015,2539,1331,1208
46191,17,141,2015,45680,24784,20896
46192,17,12,2015,13529,7206,6323
46193,17,103,2015,39343,20878,18465
46194,17,66,2015,5064,2812,2252
46195,17,67,2015,5993,3335,2658
46196,17,105,2015,8932,5069,3863
46197,17,30,2015,16633,9315,7318
46198,17,29,2015,23119,13081,10038
46199,17,106,2015,3386,1833,1553
46200,17,172,2015,600,335,265
46201,17,107,2015,2762,1629,1133
46202,17,39,2015,1916,1299,617
46203,17,120,2015,80474,40714,39760
46204,17,42,2015,308,228,80
46205,17,68,2015,41847,22988,18859
46206,17,15,2015,9317,5000,4317
46207,17,69,2015,23656,13463,10193
46208,17,56,2015,3085,1697,1388
46209,17,32,2015,12495,6980,5515
46210,17,5,2015,18965,9944,9021
46211,17,6,2015,52322,27030,25292
46212,17,16,2015,67791,35827,31964
46213,17,57,2015,5225,2923,2302
46214,17,167,2015,13632,7472,6160
46215,17,168,2015,2519,1419,1100
46216,17,20,2015,6232,3550,2682
46217,17,46,2015,3931,2221,1710
46218,17,143,2015,17273,9509,7764
46219,17,47,2015,3869,2251,1618
46220,17,100,2015,2601,1351,1250
46221,17,144,2015,163113,86323,76790
46222,17,73,2015,5110,3012,2098
46223,17,112,2015,2440,1331,1109
46224,17,33,2015,59286,33451,25835
46225,17,35,2015,103678,58171,45507
46226,17,36,2015,114630,65718,48912
46227,17,115,2015,11721,6347,5374
46228,17,65,2015,1890,1068,822
46229,17,49,2015,688,415,273
46230,17,74,2015,3853,2268,1585
46231,17,25,2015,9483,5210,4273
46232,17,169,2015,1885,1016,869
46233,17,146,2015,23543,12596,10947
46234,17,26,2015,27960,14762,13198
46235,17,170,2015,2301,1221,1080
46236,17,38,2015,135112,75525,59587
46237,17,142,2015,21100,11206,9894
46238,17,50,2015,21869,11896,9973
46239,17,114,2015,6378,3440,2938
46240,17,171,2015,22316,11956,10360
46241,17,28,2015,30869,17222,13647
46242,57,2,2015,14893,908,13985
46243,57,51,2015,444887,217249,227638
46244,57,141,2015,21908,8076,13832
46245,57,52,2015,106,77,29
46246,57,134,2015,1813,971,842
46247,57,76,2015,793,525,268
46248,57,103,2015,69876,37864,32012
46249,57,11,2015,1354,859,495
46250,57,66,2015,15729,10997,4732
46251,57,12,2015,698,492,206
46252,57,78,2015,260,165,95
46253,57,13,2015,293,132,161
46254,57,3,2015,105084,27525,77559
46255,57,79,2015,143,92,51
46256,57,29,2015,31350,15126,16224
46257,57,67,2015,45287,25876,19411
46258,57,95,2015,56,30,26
46259,57,151,2015,2529,1012,1517
46260,57,4,2015,39,14,25
46261,57,53,2015,11317,8974,2343
46262,57,147,2015,46,23,23
46263,57,105,2015,99588,65843,33745
46264,57,30,2015,57017,37587,19430
46265,57,152,2015,11670,3566,8104
46266,57,116,2015,1006,577,429
46267,57,153,2015,6054,4598,1456
46268,57,135,2015,11285,5575,5710
46269,57,136,2015,526,126,400
46270,57,106,2015,12093,7082,5011
46271,57,172,2015,199617,100069,99548
46272,57,107,2015,38713,25207,13506
46273,57,117,2015,29,18,11
46274,57,137,2015,3295,1608,1687
46275,57,96,2015,1473,915,558
46276,57,54,2015,23478,13650,9828
46277,57,81,2015,33612,25846,7766
46278,57,14,2015,602,343,259
46279,57,31,2015,10365,8492,1873
46280,57,176,2015,110,56,54
46281,57,137,2015,5988,3107,2881
46282,57,39,2015,3032,2032,1000
46283,57,118,2015,85,51,34
46284,57,82,2015,295,216,79
46285,57,83,2015,41853,29112,12741
46286,57,108,2015,84195,51707,32488
46287,57,142,2015,108497,31863,76634
46288,57,97,2015,13021,8604,4417
46289,57,138,2015,119,69,50
46290,57,119,2015,13529,6122,7407
46291,57,40,2015,1403,1173,230
46292,57,148,2015,30,19,11
46293,57,120,2015,29434,17106,12328
46294,57,42,2015,2675,2137,538
46295,57,68,2015,127459,77680,49779
46296,57,139,2015,371,178,193
46297,57,155,2015,9992,824,9168
46298,57,15,2015,13336,11549,1787
46299,57,69,2015,213522,121155,92367
46300,57,156,2015,46084,17766,28318
46301,57,56,2015,16959,8920,8039
46302,57,84,2015,15,12,3
46303,57,98,2015,2114,1324,790
46304,57,157,2015,4059,1245,2814
46305,57,158,2015,862,263,599
46306,57,110,2015,73,56,17
46307,57,85,2015,712,446,266
46308,57,99,2015,2475,1823,652
46309,57,32,2015,12625,9540,3085
46310,57,43,2015,183,122,61
46311,57,5,2015,138591,54980,83611
46312,57,6,2015,14869,6720,8149
46313,57,16,2015,3899,999,2900
46314,57,44,2015,3513,2043,1470
46315,57,17,2015,3690,1518,2172
46316,57,86,2015,344,212,132
46317,57,177,2015,8097,5798,2299
46318,57,18,2015,2902,843,2059
46319,57,167,2015,4028,3384,644
46320,57,121,2015,3650,2208,1442
46321,57,19,2015,536,219,317
46322,57,168,2015,1418,1189,229
46323,57,46,2015,3214,2572,642
46324,57,20,2015,6920,2587,4333
46325,57,149,2015,24,12,12
46326,57,159,2015,1802,327,1475
46327,57,143,2015,34955,18222,16733
46328,57,70,2015,113,57,56
46329,57,47,2015,5640,4381,1259
46330,57,71,2015,4700,2601,2099
46331,57,122,2015,2334,1649,685
46332,57,123,2015,168,94,74
46333,57,7,2015,33,7,26
46334,57,160,2015,12237,1042,11195
46335,57,58,2015,1852,1363,489
46336,57,161,2015,695,155,540
46337,57,124,2015,8860,5042,3818
46338,57,100,2015,8533,5930,2603
46339,57,72,2015,1295,698,597
46340,57,59,2015,2334,1279,1055
46341,57,144,2015,422481,188592,233889
46342,57,125,2015,1428,757,671
46343,57,150,2015,85,42,43
46344,57,8,2015,1878,801,1077
46345,57,73,2015,12747,7880,4867
46346,57,101,2015,1190,817,373
46347,57,162,2015,58257,30639,27618
46348,57,60,2015,72425,32714,39711
46349,57,48,2015,1646,1044,602
46350,57,21,2015,53,30,23
46351,57,9,2015,89137,28144,60993
46352,57,102,2015,1120,810,310
46353,57,111,2015,2642,1857,785
46354,57,112,2015,112799,70254,42545
46355,57,33,2015,114517,88014,26503
46356,57,61,2015,6201,4119,2082
46357,57,22,2015,457,284,173
46358,57,35,2015,1012177,599008,413169
46359,57,36,2015,79001,61567,17434
46360,57,126,2015,772,429,343
46361,57,90,2015,4,3,1
46362,57,91,2015,20,9,11
46363,57,92,2015,19,12,7
46364,57,62,2015,3242,2165,1077
46365,57,140,2015,71,53,18
46366,57,23,2015,968,457,511
46367,57,164,2015,87688,20510,67178
46368,57,63,2015,89708,44888,44820
46369,57,127,2015,928,740,188
46370,57,165,2015,1367,549,818
46371,57,37,2015,10603,8006,2597
46372,57,64,2015,4559,2748,1811
46373,57,128,2015,13484,5275,8209
46374,57,115,2015,5671,3285,2386
46375,57,129,2015,29,11,18
46376,57,65,2015,30897,21816,9081
46377,57,10,2015,84992,37682,47310
46378,57,145,2015,2851,658,2193
46379,57,113,2015,41,28,13
46380,57,49,2015,6265,4298,1967
46381,57,74,2015,193299,104061,89238
46382,57,25,2015,6105,2217,3888
46383,57,169,2015,202,155,47
46384,57,166,2015,5085,1842,3243
46385,57,93,2015,161,119,42
46386,57,146,2015,101334,38087,63247
46387,57,26,2015,19499,8353,11146
46388,57,170,2015,225,190,35
46389,57,130,2015,950,549,401
46390,57,38,2015,222013,176419,45594
46391,57,27,2015,373,182,191
46392,57,50,2015,61672,36286,25386
46393,57,131,2015,1590,924,666
46394,57,114,2015,7169,4085,3084
46395,57,171,2015,2509,2047,462
46396,57,1,2015,5276,2992,2284
46397,57,28,2015,266,120,146
46398,57,132,2015,867,460,407
46399,57,133,2015,849,461,388
46400,86,76,2015,153,77,76
46401,86,78,2015,662,335,327
46402,86,79,2015,533,270,263
46403,86,95,2015,7,4,3
46404,86,96,2015,99,55,44
46405,86,81,2015,1791,899,892
46406,86,82,2015,137,69,68
46407,86,97,2015,132,74,58
46408,86,84,2015,205,105,100
46409,86,98,2015,302,169,133
46410,86,99,2015,160,91,69
46411,86,5,2015,1127,421,706
46412,86,101,2015,123,69,54
46413,86,102,2015,74,41,33
46414,86,90,2015,96,49,47
46415,86,91,2015,328,165,163
46416,86,92,2015,224,114,110
46417,86,93,2015,2299,1162,1137
46418,86,50,2015,4739,2420,2319
46419,177,103,2015,2924,1620,1304
46420,177,66,2015,548,303,245
46421,177,3,2015,10835,6001,4834
46422,177,67,2015,685,378,307
46423,177,105,2015,173437,86535,86902
46424,177,172,2015,714570,376766,337804
46425,177,39,2015,574,317,257
46426,177,142,2015,1747,967,780
46427,177,42,2015,678,375,303
46428,177,68,2015,10672,5911,4761
46429,177,69,2015,6336,3510,2826
46430,177,156,2015,2005,1110,895
46431,177,5,2015,26244,14538,11706
46432,177,6,2015,4359,2415,1944
46433,177,44,2015,1140,631,509
46434,177,57,2015,3536,1958,1578
46435,177,100,2015,2141,1185,956
46436,177,73,2015,1046,578,468
46437,177,162,2015,2638,1460,1178
46438,177,48,2015,456,252,204
46439,177,9,2015,12708,7039,5669
46440,177,112,2015,47721,26436,21285
46441,177,33,2015,1653,915,738
46442,177,61,2015,467,258,209
46443,177,36,2015,8092,4482,3610
46444,177,65,2015,2495,1382,1113
46445,177,10,2015,13152,7284,5868
46446,177,49,2015,1805,1000,805
46447,177,74,2015,1060,587,473
46448,177,50,2015,15826,8766,7060
46449,177,1,2015,146956,76634,70322
46450,18,2,2015,49,19,30
46451,18,141,2015,267,159,108
46452,18,66,2015,91,39,52
46453,18,13,2015,330,131,199
46454,18,3,2015,9021,2567,6454
46455,18,11,2015,21,15,6
46456,18,67,2015,57,29,28
46457,18,53,2015,47,26,21
46458,18,105,2015,82,43,39
46459,18,30,2015,39,23,16
46460,18,10,2015,9689,8787,902
46461,18,136,2015,21,4,17
46462,18,172,2015,16121,11800,4321
46463,18,107,2015,20,12,8
46464,18,54,2015,21,15,6
46465,18,14,2015,102,54,48
46466,18,31,2015,19,12,7
46467,18,39,2015,39,19,20
46468,18,120,2015,60,55,5
46469,18,119,2015,58,26,32
46470,18,68,2015,307,150,157
46471,18,69,2015,556,263,293
46472,18,156,2015,21,7,14
46473,18,56,2015,48,31,17
46474,18,173,2015,30,12,18
46475,18,32,2015,456,260,196
46476,18,5,2015,4587,588,3999
46477,18,6,2015,73,37,36
46478,18,16,2015,158951,75252,83699
46479,18,44,2015,41,23,18
46480,18,17,2015,1219,408,811
46481,18,57,2015,240,127,113
46482,18,177,2015,81,28,53
46483,18,167,2015,16,11,5
46484,18,176,2015,65,19,46
46485,18,19,2015,584,169,415
46486,18,20,2015,1427,796,631
46487,18,143,2015,15094,5211,9883
46488,18,161,2015,54,12,42
46489,18,144,2015,465,364,101
46490,18,21,2015,494,258,236
46491,18,8,2015,141,60,81
46492,18,73,2015,155,79,76
46493,18,162,2015,21,7,14
46494,18,48,2015,34,19,15
46495,18,9,2015,2526,1038,1488
46496,18,33,2015,64,39,25
46497,18,22,2015,173,46,127
46498,18,35,2015,210,167,43
46499,18,36,2015,463,345,118
46500,18,23,2015,3908,1283,2625
46501,18,63,2015,45,38,7
46502,18,37,2015,18,12,6
46503,18,128,2015,591,262,329
46504,18,115,2015,45,15,30
46505,18,65,2015,237,141,96
46506,18,129,2015,215,76,139
46507,18,145,2015,4145,1840,2305
46508,18,49,2015,70,40,30
46509,18,74,2015,155,77,78
46510,18,25,2015,674705,336852,337853
46511,18,27,2015,163,68,95
46512,18,146,2015,201,100,101
46513,18,26,2015,797,202,595
46514,18,38,2015,308,265,43
46515,18,60,2015,69,49,20
46516,18,142,2015,78178,26988,51190
46517,18,50,2015,628,271,357
46518,18,28,2015,22918,9042,13876
46519,167,12,2015,48377,21223,27154
46520,167,11,2015,9144,3741,5403
46521,167,29,2015,69136,34435,34701
46522,167,172,2015,2162,935,1227
46523,167,40,2015,1113,585,528
46524,167,15,2015,3275,1227,2048
46525,167,176,2015,61600,29876,31724
46526,167,168,2015,6734,3508,3226
46527,167,46,2015,1113,525,588
46528,167,47,2015,4386,1988,2398
46529,167,36,2015,2352598,1208025,1144573
46530,167,169,2015,15816,7133,8683
46531,167,26,2015,46894,21923,24971
46532,167,170,2015,1050,409,641
46533,167,38,2015,338022,170891,167131
46534,167,171,2015,281713,132387,149326
46535,121,116,2015,8312,4156,4156
46536,121,137,2015,24738,12369,12369
46537,121,120,2015,36889,16857,20032
46538,121,119,2015,2127,1070,1057
46539,121,125,2015,601,303,298
46540,121,150,2015,68,35,33
46541,121,126,2015,6330,3188,3142
46542,121,128,2015,488470,238175,250295
46543,121,115,2015,112,58,54
46544,121,129,2015,95765,47882,47883
46545,121,145,2015,10266,5133,5133
46546,121,130,2015,333789,175993,157796
46547,121,131,2015,39935,20112,19823
46548,19,2,2015,2669,1057,1612
46549,19,13,2015,1297,940,357
46550,19,3,2015,350229,58212,292017
46551,19,10,2015,36556,20681,15875
46552,19,136,2015,1305,517,788
46553,19,120,2015,3595,1424,2171
46554,19,119,2015,4725,1872,2853
46555,19,68,2015,4810,2256,2554
46556,19,5,2015,1061758,313209,748549
46557,19,18,2015,50399,22280,28119
46558,19,20,2015,11532,4570,6962
46559,19,144,2015,2795,1108,1687
46560,19,8,2015,22678,8995,13683
46561,19,73,2015,980,480,500
46562,19,162,2015,4441,1760,2681
46563,19,9,2015,312434,88352,224082
46564,19,22,2015,623,502,121
46565,19,23,2015,2077,800,1277
46566,19,128,2015,3168,1254,1914
46567,19,129,2015,1726,766,960
46568,19,145,2015,45525,20209,25316
46569,19,25,2015,21340,8460,12880
46570,19,27,2015,24662,14368,10294
46571,19,146,2015,1784,707,1077
46572,19,26,2015,12297,4874,7423
46573,19,142,2015,387993,163606,224387
46574,19,50,2015,9394,4059,5335
46575,19,28,2015,65129,25819,39310
46576,168,12,2015,4678,2323,2355
46577,168,11,2015,2380,1165,1215
46578,168,29,2015,9947,6268,3679
46579,168,172,2015,271,135,136
46580,168,40,2015,573,338,235
46581,168,42,2015,116,50,66
46582,168,15,2015,3270,1702,1568
46583,168,69,2015,1820,1065,755
46584,168,167,2015,12940,7950,4990
46585,168,176,2015,1777,994,783
46586,168,46,2015,902,527,375
46587,168,47,2015,2649,1559,1090
46588,168,33,2015,3212,2000,1212
46589,168,35,2015,482,265,217
46590,168,36,2015,111753,67502,44251
46591,168,1,2015,107,39,68
46592,168,169,2015,2205,1140,1065
46593,168,26,2015,1051,554,497
46594,168,170,2015,1001,579,422
46595,168,38,2015,26771,16340,10431
46596,168,171,2015,9183,5168,4015
46597,46,2,2015,27,6,21
46598,46,51,2015,9,4,5
46599,46,141,2015,15,3,12
46600,46,52,2015,0,0,0
46601,46,134,2015,2,1,1
46602,46,75,2015,0,0,0
46603,46,76,2015,1,1,0
46604,46,103,2015,12,8,4
46605,46,11,2015,693,268,425
46606,46,77,2015,1,0,1
46607,46,66,2015,90,38,52
46608,46,12,2015,1922,823,1099
46609,46,13,2015,1,0,1
46610,46,3,2015,5,1,4
46611,46,79,2015,2,2,0
46612,46,29,2015,48588,31843,16745
46613,46,67,2015,111,51,60
46614,46,151,2015,2,0,2
46615,46,53,2015,7,1,6
46616,46,147,2015,1,1,0
46617,46,105,2015,21,6,15
46618,46,30,2015,157,55,102
46619,46,116,2015,1,0,1
46620,46,153,2015,0,0,0
46621,46,135,2015,1,0,1
46622,46,106,2015,5,1,4
46623,46,172,2015,268,116,152
46624,46,107,2015,6,4,2
46625,46,137,2015,0,0,0
46626,46,96,2015,2,1,1
46627,46,54,2015,7,2,5
46628,46,81,2015,46,17,29
46629,46,14,2015,44,18,26
46630,46,31,2015,137,89,48
46631,46,176,2015,11,5,6
46632,46,137,2015,0,0,0
46633,46,39,2015,203,43,160
46634,46,83,2015,1,1,0
46635,46,108,2015,2,2,0
46636,46,142,2015,37,9,28
46637,46,119,2015,0,0,0
46638,46,40,2015,3081,1678,1403
46639,46,41,2015,2,1,1
46640,46,42,2015,170,75,95
46641,46,68,2015,181,75,106
46642,46,139,2015,1,0,1
46643,46,155,2015,0,0,0
46644,46,15,2015,1317,597,720
46645,46,69,2015,2424,1264,1160
46646,46,156,2015,5,0,5
46647,46,56,2015,42,18,24
46648,46,98,2015,1,0,1
46649,46,32,2015,193,106,87
46650,46,43,2015,29,11,18
46651,46,5,2015,131,13,118
46652,46,6,2015,35,13,22
46653,46,16,2015,33,16,17
46654,46,44,2015,731,313,418
46655,46,17,2015,78,32,46
46656,46,57,2015,249,74,175
46657,46,86,2015,1,0,1
46658,46,177,2015,16,9,7
46659,46,18,2015,4,0,4
46660,46,167,2015,5931,3272,2659
46661,46,121,2015,3,1,2
46662,46,19,2015,3,0,3
46663,46,168,2015,809,456,353
46664,46,20,2015,29,3,26
46665,46,143,2015,3,2,1
46666,46,70,2015,1,0,1
46667,46,47,2015,16668,10221,6447
46668,46,71,2015,7,5,2
46669,46,122,2015,0,0,0
46670,46,123,2015,0,0,0
46671,46,160,2015,2,0,2
46672,46,58,2015,6,1,5
46673,46,161,2015,1,0,1
46674,46,124,2015,2,1,1
46675,46,100,2015,13,2,11
46676,46,72,2015,1,0,1
46677,46,59,2015,0,0,0
46678,46,144,2015,12,1,11
46679,46,125,2015,1,0,1
46680,46,150,2015,1,1,0
46681,46,8,2015,16,2,14
46682,46,73,2015,135,43,92
46683,46,101,2015,0,0,0
46684,46,162,2015,13,1,12
46685,46,60,2015,12,4,8
46686,46,48,2015,325,141,184
46687,46,9,2015,24,3,21
46688,46,111,2015,3,1,2
46689,46,112,2015,7,2,5
46690,46,33,2015,832,460,372
46691,46,61,2015,48,17,31
46692,46,22,2015,1,1,0
46693,46,35,2015,68,32,36
46694,46,36,2015,136376,86507,49869
46695,46,126,2015,1,0,1
46696,46,23,2015,5,2,3
46697,46,63,2015,10,2,8
46698,46,165,2015,1,0,1
46699,46,37,2015,22,9,13
46700,46,64,2015,6,3,3
46701,46,128,2015,5,1,4
46702,46,115,2015,13,4,9
46703,46,129,2015,0,0,0
46704,46,65,2015,148,52,96
46705,46,10,2015,28,10,18
46706,46,145,2015,3,1,2
46707,46,49,2015,324,131,193
46708,46,74,2015,56,23,33
46709,46,25,2015,22,4,18
46710,46,169,2015,536,279,257
46711,46,166,2015,0,0,0
46712,46,93,2015,1,1,0
46713,46,146,2015,2,0,2
46714,46,26,2015,108,25,83
46715,46,170,2015,589,311,278
46716,46,130,2015,0,0,0
46717,46,38,2015,34080,18439,15641
46718,46,27,2015,12,7,5
46719,46,50,2015,2218,900,1318
46720,46,131,2015,2,0,2
46721,46,114,2015,3,1,2
46722,46,171,2015,2052,1091,961
46723,46,1,2015,7,2,5
46724,46,28,2015,1,0,1
46725,46,132,2015,1,0,1
46726,46,133,2015,3,0,3
46727,20,13,2015,108,56,52
46728,20,3,2015,2957,1541,1416
46729,20,10,2015,3176,1655,1521
46730,20,172,2015,2358,1228,1130
46731,20,68,2015,101,53,48
46732,20,69,2015,183,96,87
46733,20,32,2015,150,78,72
46734,20,5,2015,1503,783,720
46735,20,16,2015,117164,61045,56119
46736,20,17,2015,400,208,192
46737,20,18,2015,468,244,224
46738,20,19,2015,192,99,93
46739,20,143,2015,248,129,119
46740,20,144,2015,153,79,74
46741,20,21,2015,163,85,78
46742,20,9,2015,827,431,396
46743,20,36,2015,153,79,74
46744,20,23,2015,1280,668,612
46745,20,129,2015,70,36,34
46746,20,145,2015,2055,1071,984
46747,20,25,2015,1194049,618308,575741
46748,20,26,2015,261,135,126
46749,20,38,2015,101,53,48
46750,20,142,2015,80893,42147,38746
46751,20,50,2015,206,107,99
46752,20,28,2015,606,316,290
46753,149,147,2015,151,82,69
46754,149,172,2015,168,71,97
46755,149,156,2015,124,40,84
46756,149,5,2015,318,138,180
46757,149,123,2015,51,19,32
46758,149,125,2015,32,9,23
46759,149,150,2015,5,1,4
46760,149,9,2015,318,138,180
46761,149,115,2015,3629,1727,1902
46762,149,133,2015,97,44,53
46763,149,148,2015,51,26,25
46764,149,130,2015,191,83,108
46765,149,131,2015,118,57,61
46766,149,132,2015,97,44,53
46767,159,151,2015,28,6,22
46768,159,68,2015,67,37,30
46769,159,155,2015,816,364,452
46770,159,69,2015,213,121,92
46771,159,156,2015,8113,3426,4687
46772,159,157,2015,32482,14564,17918
46773,159,5,2015,817,126,691
46774,159,57,2015,57,26,31
46775,159,20,2015,999,287,712
46776,159,160,2015,1454,409,1045
46777,159,73,2015,68,37,31
46778,159,162,2015,5649,1265,4384
46779,159,158,2015,521,303,218
46780,159,164,2015,392,122,270
46781,159,165,2015,14536,6688,7848
46782,159,65,2015,65,34,31
46783,159,49,2015,258,143,115
46784,159,74,2015,34,17,17
46785,159,166,2015,418,147,271
46786,159,50,2015,263,144,119
46787,159,152,2015,253,67,186
46788,143,2,2015,319,89,230
46789,143,51,2015,300,93,207
46790,143,141,2015,3577,1528,2049
46791,143,66,2015,750,348,402
46792,143,13,2015,965,232,733
46793,143,3,2015,1246,58,1188
46794,143,11,2015,255,93,162
46795,143,67,2015,673,268,405
46796,143,53,2015,328,100,228
46797,143,105,2015,255,100,155
46798,143,29,2015,759,300,459
46799,143,10,2015,366,140,226
46800,143,136,2015,858,219,639
46801,143,172,2015,3064,858,2206
46802,143,117,2015,4281,588,3693
46803,143,137,2015,401,100,301
46804,143,137,2015,433,97,336
46805,143,39,2015,768,245,523
46806,143,97,2015,706,249,457
46807,143,120,2015,1825,660,1165
46808,143,119,2015,4646,1473,3173
46809,143,42,2015,828,303,525
46810,143,68,2015,5010,1739,3271
46811,143,118,2015,1421,377,1044
46812,143,69,2015,7005,2841,4164
46813,143,156,2015,612,121,491
46814,143,56,2015,2608,1056,1552
46815,143,32,2015,337,154,183
46816,143,5,2015,4826,1088,3738
46817,143,6,2015,410,104,306
46818,143,16,2015,68240,21796,46444
46819,143,57,2015,6667,2510,4157
46820,143,177,2015,1002,359,643
46821,143,167,2015,800,154,646
46822,143,18,2015,20338,5868,14470
46823,143,121,2015,334,113,221
46824,143,19,2015,10763,2276,8487
46825,143,20,2015,11029,4123,6906
46826,143,160,2015,337,77,260
46827,143,161,2015,356,75,281
46828,143,72,2015,276,88,188
46829,143,144,2015,4883,2408,2475
46830,143,21,2015,1688,344,1344
46831,143,73,2015,1764,755,1009
46832,143,162,2015,2841,650,2191
46833,143,48,2015,334,126,208
46834,143,9,2015,2451,615,1836
46835,143,33,2015,676,357,319
46836,143,158,2015,309,1,308
46837,143,22,2015,1410,314,1096
46838,143,35,2015,594,308,286
46839,143,36,2015,7221,2584,4637
46840,143,23,2015,35352,8326,27026
46841,143,164,2015,1117,146,971
46842,143,165,2015,237,75,162
46843,143,128,2015,104178,28639,75539
46844,143,115,2015,645,188,457
46845,143,65,2015,724,275,449
46846,143,129,2015,1770,509,1261
46847,143,145,2015,14379,4137,10242
46848,143,49,2015,746,242,504
46849,143,74,2015,929,391,538
46850,143,25,2015,27666,7995,19671
46851,143,169,2015,676,146,530
46852,143,27,2015,2766,835,1931
46853,143,146,2015,3074,1157,1917
46854,143,26,2015,2527,632,1895
46855,143,170,2015,237,51,186
46856,143,38,2015,871,410,461
46857,143,142,2015,20932,6056,14876
46858,143,50,2015,7207,2562,4645
46859,143,131,2015,264,67,197
46860,143,171,2015,375,46,329
46861,143,28,2015,21266,5436,15830
46862,70,2,2015,4,1,3
46863,70,51,2015,0,0,0
46864,70,141,2015,6,3,3
46865,70,52,2015,1,1,0
46866,70,134,2015,7,1,6
46867,70,103,2015,26,16,10
46868,70,11,2015,9,5,4
46869,70,66,2015,3829,2210,1619
46870,70,12,2015,1,1,0
46871,70,78,2015,3,1,2
46872,70,3,2015,2,0,2
46873,70,29,2015,4,4,0
46874,70,67,2015,40,22,18
46875,70,53,2015,306,173,133
46876,70,105,2015,169,117,52
46877,70,30,2015,14,11,3
46878,70,152,2015,2,1,1
46879,70,135,2015,5,1,4
46880,70,106,2015,8,8,0
46881,70,172,2015,81,47,34
46882,70,107,2015,41,30,11
46883,70,96,2015,5,3,2
46884,70,54,2015,118,61,57
46885,70,81,2015,9,4,5
46886,70,31,2015,58,40,18
46887,70,137,2015,3,0,3
46888,70,39,2015,16,8,8
46889,70,83,2015,73,53,20
46890,70,108,2015,11,8,3
46891,70,142,2015,19,5,14
46892,70,97,2015,1,0,1
46893,70,119,2015,7,1,6
46894,70,40,2015,2,2,0
46895,70,120,2015,10,4,6
46896,70,42,2015,8,5,3
46897,70,68,2015,125,60,65
46898,70,155,2015,0,0,0
46899,70,15,2015,1,1,0
46900,70,69,2015,1787,932,855
46901,70,56,2015,46,20,26
46902,70,98,2015,5,4,1
46903,70,157,2015,0,0,0
46904,70,85,2015,1,1,0
46905,70,99,2015,1,1,0
46906,70,32,2015,70,45,25
46907,70,43,2015,1,0,1
46908,70,5,2015,27,10,17
46909,70,6,2015,11,7,4
46910,70,16,2015,5,2,3
46911,70,44,2015,17,9,8
46912,70,17,2015,6,5,1
46913,70,57,2015,860,315,545
46914,70,86,2015,3,1,2
46915,70,177,2015,13,5,8
46916,70,18,2015,2,1,1
46917,70,167,2015,5,4,1
46918,70,121,2015,6,4,2
46919,70,19,2015,1,0,1
46920,70,168,2015,4,3,1
46921,70,46,2015,6,4,2
46922,70,143,2015,1,1,0
46923,70,47,2015,4,3,1
46924,70,71,2015,3,2,1
46925,70,122,2015,2,0,2
46926,70,7,2015,2,0,2
46927,70,58,2015,3,1,2
46928,70,124,2015,1,1,0
46929,70,100,2015,24,15,9
46930,70,72,2015,1,0,1
46931,70,59,2015,4,1,3
46932,70,144,2015,15,8,7
46933,70,125,2015,3,1,2
46934,70,8,2015,4,1,3
46935,70,73,2015,75,42,33
46936,70,101,2015,3,2,1
46937,70,162,2015,6,2,4
46938,70,60,2015,88,49,39
46939,70,48,2015,6,4,2
46940,70,9,2015,7,3,4
46941,70,102,2015,7,4,3
46942,70,111,2015,2,2,0
46943,70,112,2015,15,7,8
46944,70,33,2015,60,47,13
46945,70,61,2015,424,201,223
46946,70,35,2015,29,22,7
46947,70,36,2015,53,41,12
46948,70,91,2015,1,0,1
46949,70,164,2015,2,1,1
46950,70,63,2015,397,192,205
46951,70,127,2015,1,0,1
46952,70,37,2015,44,35,9
46953,70,64,2015,109,82,27
46954,70,128,2015,18,7,11
46955,70,115,2015,34,22,12
46956,70,65,2015,275,125,150
46957,70,10,2015,8,3,5
46958,70,49,2015,25,16,9
46959,70,74,2015,12882,6286,6596
46960,70,25,2015,7,2,5
46961,70,93,2015,1,1,0
46962,70,146,2015,24,9,15
46963,70,26,2015,608,290,318
46964,70,130,2015,1,1,0
46965,70,38,2015,38,28,10
46966,70,27,2015,3,1,2
46967,70,50,2015,67,32,35
46968,70,131,2015,3,1,2
46969,70,114,2015,2,2,0
46970,70,171,2015,4,1,3
46971,70,1,2015,12,7,5
46972,70,132,2015,1,1,0
46973,70,133,2015,3,3,0
46974,47,2,2015,20,4,16
46975,47,51,2015,4,1,3
46976,47,141,2015,8,3,5
46977,47,134,2015,1,0,1
46978,47,103,2015,53,29,24
46979,47,11,2015,579,196,383
46980,47,77,2015,2,1,1
46981,47,66,2015,60,26,34
46982,47,12,2015,878,316,562
46983,47,78,2015,1,0,1
46984,47,13,2015,2,1,1
46985,47,3,2015,5,0,5
46986,47,29,2015,33613,21572,12041
46987,47,67,2015,181,73,108
46988,47,95,2015,1,0,1
46989,47,151,2015,1,0,1
46990,47,53,2015,3,0,3
46991,47,105,2015,61,40,21
46992,47,30,2015,74,20,54
46993,47,135,2015,7,3,4
46994,47,106,2015,6,2,4
46995,47,172,2015,53,53,0
46996,47,107,2015,10,5,5
46997,47,137,2015,5,2,3
46998,47,54,2015,7,4,3
46999,47,81,2015,16,8,8
47000,47,14,2015,33,14,19
47001,47,31,2015,87,48,39
47002,47,176,2015,7,5,2
47003,47,137,2015,3,1,2
47004,47,39,2015,377,157,220
47005,47,82,2015,1,0,1
47006,47,108,2015,1,0,1
47007,47,142,2015,54,16,38
47008,47,119,2015,5,3,2
47009,47,40,2015,816,450,366
47010,47,120,2015,1,0,1
47011,47,42,2015,108,41,67
47012,47,68,2015,334,156,178
47013,47,155,2015,1,0,1
47014,47,15,2015,656,267,389
47015,47,69,2015,1628,786,842
47016,47,156,2015,4,1,3
47017,47,56,2015,55,18,37
47018,47,157,2015,2,0,2
47019,47,110,2015,0,0,0
47020,47,99,2015,2,0,2
47021,47,32,2015,101,53,48
47022,47,43,2015,54,30,24
47023,47,5,2015,11,0,11
47024,47,6,2015,121,30,91
47025,47,16,2015,16,3,13
47026,47,44,2015,1465,706,759
47027,47,17,2015,18,18,0
47028,47,57,2015,355,107,248
47029,47,86,2015,1,1,0
47030,47,177,2015,26,15,11
47031,47,18,2015,2,2,0
47032,47,167,2015,4477,2519,1958
47033,47,121,2015,5,4,1
47034,47,19,2015,11,3,8
47035,47,168,2015,380,218,162
47036,47,46,2015,5630,3223,2407
47037,47,20,2015,31,8,23
47038,47,159,2015,6,3,3
47039,47,143,2015,5,0,5
47040,47,71,2015,18,3,15
47041,47,122,2015,2,1,1
47042,47,123,2015,1,1,0
47043,47,7,2015,0,0,0
47044,47,160,2015,2,0,2
47045,47,58,2015,9,2,7
47046,47,161,2015,1,0,1
47047,47,124,2015,3,0,3
47048,47,100,2015,16,2,14
47049,47,72,2015,2,0,2
47050,47,144,2015,3,0,3
47051,47,125,2015,0,0,0
47052,47,150,2015,3,1,2
47053,47,8,2015,12,3,9
47054,47,73,2015,166,59,107
47055,47,101,2015,0,0,0
47056,47,162,2015,15,0,15
47057,47,60,2015,4,2,2
47058,47,48,2015,1418,673,745
47059,47,21,2015,1,1,0
47060,47,9,2015,91,6,85
47061,47,111,2015,3,1,2
47062,47,112,2015,5,4,1
47063,47,33,2015,2167,1319,848
47064,47,61,2015,65,17,48
47065,47,22,2015,2,2,0
47066,47,35,2015,211,21,190
47067,47,36,2015,58511,34598,23913
47068,47,126,2015,2,1,1
47069,47,23,2015,8,0,8
47070,47,63,2015,2,2,0
47071,47,37,2015,38,20,18
47072,47,64,2015,3,1,2
47073,47,128,2015,2,0,2
47074,47,115,2015,8,4,4
47075,47,65,2015,630,266,364
47076,47,10,2015,3,3,0
47077,47,145,2015,2,1,1
47078,47,113,2015,1,0,1
47079,47,49,2015,312,138,174
47080,47,74,2015,61,24,37
47081,47,25,2015,20,3,17
47082,47,169,2015,338,170,168
47083,47,166,2015,1,0,1
47084,47,146,2015,12,5,7
47085,47,26,2015,64,14,50
47086,47,170,2015,236,146,90
47087,47,130,2015,1,0,1
47088,47,38,2015,12347,6424,5923
47089,47,27,2015,35,15,20
47090,47,50,2015,4306,2121,2185
47091,47,131,2015,3,1,2
47092,47,114,2015,25,16,9
47093,47,171,2015,945,513,432
47094,47,1,2015,35,15,20
47095,47,132,2015,1,1,0
47096,47,133,2015,1,0,1
47097,71,2,2015,0,0,0
47098,71,51,2015,300,123,177
47099,71,141,2015,100,45,55
47100,71,52,2015,0,0,0
47101,71,134,2015,0,0,0
47102,71,76,2015,0,0,0
47103,71,103,2015,39,16,23
47104,71,11,2015,0,0,0
47105,71,77,2015,0,0,0
47106,71,66,2015,967,548,419
47107,71,12,2015,0,0,0
47108,71,78,2015,0,0,0
47109,71,13,2015,0,0,0
47110,71,3,2015,30,10,20
47111,71,79,2015,0,0,0
47112,71,29,2015,42,34,8
47113,71,67,2015,19800,9688,10112
47114,71,151,2015,0,0,0
47115,71,4,2015,0,0,0
47116,71,53,2015,2421,1019,1402
47117,71,147,2015,0,0,0
47118,71,105,2015,297,171,126
47119,71,30,2015,878,576,302
47120,71,152,2015,0,0,0
47121,71,116,2015,0,0,0
47122,71,153,2015,1617,755,862
47123,71,135,2015,59,31,28
47124,71,136,2015,0,0,0
47125,71,106,2015,57,24,33
47126,71,172,2015,1054,459,595
47127,71,107,2015,25,15,10
47128,71,117,2015,0,0,0
47129,71,137,2015,0,0,0
47130,71,96,2015,0,0,0
47131,71,54,2015,413,171,242
47132,71,81,2015,22,12,10
47133,71,14,2015,62,30,32
47134,71,31,2015,906,603,303
47135,71,176,2015,0,0,0
47136,71,137,2015,97,43,54
47137,71,39,2015,2535,1294,1241
47138,71,118,2015,0,0,0
47139,71,82,2015,115,70,45
47140,71,83,2015,35,19,16
47141,71,108,2015,0,0,0
47142,71,142,2015,25,9,16
47143,71,97,2015,0,0,0
47144,71,138,2015,0,0,0
47145,71,119,2015,0,0,0
47146,71,40,2015,526,419,107
47147,71,148,2015,0,0,0
47148,71,120,2015,0,0,0
47149,71,42,2015,1302,760,542
47150,71,68,2015,36180,18891,17289
47151,71,139,2015,0,0,0
47152,71,155,2015,0,0,0
47153,71,15,2015,0,0,0
47154,71,69,2015,14125,7635,6490
47155,71,156,2015,0,0,0
47156,71,55,2015,0,0,0
47157,71,56,2015,1823,899,924
47158,71,84,2015,0,0,0
47159,71,98,2015,0,0,0
47160,71,157,2015,0,0,0
47161,71,158,2015,0,0,0
47162,71,110,2015,0,0,0
47163,71,85,2015,0,0,0
47164,71,99,2015,0,0,0
47165,71,32,2015,1084,715,369
47166,71,43,2015,328,160,168
47167,71,5,2015,193,84,109
47168,71,6,2015,231,94,137
47169,71,16,2015,0,0,0
47170,71,44,2015,1627,842,785
47171,71,17,2015,41,15,26
47172,71,57,2015,20621,9987,10634
47173,71,86,2015,0,0,0
47174,71,177,2015,282,133,149
47175,71,18,2015,0,0,0
47176,71,167,2015,0,0,0
47177,71,121,2015,0,0,0
47178,71,19,2015,0,0,0
47179,71,168,2015,0,0,0
47180,71,46,2015,488,411,77
47181,71,20,2015,35,18,17
47182,71,159,2015,0,0,0
47183,71,143,2015,0,0,0
47184,71,70,2015,0,0,0
47185,71,47,2015,599,390,209
47186,71,122,2015,0,0,0
47187,71,123,2015,0,0,0
47188,71,160,2015,0,0,0
47189,71,58,2015,270,109,161
47190,71,161,2015,0,0,0
47191,71,124,2015,51,31,20
47192,71,100,2015,27,18,9
47193,71,72,2015,0,0,0
47194,71,59,2015,8543,3378,5165
47195,71,144,2015,244,120,124
47196,71,125,2015,0,0,0
47197,71,150,2015,0,0,0
47198,71,8,2015,30,7,23
47199,71,73,2015,4463,2221,2242
47200,71,101,2015,0,0,0
47201,71,162,2015,0,0,0
47202,71,60,2015,346,135,211
47203,71,48,2015,175,70,105
47204,71,21,2015,0,0,0
47205,71,9,2015,0,0,0
47206,71,102,2015,0,0,0
47207,71,111,2015,0,0,0
47208,71,112,2015,99,52,47
47209,71,33,2015,3150,1924,1226
47210,71,61,2015,94732,45347,49385
47211,71,22,2015,0,0,0
47212,71,35,2015,1739,1144,595
47213,71,36,2015,390,247,143
47214,71,126,2015,25,12,13
47215,71,92,2015,0,0,0
47216,71,62,2015,0,0,0
47217,71,140,2015,0,0,0
47218,71,23,2015,0,0,0
47219,71,164,2015,30,12,18
47220,71,63,2015,5920,2293,3627
47221,71,127,2015,0,0,0
47222,71,165,2015,0,0,0
47223,71,37,2015,707,390,317
47224,71,64,2015,483,237,246
47225,71,128,2015,0,0,0
47226,71,115,2015,45,19,26
47227,71,65,2015,3998,2042,1956
47228,71,10,2015,0,0,0
47229,71,145,2015,0,0,0
47230,71,113,2015,0,0,0
47231,71,49,2015,2059,1108,951
47232,71,74,2015,532,258,274
47233,71,25,2015,0,0,0
47234,71,169,2015,0,0,0
47235,71,166,2015,0,0,0
47236,71,93,2015,0,0,0
47237,71,146,2015,134,39,95
47238,71,26,2015,201,85,116
47239,71,170,2015,0,0,0
47240,71,130,2015,0,0,0
47241,71,38,2015,175,130,45
47242,71,27,2015,0,0,0
47243,71,50,2015,6604,2974,3630
47244,71,131,2015,0,0,0
47245,71,114,2015,0,0,0
47246,71,171,2015,0,0,0
47247,71,1,2015,71,42,29
47248,71,28,2015,0,0,0
47249,71,132,2015,0,0,0
47250,71,133,2015,0,0,0
47251,174,172,2015,280130,148392,131738
47252,174,173,2015,20984,8442,12542
47253,174,61,2015,1960,915,1045
47254,122,172,2015,1979,867,1112
47255,122,117,2015,10953,4715,6238
47256,122,68,2015,8950,3848,5102
47257,122,5,2015,1581,681,900
47258,123,116,2015,6659,3078,3581
47259,123,137,2015,1216,561,655
47260,123,137,2015,11896,5603,6293
47261,123,5,2015,2083,971,1112
47262,123,125,2015,47220,22867,24353
47263,123,126,2015,5582,2667,2915
47264,123,128,2015,74,33,41
47265,123,115,2015,7124,3984,3140
47266,123,50,2015,1272,622,650
47267,123,131,2015,8285,4659,3626
47268,123,132,2015,36918,22116,14802
47269,123,133,2015,32030,18257,13773
47270,7,66,2015,23,3,20
47271,7,3,2015,37034,478,36556
47272,7,10,2015,6772,944,5828
47273,7,68,2015,115,14,101
47274,7,69,2015,250,31,219
47275,7,5,2015,13364,3543,9821
47276,7,57,2015,164,73,91
47277,7,177,2015,109,83,26
47278,7,20,2015,10,1,9
47279,7,9,2015,303,59,244
47280,7,49,2015,36,4,32
47281,7,74,2015,118,15,103
47282,7,142,2015,37,4,33
47283,7,50,2015,103,38,65
47284,160,2,2015,473,105,368
47285,160,51,2015,1264,698,566
47286,160,141,2015,473,171,302
47287,160,52,2015,1027,487,540
47288,160,134,2015,1542,816,726
47289,160,135,2015,1778,871,907
47290,160,136,2015,593,303,290
47291,160,106,2015,1528,698,830
47292,160,172,2015,3439,1530,1909
47293,160,137,2015,10473,5011,5462
47294,160,137,2015,2226,1134,1092
47295,160,54,2015,975,355,620
47296,160,151,2015,1594,673,921
47297,160,138,2015,803,407,396
47298,160,68,2015,5362,2518,2844
47299,160,139,2015,11817,5857,5960
47300,160,155,2015,1237,632,605
47301,160,156,2015,4993,2203,2790
47302,160,84,2015,369,210,159
47303,160,157,2015,35755,17318,18437
47304,160,17,2015,1330,619,711
47305,160,177,2015,631,316,315
47306,160,167,2015,1830,778,1052
47307,160,176,2015,1764,975,789
47308,160,159,2015,1119,632,487
47309,160,143,2015,1080,407,673
47310,160,161,2015,13539,6126,7413
47311,160,144,2015,777,462,315
47312,160,162,2015,3636,1766,1870
47313,160,158,2015,355,237,118
47314,160,36,2015,381,198,183
47315,160,126,2015,473,198,275
47316,160,23,2015,1448,816,632
47317,160,164,2015,20671,10367,10304
47318,160,165,2015,2107,1134,973
47319,160,115,2015,553,185,368
47320,160,145,2015,606,250,356
47321,160,166,2015,3833,1688,2145
47322,160,27,2015,3030,1450,1580
47323,160,94,2015,659,369,290
47324,160,142,2015,724,382,342
47325,160,131,2015,881,540,341
47326,160,152,2015,53080,24416,28664
47327,160,114,2015,500,264,236
47328,160,132,2015,579,341,238
47329,58,51,2015,106,54,52
47330,58,141,2015,72,19,53
47331,58,103,2015,14,1,13
47332,58,11,2015,38,21,17
47333,58,66,2015,153,70,83
47334,58,3,2015,11,5,6
47335,58,29,2015,9,4,5
47336,58,67,2015,230,89,141
47337,58,53,2015,227,70,157
47338,58,105,2015,133,66,67
47339,58,30,2015,1253,606,647
47340,58,172,2015,495,266,229
47341,58,54,2015,101,38,63
47342,58,14,2015,61,23,38
47343,58,31,2015,112,70,42
47344,58,39,2015,181,70,111
47345,58,142,2015,648,188,460
47346,58,119,2015,929,456,473
47347,58,120,2015,475,213,262
47348,58,42,2015,109,66,43
47349,58,68,2015,596,283,313
47350,58,15,2015,55,27,28
47351,58,69,2015,1363,671,692
47352,58,156,2015,93,10,83
47353,58,56,2015,106,29,77
47354,58,32,2015,199,120,79
47355,58,5,2015,364,113,251
47356,58,6,2015,41,19,22
47357,58,16,2015,114,34,80
47358,58,44,2015,377,192,185
47359,58,17,2015,15,3,12
47360,58,57,2015,2166,637,1529
47361,58,177,2015,62,45,17
47362,58,18,2015,54,7,47
47363,58,121,2015,45,27,18
47364,58,19,2015,79,24,55
47365,58,46,2015,106,50,56
47366,58,20,2015,89,24,65
47367,58,143,2015,1745,858,887
47368,58,47,2015,61,41,20
47369,58,144,2015,309,212,97
47370,58,73,2015,589,249,340
47371,58,162,2015,471,133,338
47372,58,60,2015,41,11,30
47373,58,48,2015,91,23,68
47374,58,9,2015,253,125,128
47375,58,112,2015,38,23,15
47376,58,33,2015,344,212,132
47377,58,61,2015,79,32,47
47378,58,35,2015,940,492,448
47379,58,36,2015,1315,858,457
47380,58,23,2015,36,16,20
47381,58,63,2015,764,263,501
47382,58,37,2015,141,91,50
47383,58,64,2015,29,12,17
47384,58,128,2015,1882,925,957
47385,58,115,2015,241,110,131
47386,58,65,2015,209,97,112
47387,58,10,2015,23,8,15
47388,58,145,2015,186,91,95
47389,58,49,2015,645,248,397
47390,58,74,2015,143,63,80
47391,58,25,2015,1488,731,757
47392,58,93,2015,17,8,9
47393,58,146,2015,446,177,269
47394,58,26,2015,318,94,224
47395,58,38,2015,399,275,124
47396,58,27,2015,35,10,25
47397,58,50,2015,14361,6748,7613
47398,58,171,2015,27,19,8
47399,58,133,2015,49,16,33
47400,161,141,2015,1634,549,1085
47401,161,103,2015,66,24,42
47402,161,67,2015,60,24,36
47403,161,105,2015,159,57,102
47404,161,135,2015,392,136,256
47405,161,136,2015,51,17,34
47406,161,172,2015,158,103,55
47407,161,137,2015,90,35,55
47408,161,151,2015,551,220,331
47409,161,139,2015,84,33,51
47410,161,156,2015,206,112,94
47411,161,157,2015,3105,1628,1477
47412,161,16,2015,112,45,67
47413,161,57,2015,54,22,32
47414,161,19,2015,31,14,17
47415,161,20,2015,118,53,65
47416,161,143,2015,138,57,81
47417,161,160,2015,104491,44733,59758
47418,161,144,2015,342,138,204
47419,161,158,2015,1203,655,548
47420,161,36,2015,60,11,49
47421,161,23,2015,305,118,187
47422,161,164,2015,17630,7195,10435
47423,161,65,2015,84,30,54
47424,161,25,2015,322,133,189
47425,161,166,2015,144,75,69
47426,161,27,2015,68,30,38
47427,161,146,2015,248,108,140
47428,161,142,2015,225,95,130
47429,124,3,2015,8327,5224,3103
47430,124,67,2015,118,25,93
47431,124,10,2015,1126,827,299
47432,124,172,2015,2951,1764,1187
47433,124,68,2015,1505,596,909
47434,124,69,2015,136,65,71
47435,124,173,2015,23,7,16
47436,124,5,2015,8651,1416,7235
47437,124,44,2015,50,22,28
47438,124,57,2015,146,60,86
47439,124,177,2015,9,5,4
47440,124,122,2015,2277,1030,1247
47441,124,9,2015,187,106,81
47442,124,36,2015,49,27,22
47443,124,127,2015,124,78,46
47444,124,115,2015,622,337,285
47445,124,65,2015,27,9,18
47446,124,74,2015,105,28,77
47447,124,50,2015,454,225,229
47448,100,141,2015,102,28,74
47449,100,134,2015,54,28,26
47450,100,103,2015,15214,7427,7787
47451,100,66,2015,524,260,264
47452,100,3,2015,51,11,40
47453,100,11,2015,100,50,50
47454,100,67,2015,885,403,482
47455,100,105,2015,6350,3399,2951
47456,100,95,2015,1940,1027,913
47457,100,30,2015,258,146,112
47458,100,135,2015,41,8,33
47459,100,106,2015,6121,3093,3028
47460,100,172,2015,8849,3219,5630
47461,100,107,2015,18461,10662,7799
47462,100,137,2015,81,26,55
47463,100,96,2015,3128,1581,1547
47464,100,54,2015,55,28,27
47465,100,81,2015,12348,5758,6590
47466,100,31,2015,344,220,124
47467,100,39,2015,264,111,153
47468,100,83,2015,2832,1696,1136
47469,100,108,2015,3189,1834,1355
47470,100,97,2015,10427,5188,5239
47471,100,42,2015,153,95,58
47472,100,68,2015,9635,4404,5231
47473,100,69,2015,6630,3158,3472
47474,100,56,2015,261,84,177
47475,100,98,2015,42221,22585,19636
47476,100,85,2015,570,274,296
47477,100,99,2015,14623,8123,6500
47478,100,32,2015,386,240,146
47479,100,5,2015,1965,531,1434
47480,100,6,2015,285,97,188
47481,100,16,2015,49,9,40
47482,100,44,2015,282,97,185
47483,100,17,2015,1932,777,1155
47484,100,57,2015,5806,1569,4237
47485,100,86,2015,132,54,78
47486,100,177,2015,3753,1506,2247
47487,100,18,2015,43,9,34
47488,100,121,2015,68,28,40
47489,100,176,2015,1719,613,1106
47490,100,20,2015,527,211,316
47491,100,46,2015,35,22,13
47492,100,47,2015,61,43,18
47493,100,144,2015,244,93,151
47494,100,73,2015,1309,418,891
47495,100,101,2015,3924,2117,1807
47496,100,162,2015,144,31,113
47497,100,48,2015,185,66,119
47498,100,9,2015,150,34,116
47499,100,102,2015,1612,675,937
47500,100,111,2015,529,307,222
47501,100,112,2015,4730,1611,3119
47502,100,33,2015,682,357,325
47503,100,61,2015,570,170,400
47504,100,88,2015,1120,470,650
47505,100,35,2015,415,265,150
47506,100,36,2015,1664,1061,603
47507,100,23,2015,111,29,82
47508,100,164,2015,33,13,20
47509,100,63,2015,61,35,26
47510,100,37,2015,108,73,35
47511,100,1,2015,84,41,43
47512,100,64,2015,54,29,25
47513,100,115,2015,202,88,114
47514,100,65,2015,22544,9996,12548
47515,100,49,2015,647,280,367
47516,100,74,2015,1527,689,838
47517,100,25,2015,200,68,132
47518,100,93,2015,28,13,15
47519,100,26,2015,282,99,183
47520,100,38,2015,344,226,118
47521,100,142,2015,203,43,160
47522,100,50,2015,3536,1772,1764
47523,100,114,2015,3163,1908,1255
47524,72,68,2015,7611,4326,3285
47525,72,57,2015,5841,2625,3216
47526,59,51,2015,2754,1611,1143
47527,59,66,2015,257,177,80
47528,59,53,2015,32042,19223,12819
47529,59,30,2015,78,14,64
47530,59,54,2015,15486,9720,5766
47531,59,31,2015,120,51,69
47532,59,39,2015,97,78,19
47533,59,68,2015,446,309,137
47534,59,69,2015,1876,1278,598
47535,59,56,2015,56,11,45
47536,59,32,2015,47,15,32
47537,59,57,2015,209,148,61
47538,59,71,2015,100,62,38
47539,59,73,2015,155,123,32
47540,59,33,2015,98,27,71
47541,59,35,2015,105,57,48
47542,59,36,2015,925,534,391
47543,59,63,2015,9679,5715,3964
47544,59,37,2015,56,5,51
47545,59,64,2015,1617,1048,569
47546,59,49,2015,151,93,58
47547,59,74,2015,212,179,33
47548,59,26,2015,87,83,4
47549,59,38,2015,150,54,96
47550,59,60,2015,3317,1945,1372
47551,59,50,2015,103,86,17
47552,87,76,2015,115,60,55
47553,87,82,2015,283,156,127
47554,87,83,2015,24,6,18
47555,87,110,2015,240,101,139
47556,87,90,2015,118,67,51
47557,87,92,2015,29,9,20
47558,87,93,2015,43,16,27
47559,87,50,2015,104,51,53
47560,144,141,2015,13194,6572,6622
47561,144,67,2015,1377,685,692
47562,144,137,2015,1847,919,928
47563,144,68,2015,34615,17253,17362
47564,144,69,2015,1415,705,710
47565,144,157,2015,967,481,486
47566,144,16,2015,1683,837,846
47567,144,57,2015,1862,927,935
47568,144,20,2015,1326,659,667
47569,144,143,2015,1155,575,580
47570,144,161,2015,1564,779,785
47571,144,164,2015,1774,883,891
47572,144,65,2015,4025,2004,2021
47573,144,25,2015,2619,1303,1316
47574,144,146,2015,2533,1261,1272
47575,144,142,2015,1825,908,917
47576,144,50,2015,1192,593,599
47577,125,134,2015,37206,19232,17974
47578,125,116,2015,5954,3074,2880
47579,125,153,2015,6491,3181,3310
47580,125,137,2015,9958,5145,4813
47581,125,5,2015,2338,890,1448
47582,125,121,2015,23584,12410,11174
47583,125,149,2015,7465,4246,3219
47584,125,123,2015,59620,30176,29444
47585,125,162,2015,5100,2708,2392
47586,125,9,2015,1345,513,832
47587,125,61,2015,4331,1553,2778
47588,125,127,2015,16123,8871,7252
47589,125,115,2015,19198,9713,9485
47590,125,133,2015,92671,49022,43649
47591,125,131,2015,7067,3442,3625
47592,125,132,2015,5059,2668,2391
47593,150,2,2015,42,24,18
47594,150,141,2015,473,248,225
47595,150,134,2015,37350,15319,22031
47596,150,76,2015,459,273,186
47597,150,103,2015,48,30,18
47598,150,66,2015,596,273,323
47599,150,78,2015,48,36,12
47600,150,13,2015,47,34,13
47601,150,3,2015,31,11,20
47602,150,11,2015,61,0,61
47603,150,67,2015,180,88,92
47604,150,147,2015,644,327,317
47605,150,105,2015,522,303,219
47606,150,30,2015,29,23,6
47607,150,116,2015,380,148,232
47608,150,135,2015,115,20,95
47609,150,106,2015,31,8,23
47610,150,172,2015,3039,856,2183
47611,150,137,2015,1093,456,637
47612,150,137,2015,3472,1776,1696
47613,150,81,2015,665,393,272
47614,150,31,2015,74,49,25
47615,150,151,2015,152,85,67
47616,150,39,2015,110,36,74
47617,150,120,2015,206,140,66
47618,150,42,2015,77,54,23
47619,150,68,2015,524,287,237
47620,150,155,2015,84,46,38
47621,150,69,2015,8870,5099,3771
47622,150,156,2015,139,57,82
47623,150,157,2015,51,20,31
47624,150,5,2015,659,227,432
47625,150,6,2015,29,11,18
47626,150,44,2015,58,30,28
47627,150,17,2015,105,46,59
47628,150,57,2015,806,443,363
47629,150,177,2015,110,69,41
47630,150,121,2015,1086,536,550
47631,150,176,2015,98,0,98
47632,150,20,2015,45,17,28
47633,150,149,2015,123,63,60
47634,150,143,2015,34,17,17
47635,150,71,2015,42,23,19
47636,150,123,2015,361,167,194
47637,150,124,2015,103,61,42
47638,150,125,2015,134,57,77
47639,150,73,2015,505,257,248
47640,150,162,2015,961,371,590
47641,150,48,2015,51,34,17
47642,150,9,2015,162,17,145
47643,150,33,2015,164,107,57
47644,150,61,2015,423,172,251
47645,150,35,2015,29,13,16
47646,150,36,2015,444,183,261
47647,150,126,2015,350,154,196
47648,150,164,2015,29,11,18
47649,150,127,2015,54,34,20
47650,150,165,2015,159,85,74
47651,150,128,2015,91,27,64
47652,150,115,2015,8300,4148,4152
47653,150,133,2015,14141,6955,7186
47654,150,65,2015,336,137,199
47655,150,145,2015,194,107,87
47656,150,148,2015,191,104,87
47657,150,49,2015,98,52,46
47658,150,74,2015,418,241,177
47659,150,26,2015,34,13,21
47660,150,130,2015,470,230,240
47661,150,38,2015,251,34,217
47662,150,142,2015,170,66,104
47663,150,50,2015,1681,968,713
47664,150,131,2015,1074,543,531
47665,150,152,2015,69,36,33
47666,150,132,2015,2959,1037,1922
47667,8,3,2015,233,115,118
47668,8,4,2015,28740,13980,14760
47669,8,10,2015,46,26,20
47670,8,172,2015,20302,14356,5946
47671,8,5,2015,446113,318615,127498
47672,8,9,2015,1268,453,815
47673,73,2,2015,32735,15266,17469
47674,73,51,2015,1324,658,666
47675,73,141,2015,3855,1471,2384
47676,73,52,2015,18,9,9
47677,73,134,2015,4982,2150,2832
47678,73,75,2015,22,16,6
47679,73,76,2015,33,22,11
47680,73,103,2015,3223,1792,1431
47681,73,11,2015,867,411,456
47682,73,77,2015,4178,2070,2108
47683,73,66,2015,6514,3669,2845
47684,73,12,2015,753,355,398
47685,73,78,2015,57,25,32
47686,73,13,2015,126,61,65
47687,73,3,2015,1338,792,546
47688,73,79,2015,80,36,44
47689,73,29,2015,309,167,142
47690,73,67,2015,53446,29427,24019
47691,73,95,2015,17,11,6
47692,73,151,2015,279,100,179
47693,73,4,2015,310,150,160
47694,73,53,2015,813,401,412
47695,73,147,2015,232,120,112
47696,73,105,2015,16131,10330,5801
47697,73,30,2015,19921,10733,9188
47698,73,152,2015,378,145,233
47699,73,116,2015,2189,1127,1062
47700,73,153,2015,11634,6232,5402
47701,73,135,2015,1842,962,880
47702,73,80,2015,15,8,7
47703,73,136,2015,88,33,55
47704,73,106,2015,3250,1728,1522
47705,73,172,2015,61901,34890,27011
47706,73,107,2015,14123,8344,5779
47707,73,117,2015,14,3,11
47708,73,137,2015,962,482,480
47709,73,96,2015,764,414,350
47710,73,54,2015,322,168,154
47711,73,81,2015,1300,814,486
47712,73,14,2015,582,256,326
47713,73,31,2015,746,388,358
47714,73,176,2015,121,56,65
47715,73,137,2015,4923,2472,2451
47716,73,39,2015,3511,2068,1443
47717,73,118,2015,92,64,28
47718,73,82,2015,79,42,37
47719,73,83,2015,8585,5907,2678
47720,73,108,2015,2221,1396,825
47721,73,142,2015,12780,3996,8784
47722,73,97,2015,382,229,153
47723,73,138,2015,49,39,10
47724,73,119,2015,13186,4926,8260
47725,73,40,2015,991,681,310
47726,73,148,2015,85,50,35
47727,73,120,2015,10067,4590,5477
47728,73,41,2015,8,4,4
47729,73,42,2015,2880,2034,846
47730,73,68,2015,24766,13471,11295
47731,73,139,2015,96,48,48
47732,73,155,2015,709,258,451
47733,73,15,2015,314,157,157
47734,73,69,2015,117881,68914,48967
47735,73,156,2015,13808,7151,6657
47736,73,55,2015,32,14,18
47737,73,56,2015,13982,5821,8161
47738,73,84,2015,46,29,17
47739,73,98,2015,738,371,367
47740,73,157,2015,2497,1016,1481
47741,73,158,2015,237,101,136
47742,73,110,2015,2267,1490,777
47743,73,85,2015,1395,670,725
47744,73,99,2015,475,305,170
47745,73,32,2015,13103,7270,5833
47746,73,43,2015,433,222,211
47747,73,5,2015,24060,10768,13292
47748,73,6,2015,28885,13319,15566
47749,73,16,2015,40269,17643,22626
47750,73,44,2015,5201,2581,2620
47751,73,45,2015,7,4,3
47752,73,17,2015,5037,2224,2813
47753,73,57,2015,25466,9565,15901
47754,73,86,2015,915,525,390
47755,73,177,2015,5726,3291,2435
47756,73,18,2015,933,400,533
47757,73,167,2015,260,139,121
47758,73,121,2015,3003,1718,1285
47759,73,19,2015,1188,503,685
47760,73,168,2015,75,40,35
47761,73,46,2015,3376,1958,1418
47762,73,20,2015,3395,1482,1913
47763,73,149,2015,138,55,83
47764,73,159,2015,1836,724,1112
47765,73,143,2015,1042,370,672
47766,73,70,2015,4,3,1
47767,73,47,2015,4528,2768,1760
47768,73,71,2015,1163,619,544
47769,73,122,2015,185,107,78
47770,73,123,2015,290,141,149
47771,73,7,2015,11,4,7
47772,73,160,2015,170,83,87
47773,73,58,2015,342,190,152
47774,73,161,2015,309,33,276
47775,73,124,2015,357,211,146
47776,73,100,2015,3900,2345,1555
47777,73,72,2015,86,43,43
47778,73,59,2015,9,5,4
47779,73,87,2015,8,4,4
47780,73,144,2015,166873,80553,86320
47781,73,125,2015,647,326,321
47782,73,150,2015,257,154,103
47783,73,8,2015,1730,786,944
47784,73,101,2015,490,283,207
47785,73,162,2015,6955,3206,3749
47786,73,60,2015,197,96,101
47787,73,48,2015,2671,1544,1127
47788,73,21,2015,618,285,333
47789,73,9,2015,11822,5033,6789
47790,73,102,2015,310,161,149
47791,73,111,2015,201,131,70
47792,73,112,2015,3910,2677,1233
47793,73,33,2015,107426,58644,48782
47794,73,61,2015,16615,7989,8626
47795,73,22,2015,114,59,55
47796,73,35,2015,16246,9905,6341
47797,73,36,2015,2863,1533,1330
47798,73,126,2015,1126,578,548
47799,73,90,2015,75,49,26
47800,73,91,2015,60,26,34
47801,73,92,2015,65,43,22
47802,73,62,2015,3,2,1
47803,73,140,2015,161,85,76
47804,73,23,2015,1989,891,1098
47805,73,164,2015,976,363,613
47806,73,63,2015,127,56,71
47807,73,127,2015,83,56,27
47808,73,165,2015,3998,1359,2639
47809,73,37,2015,624,299,325
47810,73,64,2015,259,126,133
47811,73,128,2015,27007,12955,14052
47812,73,115,2015,13334,7206,6128
47813,73,129,2015,2,1,1
47814,73,65,2015,24963,12968,11995
47815,73,10,2015,10210,5040,5170
47816,73,145,2015,4415,1607,2808
47817,73,113,2015,179040,99394,79646
47818,73,49,2015,4430,2591,1839
47819,73,74,2015,6805,3817,2988
47820,73,25,2015,28902,11676,17226
47821,73,169,2015,61,33,28
47822,73,166,2015,1144,444,700
47823,73,93,2015,540,332,208
47824,73,146,2015,4447,1605,2842
47825,73,26,2015,190724,93239,97485
47826,73,170,2015,18,12,6
47827,73,94,2015,1,0,1
47828,73,130,2015,1619,866,753
47829,73,38,2015,1388,741,647
47830,73,27,2015,832,395,437
47831,73,50,2015,48562,21787,26775
47832,73,131,2015,1414,747,667
47833,73,114,2015,647,325,322
47834,73,171,2015,184,99,85
47835,73,1,2015,12522,6966,5556
47836,73,28,2015,515,212,303
47837,73,132,2015,975,518,457
47838,73,133,2015,1376,712,664
47839,101,2,2015,61,27,34
47840,101,141,2015,113,61,52
47841,101,76,2015,119,61,58
47842,101,103,2015,270,129,141
47843,101,66,2015,38,15,23
47844,101,78,2015,84,41,43
47845,101,67,2015,44,10,34
47846,101,105,2015,122,66,56
47847,101,95,2015,24,11,13
47848,101,30,2015,61,39,22
47849,101,106,2015,126,51,75
47850,101,172,2015,139,48,91
47851,101,107,2015,447,202,245
47852,101,137,2015,47,15,32
47853,101,96,2015,10772,5299,5473
47854,101,81,2015,941,358,583
47855,101,39,2015,52,17,35
47856,101,83,2015,69,32,37
47857,101,108,2015,111,44,67
47858,101,97,2015,2444,1112,1332
47859,101,120,2015,81,31,50
47860,101,68,2015,148,59,89
47861,101,69,2015,300,108,192
47862,101,98,2015,1762,827,935
47863,101,85,2015,23,11,12
47864,101,99,2015,12439,6368,6071
47865,101,5,2015,24,11,13
47866,101,44,2015,24,6,18
47867,101,57,2015,190,44,146
47868,101,86,2015,20,6,14
47869,101,177,2015,40,13,27
47870,101,18,2015,26,10,16
47871,101,100,2015,846,465,381
47872,101,73,2015,267,144,123
47873,101,162,2015,24,15,9
47874,101,102,2015,405,177,228
47875,101,112,2015,228,95,133
47876,101,88,2015,58,26,32
47877,101,36,2015,194,116,78
47878,101,164,2015,188,106,82
47879,101,128,2015,38,31,7
47880,101,65,2015,460,199,261
47881,101,49,2015,33,12,21
47882,101,74,2015,84,22,62
47883,101,38,2015,78,45,33
47884,101,50,2015,71,24,47
47885,101,114,2015,38,23,15
47886,101,28,2015,30,21,9
47887,162,135,2015,26893,12138,14755
47888,162,136,2015,29175,13168,16007
47889,162,151,2015,351985,158870,193115
47890,162,156,2015,222377,100371,122006
47891,162,159,2015,20541,9271,11270
47892,162,160,2015,160967,72653,88314
47893,162,165,2015,4073,1838,2235
47894,162,166,2015,147698,66664,81034
47895,176,3,2015,152,92,60
47896,176,105,2015,2780,1383,1397
47897,176,10,2015,153,103,50
47898,176,172,2015,28594,13853,14741
47899,176,173,2015,164,54,110
47900,176,5,2015,363,174,189
47901,176,177,2015,210,95,115
47902,176,9,2015,170,84,86
47903,176,112,2015,522,259,263
47904,176,36,2015,145,68,77
47905,176,1,2015,751,338,413
47906,176,50,2015,304,128,176
47907,60,51,2015,67799,39884,27915
47908,60,53,2015,8713,5090,3623
47909,60,30,2015,1072,626,446
47910,60,54,2015,1433,837,596
47911,60,31,2015,53,30,23
47912,60,69,2015,42,24,18
47913,60,56,2015,233,135,98
47914,60,32,2015,81,46,35
47915,60,57,2015,37,22,15
47916,60,59,2015,9229,5392,3837
47917,60,33,2015,100,58,42
47918,60,35,2015,23,13,10
47919,60,36,2015,215,127,88
47920,60,63,2015,17930,10478,7452
47921,60,37,2015,36,21,15
47922,60,64,2015,256,149,107
47923,60,26,2015,19922,11222,8700
47924,60,38,2015,64,36,28
47925,60,142,2015,1964,1147,817
47926,48,2,2015,13124,5134,7990
47927,48,51,2015,969,405,564
47928,48,141,2015,1210,439,771
47929,48,52,2015,12,5,7
47930,48,134,2015,490,246,244
47931,48,76,2015,4,1,3
47932,48,103,2015,1086,532,554
47933,48,11,2015,301,174,127
47934,48,77,2015,19,4,15
47935,48,66,2015,1578,756,822
47936,48,12,2015,521,293,228
47937,48,78,2015,21,10,11
47938,48,13,2015,32,16,16
47939,48,3,2015,997,454,543
47940,48,79,2015,23,7,16
47941,48,29,2015,1020,705,315
47942,48,67,2015,1660,797,863
47943,48,95,2015,12,4,8
47944,48,151,2015,28,13,15
47945,48,4,2015,365,206,159
47946,48,53,2015,13201,6716,6485
47947,48,147,2015,118,62,56
47948,48,105,2015,5152,3489,1663
47949,48,30,2015,5696,2545,3151
47950,48,152,2015,31,6,25
47951,48,116,2015,1014,540,474
47952,48,153,2015,405,182,223
47953,48,135,2015,677,312,365
47954,48,80,2015,5,2,3
47955,48,136,2015,24,5,19
47956,48,106,2015,6585,3175,3410
47957,48,172,2015,12197,7856,4341
47958,48,173,2015,0,0,0
47959,48,174,2015,0,0,0
47960,48,107,2015,5636,2694,2942
47961,48,117,2015,6,5,1
47962,48,137,2015,222,114,108
47963,48,96,2015,277,134,143
47964,48,54,2015,3390,1569,1821
47965,48,81,2015,966,620,346
47966,48,14,2015,196,59,137
47967,48,31,2015,2139,1040,1099
47968,48,176,2015,37,18,19
47969,48,137,2015,2186,1101,1085
47970,48,39,2015,25312,12130,13182
47971,48,118,2015,58,39,19
47972,48,82,2015,16,9,7
47973,48,83,2015,791,487,304
47974,48,108,2015,759,378,381
47975,48,142,2015,1071,342,729
47976,48,97,2015,202,103,99
47977,48,138,2015,12,8,4
47978,48,119,2015,15150,6359,8791
47979,48,40,2015,5013,2072,2941
47980,48,148,2015,15,5,10
47981,48,120,2015,7900,3854,4046
47982,48,41,2015,883,432,451
47983,48,42,2015,6779,4062,2717
47984,48,68,2015,6305,2747,3558
47985,48,139,2015,9,4,5
47986,48,155,2015,1151,480,671
47987,48,15,2015,312,173,139
47988,48,69,2015,28005,13190,14815
47989,48,156,2015,1879,844,1035
47990,48,55,2015,8,3,5
47991,48,56,2015,2279,887,1392
47992,48,84,2015,19,9,10
47993,48,98,2015,445,224,221
47994,48,157,2015,273,134,139
47995,48,158,2015,64,21,43
47996,48,110,2015,88,56,32
47997,48,85,2015,40,16,24
47998,48,99,2015,118,68,50
47999,48,32,2015,3902,1778,2124
48000,48,43,2015,8221,3898,4323
48001,48,5,2015,11845,5625,6220
48002,48,6,2015,16043,7429,8614
48003,48,16,2015,22006,9661,12345
48004,48,44,2015,1103,426,677
48005,48,45,2015,6,1,5
48006,48,17,2015,787,351,436
48007,48,57,2015,3976,1465,2511
48008,48,86,2015,161,86,75
48009,48,177,2015,1381,919,462
48010,48,18,2015,428,207,221
48011,48,167,2015,931,592,339
48012,48,121,2015,1964,1167,797
48013,48,19,2015,399,164,235
48014,48,168,2015,192,137,55
48015,48,46,2015,9541,3979,5562
48016,48,20,2015,1846,824,1022
48017,48,149,2015,14,7,7
48018,48,159,2015,922,479,443
48019,48,143,2015,539,220,319
48020,48,70,2015,27,11,16
48021,48,47,2015,35565,14565,21000
48022,48,71,2015,140,51,89
48023,48,122,2015,471,250,221
48024,48,123,2015,119,65,54
48025,48,7,2015,5,2,3
48026,48,160,2015,53,21,32
48027,48,58,2015,99,51,48
48028,48,161,2015,60,5,55
48029,48,124,2015,187,107,80
48030,48,100,2015,1224,692,532
48031,48,72,2015,14,8,6
48032,48,59,2015,404,204,200
48033,48,87,2015,2,2,0
48034,48,144,2015,5522,2453,3069
48035,48,125,2015,191,108,83
48036,48,150,2015,82,51,31
48037,48,8,2015,1559,649,910
48038,48,73,2015,8590,3882,4708
48039,48,101,2015,191,107,84
48040,48,162,2015,1776,740,1036
48041,48,60,2015,2467,1160,1307
48042,48,21,2015,54,16,38
48043,48,9,2015,19283,9291,9992
48044,48,102,2015,60,37,23
48045,48,111,2015,149,92,57
48046,48,112,2015,1476,902,574
48047,48,33,2015,90350,31600,58750
48048,48,61,2015,2854,1203,1651
48049,48,88,2015,0,0,0
48050,48,22,2015,68,33,35
48051,48,35,2015,12003,5424,6579
48052,48,36,2015,17119,11237,5882
48053,48,126,2015,612,332,280
48054,48,90,2015,3,2,1
48055,48,91,2015,14,8,6
48056,48,92,2015,5,1,4
48057,48,62,2015,4,3,1
48058,48,140,2015,10,5,5
48059,48,23,2015,627,298,329
48060,48,164,2015,253,93,160
48061,48,63,2015,3883,1932,1951
48062,48,127,2015,12,5,7
48063,48,165,2015,514,250,264
48064,48,37,2015,3815,1368,2447
48065,48,64,2015,378,188,190
48066,48,128,2015,27009,12662,14347
48067,48,115,2015,1450,670,780
48068,48,129,2015,65,28,37
48069,48,65,2015,6239,2867,3372
48070,48,10,2015,9187,4430,4757
48071,48,145,2015,3264,1307,1957
48072,48,113,2015,41,24,17
48073,48,49,2015,49068,24212,24856
48074,48,74,2015,2226,1140,1086
48075,48,25,2015,13249,4853,8396
48076,48,169,2015,108,61,47
48077,48,166,2015,115,53,62
48078,48,93,2015,345,195,150
48079,48,146,2015,1003,323,680
48080,48,26,2015,11106,4891,6215
48081,48,170,2015,76,39,37
48082,48,94,2015,1,0,1
48083,48,130,2015,1126,602,524
48084,48,38,2015,4223,3129,1094
48085,48,27,2015,433,197,236
48086,48,50,2015,19331,7520,11811
48087,48,131,2015,931,482,449
48088,48,114,2015,234,117,117
48089,48,171,2015,488,278,210
48090,48,1,2015,13682,7513,6169
48091,48,28,2015,352,165,187
48092,48,132,2015,537,294,243
48093,48,133,2015,291,143,148
48094,21,13,2015,893,334,559
48095,21,3,2015,247568,15646,231922
48096,21,10,2015,23519,10354,13165
48097,21,68,2015,2642,666,1976
48098,21,5,2015,1076151,133789,942362
48099,21,16,2015,9610,3206,6404
48100,21,18,2015,17108,5308,11800
48101,21,19,2015,668,112,556
48102,21,73,2015,1264,278,986
48103,21,9,2015,195644,18519,177125
48104,21,22,2015,386,65,321
48105,21,23,2015,1673,403,1270
48106,21,129,2015,317,103,214
48107,21,145,2015,15552,5093,10459
48108,21,27,2015,14848,5409,9439
48109,21,142,2015,69046,20302,48744
48110,21,50,2015,9369,2565,6804
48111,9,2,2015,1710378,899713,810665
48112,9,10,2015,578,292,286
48113,9,172,2015,334,140,194
48114,9,5,2015,1709217,720271,988946
48115,9,6,2015,2301,1029,1272
48116,9,16,2015,251,126,125
48117,102,103,2015,2550,1153,1397
48118,102,66,2015,108,49,59
48119,102,3,2015,42,9,33
48120,102,79,2015,32,17,15
48121,102,67,2015,271,85,186
48122,102,105,2015,2002,1061,941
48123,102,95,2015,86,30,56
48124,102,30,2015,73,28,45
48125,102,106,2015,1813,848,965
48126,102,172,2015,18665,8819,9846
48127,102,107,2015,55251,29805,25446
48128,102,96,2015,7760,4072,3688
48129,102,54,2015,102,23,79
48130,102,81,2015,2825,1177,1648
48131,102,31,2015,38,23,15
48132,102,39,2015,147,30,117
48133,102,82,2015,58,37,21
48134,102,83,2015,8095,5468,2627
48135,102,108,2015,2672,1237,1435
48136,102,97,2015,3225,1623,1602
48137,102,42,2015,46,23,23
48138,102,68,2015,969,390,579
48139,102,15,2015,58,5,53
48140,102,69,2015,1065,440,625
48141,102,56,2015,325,57,268
48142,102,84,2015,27,10,17
48143,102,98,2015,1606,702,904
48144,102,110,2015,48,25,23
48145,102,85,2015,542,294,248
48146,102,99,2015,1504,789,715
48147,102,173,2015,281,143,138
48148,102,32,2015,59,22,37
48149,102,5,2015,4481,1683,2798
48150,102,6,2015,86,22,64
48151,102,44,2015,92,25,67
48152,102,17,2015,1114,350,764
48153,102,57,2015,1318,405,913
48154,102,86,2015,697,360,337
48155,102,177,2015,372,168,204
48156,102,18,2015,119,35,84
48157,102,20,2015,526,216,310
48158,102,143,2015,38,9,29
48159,102,47,2015,46,10,36
48160,102,100,2015,4832,2198,2634
48161,102,144,2015,79,25,54
48162,102,73,2015,482,155,327
48163,102,101,2015,12915,7564,5351
48164,102,162,2015,37,9,28
48165,102,48,2015,77,28,49
48166,102,9,2015,84,35,49
48167,102,111,2015,122,74,48
48168,102,112,2015,4290,1883,2407
48169,102,33,2015,196,71,125
48170,102,61,2015,254,85,169
48171,102,88,2015,721,258,463
48172,102,35,2015,182,49,133
48173,102,36,2015,995,360,635
48174,102,23,2015,50,17,33
48175,102,63,2015,27,4,23
48176,102,37,2015,36,22,14
48177,102,1,2015,59,23,36
48178,102,115,2015,46,23,23
48179,102,65,2015,3702,1397,2305
48180,102,49,2015,212,57,155
48181,102,74,2015,367,120,247
48182,102,25,2015,265,107,158
48183,102,93,2015,119,54,65
48184,102,26,2015,112,23,89
48185,102,38,2015,502,85,417
48186,102,142,2015,73,28,45
48187,102,50,2015,2017,708,1309
48188,102,114,2015,762,316,446
48189,111,103,2015,57056,28371,28685
48190,111,105,2015,73715,35146,38569
48191,111,106,2015,2109,870,1239
48192,111,172,2015,780,344,436
48193,111,68,2015,614,243,371
48194,111,69,2015,1659,701,958
48195,111,57,2015,876,337,539
48196,111,177,2015,1983,948,1035
48197,111,100,2015,1605,799,806
48198,111,33,2015,872,410,462
48199,111,65,2015,883,372,511
48200,111,50,2015,174,79,95
48201,111,114,2015,2925,1260,1665
48202,112,141,2015,19,6,13
48203,112,134,2015,15,10,5
48204,112,103,2015,14386,6591,7795
48205,112,66,2015,200,89,111
48206,112,67,2015,626,291,335
48207,112,105,2015,8817,3670,5147
48208,112,30,2015,69,26,43
48209,112,106,2015,9437,4454,4983
48210,112,172,2015,18783,3847,14936
48211,112,107,2015,7599,3651,3948
48212,112,96,2015,343,173,170
48213,112,54,2015,92,20,72
48214,112,81,2015,922,364,558
48215,112,31,2015,91,40,51
48216,112,39,2015,247,108,139
48217,112,83,2015,184,92,92
48218,112,108,2015,6855,3172,3683
48219,112,97,2015,110,55,55
48220,112,40,2015,17,8,9
48221,112,42,2015,72,36,36
48222,112,68,2015,3952,1748,2204
48223,112,109,2015,34,19,15
48224,112,69,2015,5215,2290,2925
48225,112,56,2015,60,17,43
48226,112,98,2015,166,82,84
48227,112,85,2015,49,30,19
48228,112,99,2015,168,101,67
48229,112,32,2015,65,33,32
48230,112,43,2015,15,3,12
48231,112,5,2015,1434,206,1228
48232,112,6,2015,59,18,41
48233,112,16,2015,19,4,15
48234,112,44,2015,215,104,111
48235,112,17,2015,516,197,319
48236,112,57,2015,4153,1674,2479
48237,112,177,2015,3417,1648,1769
48238,112,18,2015,39,10,29
48239,112,176,2015,88,38,50
48240,112,20,2015,71,27,44
48241,112,71,2015,15,6,9
48242,112,58,2015,21,1,20
48243,112,100,2015,3294,1389,1905
48244,112,144,2015,38,12,26
48245,112,73,2015,691,304,387
48246,112,101,2015,164,95,69
48247,112,48,2015,107,49,58
48248,112,9,2015,73,17,56
48249,112,102,2015,350,174,176
48250,112,111,2015,555,297,258
48251,112,33,2015,201,96,105
48252,112,61,2015,131,46,85
48253,112,88,2015,139,74,65
48254,112,35,2015,186,97,89
48255,112,36,2015,641,398,243
48256,112,92,2015,22,16,6
48257,112,23,2015,33,15,18
48258,112,64,2015,29,12,17
48259,112,115,2015,118,44,74
48260,112,65,2015,6648,2981,3667
48261,112,49,2015,287,132,155
48262,112,74,2015,794,357,437
48263,112,26,2015,52,19,33
48264,112,38,2015,245,157,88
48265,112,142,2015,20,4,16
48266,112,50,2015,2945,1258,1687
48267,112,114,2015,623,262,361
48268,33,2,2015,139,13,126
48269,33,51,2015,124,17,107
48270,33,141,2015,574,101,473
48271,33,134,2015,55,5,50
48272,33,103,2015,268,103,165
48273,33,11,2015,2078,783,1295
48274,33,66,2015,3742,1887,1855
48275,33,12,2015,262,117,145
48276,33,3,2015,97,13,84
48277,33,29,2015,74999,46713,28286
48278,33,67,2015,5155,2478,2677
48279,33,53,2015,3433,2051,1382
48280,33,105,2015,256,108,148
48281,33,30,2015,1707,725,982
48282,33,135,2015,35,4,31
48283,33,106,2015,57,23,34
48284,33,172,2015,1162,636,526
48285,33,107,2015,121,62,59
48286,33,137,2015,104,43,61
48287,33,96,2015,34,0,34
48288,33,54,2015,775,336,439
48289,33,81,2015,222,73,149
48290,33,14,2015,205,74,131
48291,33,31,2015,4457,2396,2061
48292,33,39,2015,881,413,468
48293,33,83,2015,19,13,6
48294,33,108,2015,44,0,44
48295,33,142,2015,446,115,331
48296,33,119,2015,29,24,5
48297,33,40,2015,195,124,71
48298,33,120,2015,42,12,30
48299,33,42,2015,246,139,107
48300,33,68,2015,25801,14748,11053
48301,33,15,2015,321,177,144
48302,33,69,2015,75383,41207,34176
48303,33,156,2015,34,11,23
48304,33,56,2015,3060,1367,1693
48305,33,157,2015,54,8,46
48306,33,110,2015,25,10,15
48307,33,32,2015,1326,697,629
48308,33,43,2015,486,247,239
48309,33,5,2015,846,283,563
48310,33,6,2015,227,68,159
48311,33,16,2015,419,102,317
48312,33,44,2015,7498,3631,3867
48313,33,17,2015,341,129,212
48314,33,57,2015,9812,4429,5383
48315,33,177,2015,503,310,193
48316,33,18,2015,134,15,119
48317,33,167,2015,4546,2453,2093
48318,33,121,2015,59,27,32
48319,33,19,2015,188,50,138
48320,33,168,2015,123,38,85
48321,33,46,2015,1531,932,599
48322,33,20,2015,377,72,305
48323,33,143,2015,237,74,163
48324,33,47,2015,49829,31473,18356
48325,33,71,2015,227,143,84
48326,33,160,2015,28,2,26
48327,33,100,2015,209,81,128
48328,33,72,2015,23,7,16
48329,33,59,2015,57,15,42
48330,33,144,2015,313,51,262
48331,33,125,2015,25,0,25
48332,33,8,2015,54,13,41
48333,33,73,2015,2557,999,1558
48334,33,162,2015,375,5,370
48335,33,60,2015,261,102,159
48336,33,48,2015,1509,777,732
48337,33,9,2015,210,17,193
48338,33,102,2015,31,16,15
48339,33,112,2015,109,19,90
48340,33,61,2015,134,43,91
48341,33,22,2015,24,13,11
48342,33,35,2015,2449,1417,1032
48343,33,36,2015,37682,24628,13054
48344,33,23,2015,171,81,90
48345,33,164,2015,85,17,68
48346,33,63,2015,1021,380,641
48347,33,37,2015,1279,709,570
48348,33,64,2015,150,54,96
48349,33,115,2015,375,161,214
48350,33,65,2015,4761,2285,2476
48351,33,10,2015,83,42,41
48352,33,145,2015,110,20,90
48353,33,49,2015,1290,526,764
48354,33,74,2015,1002,458,544
48355,33,25,2015,580,89,491
48356,33,169,2015,56,41,15
48357,33,146,2015,404,48,356
48358,33,26,2015,862,199,663
48359,33,170,2015,52,48,4
48360,33,130,2015,61,36,25
48361,33,38,2015,204061,128398,75663
48362,33,27,2015,123,58,65
48363,33,50,2015,34124,16007,18117
48364,33,131,2015,68,24,44
48365,33,114,2015,91,45,46
48366,33,171,2015,489,321,168
48367,33,1,2015,2757,1100,1657
48368,33,28,2015,111,43,68
48369,33,132,2015,41,4,37
48370,33,133,2015,101,54,47
48371,61,51,2015,50,25,25
48372,61,141,2015,230,58,172
48373,61,52,2015,372,203,169
48374,61,134,2015,156251,87201,69050
48375,61,103,2015,1320,722,598
48376,61,11,2015,100,37,63
48377,61,66,2015,504,270,234
48378,61,12,2015,65,28,37
48379,61,3,2015,1470,397,1073
48380,61,29,2015,946,503,443
48381,61,67,2015,3421,1819,1602
48382,61,151,2015,33,1,32
48383,61,53,2015,42,35,7
48384,61,105,2015,134245,79947,54298
48385,61,30,2015,5179,2617,2562
48386,61,153,2015,59532,32674,26858
48387,61,135,2015,73,25,48
48388,61,106,2015,194,106,88
48389,61,172,2015,10461,5215,5246
48390,61,173,2015,132,81,51
48391,61,174,2015,1995,1152,843
48392,61,107,2015,644,439,205
48393,61,137,2015,474,430,44
48394,61,54,2015,81,50,31
48395,61,81,2015,1621,1304,317
48396,61,14,2015,29,14,15
48397,61,31,2015,247,175,72
48398,61,176,2015,73,45,28
48399,61,137,2015,1816,633,1183
48400,61,39,2015,395,200,195
48401,61,83,2015,66,44,22
48402,61,108,2015,447,237,210
48403,61,142,2015,420,58,362
48404,61,97,2015,85,80,5
48405,61,138,2015,221,211,10
48406,61,40,2015,128,94,34
48407,61,148,2015,578,246,332
48408,61,120,2015,30,11,19
48409,61,42,2015,334,211,123
48410,61,68,2015,90792,50598,40194
48411,61,139,2015,566,17,549
48412,61,155,2015,114,20,94
48413,61,15,2015,1070,278,792
48414,61,69,2015,26905,14293,12612
48415,61,156,2015,192,52,140
48416,61,56,2015,186,89,97
48417,61,98,2015,30,17,13
48418,61,157,2015,4500,2197,2303
48419,61,158,2015,28422,12894,15528
48420,61,32,2015,398,278,120
48421,61,43,2015,28,16,12
48422,61,5,2015,7809,3442,4367
48423,61,6,2015,203,95,108
48424,61,16,2015,42,13,29
48425,61,44,2015,1561,823,738
48426,61,17,2015,339,35,304
48427,61,57,2015,2726,1180,1546
48428,61,86,2015,26,11,15
48429,61,177,2015,309,188,121
48430,61,18,2015,28,11,17
48431,61,167,2015,872,425,447
48432,61,121,2015,101,53,48
48433,61,46,2015,206,161,45
48434,61,20,2015,73,30,43
48435,61,159,2015,28,1,27
48436,61,143,2015,28,5,23
48437,61,70,2015,202,1,201
48438,61,47,2015,364,243,121
48439,61,71,2015,3926,2073,1853
48440,61,122,2015,26,11,15
48441,61,123,2015,457,291,166
48442,61,160,2015,113,9,104
48443,61,58,2015,43,28,15
48444,61,161,2015,40,8,32
48445,61,100,2015,264,152,112
48446,61,59,2015,77,75,2
48447,61,144,2015,1968,667,1301
48448,61,125,2015,70228,38794,31434
48449,61,8,2015,530,162,368
48450,61,73,2015,3960,2004,1956
48451,61,162,2015,265,95,170
48452,61,60,2015,272,141,131
48453,61,48,2015,331,176,155
48454,61,9,2015,1935,674,1261
48455,61,102,2015,35,20,15
48456,61,111,2015,53,35,18
48457,61,112,2015,285,175,110
48458,61,33,2015,974,728,246
48459,61,35,2015,22763,11440,11323
48460,61,36,2015,5674,3532,2142
48461,61,140,2015,17915,10296,7619
48462,61,164,2015,2078,442,1636
48463,61,63,2015,51,28,23
48464,61,165,2015,53,9,44
48465,61,37,2015,92,75,17
48466,61,64,2015,55,37,18
48467,61,115,2015,11028,6070,4958
48468,61,65,2015,15843,9348,6495
48469,61,10,2015,26,11,15
48470,61,49,2015,803,458,345
48471,61,74,2015,16183,8343,7840
48472,61,25,2015,26,11,15
48473,61,166,2015,74,22,52
48474,61,146,2015,137,30,107
48475,61,26,2015,296,121,175
48476,61,130,2015,27,17,10
48477,61,38,2015,46533,20392,26141
48478,61,50,2015,18383,9495,8888
48479,61,131,2015,68,35,33
48480,61,114,2015,225,72,153
48481,61,171,2015,879,279,600
48482,61,1,2015,53,28,25
48483,61,133,2015,1145,117,1028
48484,88,103,2015,1180,629,551
48485,88,105,2015,95,50,45
48486,88,106,2015,789,421,368
48487,88,172,2015,1088,580,508
48488,88,107,2015,3788,2021,1767
48489,88,96,2015,685,365,320
48490,88,81,2015,13321,7107,6214
48491,88,82,2015,1190,634,556
48492,88,83,2015,57891,30887,27004
48493,88,108,2015,851,454,397
48494,88,142,2015,35,19,16
48495,88,97,2015,846,451,395
48496,88,68,2015,143,76,67
48497,88,69,2015,504,268,236
48498,88,98,2015,381,203,178
48499,88,110,2015,50,27,23
48500,88,85,2015,160,86,74
48501,88,99,2015,408,218,190
48502,88,5,2015,49,26,23
48503,88,17,2015,45,24,21
48504,88,57,2015,192,102,90
48505,88,86,2015,43,23,20
48506,88,177,2015,83,44,39
48507,88,18,2015,90,47,43
48508,88,20,2015,18,9,9
48509,88,100,2015,2647,1412,1235
48510,88,73,2015,27,14,13
48511,88,101,2015,234,124,110
48512,88,102,2015,921,491,430
48513,88,112,2015,686,365,321
48514,88,33,2015,18,9,9
48515,88,61,2015,35,19,16
48516,88,65,2015,1816,969,847
48517,88,93,2015,174,93,81
48518,88,26,2015,21,11,10
48519,88,50,2015,173,92,81
48520,88,1,2015,64,34,30
48521,22,2,2015,1571,291,1280
48522,22,13,2015,764,258,506
48523,22,3,2015,160183,12460,147723
48524,22,10,2015,54731,14488,40243
48525,22,136,2015,512,94,418
48526,22,120,2015,1667,308,1359
48527,22,119,2015,1854,343,1511
48528,22,68,2015,1061,232,829
48529,22,5,2015,645577,89129,556448
48530,22,18,2015,32217,6665,25552
48531,22,19,2015,6494,1214,5280
48532,22,20,2015,8274,1534,6740
48533,22,144,2015,1437,266,1171
48534,22,8,2015,151314,28107,123207
48535,22,73,2015,450,102,348
48536,22,162,2015,4071,755,3316
48537,22,9,2015,133212,17630,115582
48538,22,23,2015,897,162,735
48539,22,128,2015,1243,230,1013
48540,22,129,2015,2033,422,1611
48541,22,145,2015,18583,3860,14723
48542,22,25,2015,7148,1325,5823
48543,22,27,2015,9682,2640,7042
48544,22,146,2015,978,180,798
48545,22,26,2015,5046,935,4111
48546,22,142,2015,163569,32279,131290
48547,22,50,2015,3841,776,3065
48548,22,28,2015,34877,6467,28410
48549,35,2,2015,0,0,0
48550,35,51,2015,3,1,2
48551,35,141,2015,130,70,60
48552,35,52,2015,40,18,22
48553,35,134,2015,17,9,8
48554,35,75,2015,158,44,114
48555,35,76,2015,3,2,1
48556,35,103,2015,24,12,12
48557,35,11,2015,32,15,17
48558,35,66,2015,509,222,287
48559,35,12,2015,11,5,6
48560,35,78,2015,0,0,0
48561,35,13,2015,8,5,3
48562,35,3,2015,100,3,97
48563,35,79,2015,0,0,0
48564,35,29,2015,39,23,16
48565,35,67,2015,1102,532,570
48566,35,95,2015,0,0,0
48567,35,151,2015,1,0,1
48568,35,4,2015,4,2,2
48569,35,53,2015,11,5,6
48570,35,147,2015,0,0,0
48571,35,105,2015,29,20,9
48572,35,30,2015,10465,6435,4030
48573,35,152,2015,6,0,6
48574,35,116,2015,2,0,2
48575,35,153,2015,6,4,2
48576,35,135,2015,36,11,25
48577,35,80,2015,1,1,0
48578,35,136,2015,2,2,0
48579,35,106,2015,25,12,13
48580,35,172,2015,3722,1552,2170
48581,35,107,2015,28,6,22
48582,35,117,2015,0,0,0
48583,35,137,2015,23,10,13
48584,35,96,2015,12,8,4
48585,35,54,2015,18,7,11
48586,35,81,2015,42,15,27
48587,35,14,2015,307,145,162
48588,35,31,2015,138,76,62
48589,35,176,2015,7,3,4
48590,35,137,2015,10,8,2
48591,35,39,2015,263,114,149
48592,35,118,2015,0,0,0
48593,35,82,2015,4,1,3
48594,35,83,2015,17,8,9
48595,35,108,2015,16,8,8
48596,35,142,2015,105,25,80
48597,35,97,2015,13,6,7
48598,35,138,2015,20,18,2
48599,35,119,2015,1,1,0
48600,35,40,2015,9,6,3
48601,35,148,2015,1,1,0
48602,35,120,2015,3,1,2
48603,35,41,2015,3,2,1
48604,35,42,2015,24,10,14
48605,35,68,2015,6471,2877,3594
48606,35,139,2015,1,1,0
48607,35,155,2015,2,1,1
48608,35,15,2015,57,37,20
48609,35,69,2015,6552,2994,3558
48610,35,156,2015,57,17,40
48611,35,55,2015,2,1,1
48612,35,56,2015,4653,2037,2616
48613,35,84,2015,1,0,1
48614,35,98,2015,14,7,7
48615,35,157,2015,49,14,35
48616,35,158,2015,18,14,4
48617,35,110,2015,0,0,0
48618,35,85,2015,1,0,1
48619,35,99,2015,11,9,2
48620,35,32,2015,6420,3382,3038
48621,35,43,2015,7,3,4
48622,35,5,2015,78,24,54
48623,35,6,2015,1261,210,1051
48624,35,16,2015,1419,401,1018
48625,35,44,2015,657,337,320
48626,35,45,2015,0,0,0
48627,35,17,2015,1837,499,1338
48628,35,57,2015,38580,17378,21202
48629,35,86,2015,7,3,4
48630,35,177,2015,34,19,15
48631,35,18,2015,120,25,95
48632,35,167,2015,85,45,40
48633,35,121,2015,10,9,1
48634,35,19,2015,15,4,11
48635,35,168,2015,6,2,4
48636,35,46,2015,24,14,10
48637,35,20,2015,248,56,192
48638,35,159,2015,2,0,2
48639,35,143,2015,10,6,4
48640,35,70,2015,0,0,0
48641,35,47,2015,12,9,3
48642,35,71,2015,30,12,18
48643,35,122,2015,1,1,0
48644,35,123,2015,1,1,0
48645,35,7,2015,6,2,4
48646,35,160,2015,57,3,54
48647,35,58,2015,15,7,8
48648,35,161,2015,19,3,16
48649,35,124,2015,5,3,2
48650,35,100,2015,116,75,41
48651,35,72,2015,2,0,2
48652,35,59,2015,33,11,22
48653,35,144,2015,129,53,76
48654,35,125,2015,5,3,2
48655,35,150,2015,1,1,0
48656,35,8,2015,11,2,9
48657,35,73,2015,198,79,119
48658,35,101,2015,9,3,6
48659,35,162,2015,170,111,59
48660,35,60,2015,1536,679,857
48661,35,48,2015,263,119,144
48662,35,21,2015,0,0,0
48663,35,9,2015,289,51,238
48664,35,102,2015,5,3,2
48665,35,111,2015,13,9,4
48666,35,112,2015,34,26,8
48667,35,33,2015,170,69,101
48668,35,61,2015,364,150,214
48669,35,22,2015,7,2,5
48670,35,36,2015,5269,3544,1725
48671,35,126,2015,4,0,4
48672,35,91,2015,0,0,0
48673,35,92,2015,1,1,0
48674,35,62,2015,5,4,1
48675,35,140,2015,0,0,0
48676,35,23,2015,19,4,15
48677,35,164,2015,16,12,4
48678,35,63,2015,5783,1170,4613
48679,35,165,2015,4,1,3
48680,35,37,2015,21,12,9
48681,35,64,2015,12,6,6
48682,35,128,2015,1,0,1
48683,35,115,2015,2,2,0
48684,35,65,2015,29937,14479,15458
48685,35,10,2015,4,2,2
48686,35,145,2015,11,2,9
48687,35,113,2015,0,0,0
48688,35,49,2015,191,101,90
48689,35,74,2015,158,65,93
48690,35,25,2015,2576,545,2031
48691,35,169,2015,1,1,0
48692,35,166,2015,0,0,0
48693,35,93,2015,2,2,0
48694,35,146,2015,1062,325,737
48695,35,26,2015,5833,1292,4541
48696,35,170,2015,7,4,3
48697,35,130,2015,3,1,2
48698,35,38,2015,11900,6005,5895
48699,35,27,2015,13,1,12
48700,35,50,2015,5208,2399,2809
48701,35,131,2015,3,2,1
48702,35,114,2015,8,3,5
48703,35,171,2015,15,8,7
48704,35,1,2015,80,32,48
48705,35,28,2015,21,5,16
48706,35,132,2015,15,5,10
48707,35,133,2015,0,0,0
48708,36,2,2015,5095,1196,3899
48709,36,51,2015,234,97,137
48710,36,141,2015,778,232,546
48711,36,134,2015,511,101,410
48712,36,12,2015,767339,342255,425084
48713,36,103,2015,252,97,155
48714,36,66,2015,2953,1552,1401
48715,36,3,2015,471,64,407
48716,36,11,2015,527287,231412,295875
48717,36,67,2015,471,208,263
48718,36,53,2015,515,63,452
48719,36,147,2015,28,19,9
48720,36,105,2015,433,198,235
48721,36,30,2015,5841,1877,3964
48722,36,116,2015,131,21,110
48723,36,29,2015,764279,436759,327520
48724,36,135,2015,334,68,266
48725,36,153,2015,45,19,26
48726,36,10,2015,588,258,330
48727,36,136,2015,152,26,126
48728,36,106,2015,107,41,66
48729,36,172,2015,56171,24708,31463
48730,36,107,2015,206,64,142
48731,36,117,2015,88,44,44
48732,36,137,2015,580,146,434
48733,36,96,2015,32,15,17
48734,36,54,2015,321,87,234
48735,36,81,2015,2227,858,1369
48736,36,14,2015,716,354,362
48737,36,31,2015,11257,5646,5611
48738,36,151,2015,94,23,71
48739,36,39,2015,231,105,126
48740,36,108,2015,241,75,166
48741,36,138,2015,104,37,67
48742,36,120,2015,272,67,205
48743,36,40,2015,58751,31578,27173
48744,36,42,2015,2210,1198,1012
48745,36,68,2015,2567,1139,1428
48746,36,15,2015,450221,209114,241107
48747,36,69,2015,142026,71986,70040
48748,36,156,2015,316,65,251
48749,36,56,2015,1952,839,1113
48750,36,157,2015,204,45,159
48751,36,173,2015,60,24,36
48752,36,32,2015,16841,8458,8383
48753,36,43,2015,44,23,21
48754,36,5,2015,5701,1447,4254
48755,36,6,2015,2012,697,1315
48756,36,16,2015,986,186,800
48757,36,44,2015,175,86,89
48758,36,17,2015,3649,1644,2005
48759,36,57,2015,1896,726,1170
48760,36,177,2015,1025,510,515
48761,36,167,2015,2560269,1382311,1177958
48762,36,18,2015,816,144,672
48763,36,121,2015,451,154,297
48764,36,176,2015,10624,2421,8203
48765,36,19,2015,85,29,56
48766,36,168,2015,591349,304104,287245
48767,36,20,2015,968,161,807
48768,36,46,2015,89389,47799,41590
48769,36,143,2015,270,100,170
48770,36,47,2015,71078,37878,33200
48771,36,71,2015,36,15,21
48772,36,122,2015,84,26,58
48773,36,123,2015,29,12,17
48774,36,7,2015,45,27,18
48775,36,160,2015,73,7,66
48776,36,58,2015,54,25,29
48777,36,124,2015,64,18,46
48778,36,100,2015,204,107,97
48779,36,72,2015,45,30,15
48780,36,59,2015,263,54,209
48781,36,144,2015,1101,340,761
48782,36,125,2015,111,34,77
48783,36,21,2015,52,20,32
48784,36,150,2015,121,49,72
48785,36,8,2015,175,21,154
48786,36,73,2015,548,232,316
48787,36,101,2015,60,16,44
48788,36,162,2015,796,153,643
48789,36,48,2015,701,383,318
48790,36,9,2015,728,149,579
48791,36,102,2015,25,5,20
48792,36,111,2015,36,20,16
48793,36,112,2015,277,78,199
48794,36,33,2015,29207,15343,13864
48795,36,61,2015,232,105,127
48796,36,158,2015,131,38,93
48797,36,22,2015,26,12,14
48798,36,35,2015,3911,2196,1715
48799,36,126,2015,45,18,27
48800,36,75,2015,49,12,37
48801,36,62,2015,46,30,16
48802,36,23,2015,219,64,155
48803,36,164,2015,73,22,51
48804,36,37,2015,1832,873,959
48805,36,1,2015,13671,5118,8553
48806,36,64,2015,350,119,231
48807,36,128,2015,59,8,51
48808,36,115,2015,240,109,131
48809,36,133,2015,73,30,43
48810,36,65,2015,1394,647,747
48811,36,145,2015,258,25,233
48812,36,49,2015,475,228,247
48813,36,74,2015,580,289,291
48814,36,25,2015,3265,511,2754
48815,36,169,2015,466508,191163,275345
48816,36,27,2015,355,150,205
48817,36,146,2015,335,73,262
48818,36,26,2015,10237,2169,8068
48819,36,170,2015,185664,97108,88556
48820,36,130,2015,82,35,47
48821,36,38,2015,3269992,1751206,1518786
48822,36,60,2015,255,47,208
48823,36,142,2015,1060,329,731
48824,36,50,2015,1741,768,973
48825,36,131,2015,217,74,143
48826,36,152,2015,445,250,195
48827,36,114,2015,121,67,54
48828,36,171,2015,1146803,547165,599638
48829,36,28,2015,648,67,581
48830,36,132,2015,471,141,330
48831,126,116,2015,134501,66123,68378
48832,126,137,2015,233744,121566,112178
48833,126,121,2015,2581,1083,1498
48834,126,130,2015,92195,44440,47755
48835,126,131,2015,42776,21315,21461
48836,90,76,2015,404,207,197
48837,90,78,2015,24,9,15
48838,90,79,2015,96,51,45
48839,90,82,2015,200,94,106
48840,90,84,2015,57,26,31
48841,90,110,2015,777,364,413
48842,90,86,2015,141,71,70
48843,90,87,2015,430,213,217
48844,90,91,2015,102,45,57
48845,90,92,2015,168,80,88
48846,90,93,2015,266,113,153
48847,91,76,2015,90,45,45
48848,91,66,2015,10,4,6
48849,91,78,2015,11,2,9
48850,91,79,2015,421,213,208
48851,91,67,2015,9,3,6
48852,91,105,2015,8,2,6
48853,91,95,2015,0,0,0
48854,91,80,2015,10,1,9
48855,91,172,2015,52,26,26
48856,91,81,2015,83,47,36
48857,91,82,2015,261,127,134
48858,91,83,2015,38,22,16
48859,91,120,2015,2,1,1
48860,91,68,2015,54,17,37
48861,91,109,2015,142,92,50
48862,91,69,2015,50,31,19
48863,91,156,2015,18,6,12
48864,91,84,2015,168,68,100
48865,91,98,2015,3,0,3
48866,91,110,2015,2185,1220,965
48867,91,85,2015,24,11,13
48868,91,5,2015,218,88,130
48869,91,44,2015,17,7,10
48870,91,57,2015,14,7,7
48871,91,86,2015,390,234,156
48872,91,177,2015,10,8,2
48873,91,20,2015,0,0,0
48874,91,100,2015,18,16,2
48875,91,87,2015,30,15,15
48876,91,73,2015,12,3,9
48877,91,77,2015,29,18,11
48878,91,162,2015,69,50,19
48879,91,9,2015,2,0,2
48880,91,102,2015,7,2,5
48881,91,88,2015,8,1,7
48882,91,90,2015,36,20,16
48883,91,75,2015,5,2,3
48884,91,92,2015,315,183,132
48885,91,115,2015,5,1,4
48886,91,133,2015,0,0,0
48887,91,113,2015,22,12,10
48888,91,74,2015,9,3,6
48889,91,25,2015,137,31,106
48890,91,93,2015,526,279,247
48891,91,50,2015,791,412,379
48892,92,76,2015,58,25,33
48893,92,79,2015,351,150,201
48894,92,82,2015,87,46,41
48895,92,84,2015,439,247,192
48896,92,110,2015,246,131,115
48897,92,86,2015,126,66,60
48898,92,90,2015,39,29,10
48899,92,91,2015,240,137,103
48900,92,93,2015,976,476,500
48901,92,50,2015,805,378,427
48902,62,57,2015,4460,1797,2663
48903,62,51,2015,37,29,8
48904,62,33,2015,31,28,3
48905,62,35,2015,135,115,20
48906,62,38,2015,65,65,0
48907,62,36,2015,36,35,1
48908,62,68,2015,29,19,10
48909,62,103,2015,85,42,43
48910,62,105,2015,29,27,2
48911,140,134,2015,358,214,144
48912,140,153,2015,1363,708,655
48913,140,138,2015,146,93,53
48914,140,139,2015,237,70,167
48915,140,125,2015,116,21,95
48916,140,61,2015,118,57,61
48917,23,2,2015,385241,118377,266864
48918,23,3,2015,1022812,245148,777664
48919,23,10,2015,423765,131217,292548
48920,23,120,2015,131493,39975,91518
48921,23,5,2015,2003256,597100,1406156
48922,23,16,2015,4865,2100,2765
48923,23,18,2015,192620,59188,133432
48924,23,20,2015,123277,37880,85397
48925,23,8,2015,403005,86685,316320
48926,23,9,2015,1187817,343096,844721
48927,23,145,2015,385241,118377,266864
48928,23,25,2015,659067,265301,393766
48929,23,142,2015,770483,236756,533727
48930,23,28,2015,616386,200389,415997
48931,164,141,2015,4204,2630,1574
48932,164,105,2015,650,328,322
48933,164,135,2015,1014,611,403
48934,164,137,2015,295,143,152
48935,164,151,2015,3621,1731,1890
48936,164,68,2015,13909,7028,6881
48937,164,155,2015,5386,2944,2442
48938,164,69,2015,876,425,451
48939,164,156,2015,1790,393,1397
48940,164,157,2015,51711,18714,32997
48941,164,20,2015,1106,383,723
48942,164,159,2015,439,213,226
48943,164,160,2015,34245,15060,19185
48944,164,161,2015,45357,21048,24309
48945,164,144,2015,4134,2090,2044
48946,164,162,2015,829,210,619
48947,164,158,2015,29591,16310,13281
48948,164,126,2015,283,137,146
48949,164,23,2015,1430,733,697
48950,164,165,2015,14963,7833,7130
48951,164,166,2015,1677,550,1127
48952,164,26,2015,0,0,0
48953,63,51,2015,467,382,85
48954,63,141,2015,53,20,33
48955,63,103,2015,49,34,15
48956,63,66,2015,6998,3609,3389
48957,63,11,2015,158,126,32
48958,63,67,2015,217,95,122
48959,63,53,2015,335992,188414,147578
48960,63,105,2015,85,53,32
48961,63,30,2015,1134,835,299
48962,63,29,2015,134,118,16
48963,63,172,2015,1763,807,956
48964,63,54,2015,283247,155956,127291
48965,63,81,2015,29,14,15
48966,63,14,2015,173,80,93
48967,63,31,2015,514,361,153
48968,63,39,2015,183,94,89
48969,63,42,2015,34,19,15
48970,63,68,2015,5388,2828,2560
48971,63,15,2015,48,35,13
48972,63,69,2015,16083,8064,8019
48973,63,156,2015,29,10,19
48974,63,56,2015,914,464,450
48975,63,32,2015,1800,1215,585
48976,63,5,2015,295,171,124
48977,63,6,2015,65,6,59
48978,63,16,2015,176,61,115
48979,63,44,2015,52,25,27
48980,63,17,2015,109,53,56
48981,63,57,2015,1923,894,1029
48982,63,177,2015,39,22,17
48983,63,167,2015,97,79,18
48984,63,18,2015,99,22,77
48985,63,19,2015,67,27,40
48986,63,20,2015,45,20,25
48987,63,143,2015,374,159,215
48988,63,47,2015,28,21,7
48989,63,71,2015,90,36,54
48990,63,58,2015,53,26,27
48991,63,100,2015,26,15,11
48992,63,59,2015,71224,39913,31311
48993,63,144,2015,33,21,12
48994,63,73,2015,752,360,392
48995,63,48,2015,138,62,76
48996,63,112,2015,49,32,17
48997,63,33,2015,664,584,80
48998,63,61,2015,39,15,24
48999,63,35,2015,3607,3069,538
49000,63,36,2015,2944,2175,769
49001,63,37,2015,476,349,127
49002,63,64,2015,10930,6186,4744
49003,63,115,2015,141,77,64
49004,63,133,2015,28,16,12
49005,63,65,2015,158,71,87
49006,63,49,2015,1191,595,596
49007,63,74,2015,2856,1389,1467
49008,63,25,2015,123,24,99
49009,63,27,2015,24,12,12
49010,63,146,2015,40,10,30
49011,63,26,2015,388,128,260
49012,63,170,2015,29,23,6
49013,63,38,2015,1274,1095,179
49014,63,60,2015,46737,28463,18274
49015,63,142,2015,77,26,51
49016,63,50,2015,647,307,340
49017,63,171,2015,80,74,6
49018,63,132,2015,57,31,26
49019,127,3,2015,220,44,176
49020,127,67,2015,38,24,14
49021,127,10,2015,598,171,427
49022,127,172,2015,510,61,449
49023,127,81,2015,43,24,19
49024,127,68,2015,239,117,122
49025,127,69,2015,85,47,38
49026,127,5,2015,6482,1756,4726
49027,127,57,2015,122,47,75
49028,127,121,2015,409,255,154
49029,127,122,2015,801,154,647
49030,127,7,2015,38,13,25
49031,127,124,2015,554,144,410
49032,127,8,2015,175,20,155
49033,127,162,2015,136,93,43
49034,127,9,2015,24,5,19
49035,127,36,2015,96,57,39
49036,127,128,2015,64,22,42
49037,127,115,2015,255,100,155
49038,127,65,2015,24,18,6
49039,127,130,2015,28,14,14
49040,127,50,2015,290,134,156
49041,165,153,2015,43,16,27
49042,165,136,2015,0,0,0
49043,165,172,2015,195,75,120
49044,165,137,2015,0,0,0
49045,165,151,2015,65,25,40
49046,165,138,2015,0,0,0
49047,165,119,2015,1,0,1
49048,165,155,2015,705,273,432
49049,165,69,2015,36,13,23
49050,165,156,2015,995,386,609
49051,165,157,2015,39375,17297,22078
49052,165,5,2015,855,332,523
49053,165,16,2015,0,0,0
49054,165,177,2015,1,0,1
49055,165,121,2015,27,10,17
49056,165,176,2015,3,1,2
49057,165,20,2015,617,239,378
49058,165,159,2015,10917,5152,5765
49059,165,160,2015,323,124,199
49060,165,161,2015,97,37,60
49061,165,162,2015,2022,785,1237
49062,165,9,2015,94,36,58
49063,165,158,2015,377,146,231
49064,165,36,2015,67,26,41
49065,165,126,2015,0,0,0
49066,165,164,2015,353,137,216
49067,165,1,2015,0,0,0
49068,165,115,2015,85,33,52
49069,165,145,2015,15,7,8
49070,165,166,2015,27,10,17
49071,165,50,2015,167,64,103
49072,165,152,2015,11,4,7
49073,165,132,2015,18,6,12
49074,37,2,2015,155,23,132
49075,37,51,2015,99,15,84
49076,37,141,2015,105,17,88
49077,37,52,2015,1,0,1
49078,37,134,2015,25,4,21
49079,37,103,2015,83,46,37
49080,37,11,2015,148,68,80
49081,37,77,2015,1,1,0
49082,37,66,2015,3361,1360,2001
49083,37,12,2015,37,22,15
49084,37,13,2015,14,5,9
49085,37,3,2015,18,3,15
49086,37,79,2015,1,0,1
49087,37,29,2015,223,153,70
49088,37,67,2015,828,300,528
49089,37,95,2015,2,0,2
49090,37,151,2015,9,1,8
49091,37,53,2015,394,113,281
49092,37,147,2015,4,4,0
49093,37,105,2015,114,67,47
49094,37,30,2015,2193,703,1490
49095,37,152,2015,3,0,3
49096,37,116,2015,5,1,4
49097,37,135,2015,10,2,8
49098,37,80,2015,2,1,1
49099,37,136,2015,139,79,60
49100,37,106,2015,28,11,17
49101,37,172,2015,1074,498,576
49102,37,107,2015,56,15,41
49103,37,137,2015,23,9,14
49104,37,96,2015,12,5,7
49105,37,54,2015,850,277,573
49106,37,81,2015,137,38,99
49107,37,14,2015,120,47,73
49108,37,31,2015,87989,48134,39855
49109,37,176,2015,16,7,9
49110,37,137,2015,8,3,5
49111,37,39,2015,260,87,173
49112,37,82,2015,3,2,1
49113,37,83,2015,18,10,8
49114,37,108,2015,36,14,22
49115,37,142,2015,195,10,185
49116,37,97,2015,2,0,2
49117,37,40,2015,55,37,18
49118,37,148,2015,1,0,1
49119,37,120,2015,31,9,22
49120,37,41,2015,1,1,0
49121,37,42,2015,154,68,86
49122,37,68,2015,2938,1376,1562
49123,37,155,2015,3,0,3
49124,37,15,2015,78,31,47
49125,37,69,2015,4817,1609,3208
49126,37,156,2015,19,5,14
49127,37,56,2015,431,147,284
49128,37,84,2015,2,1,1
49129,37,98,2015,3,1,2
49130,37,157,2015,6,0,6
49131,37,158,2015,2,1,1
49132,37,85,2015,2,0,2
49133,37,99,2015,2,0,2
49134,37,32,2015,17058,8713,8345
49135,37,43,2015,63,32,31
49136,37,5,2015,155,42,113
49137,37,6,2015,130,31,99
49138,37,16,2015,79,14,65
49139,37,44,2015,914,421,493
49140,37,45,2015,3,0,3
49141,37,17,2015,192,58,134
49142,37,57,2015,2841,724,2117
49143,37,86,2015,14,5,9
49144,37,177,2015,137,78,59
49145,37,18,2015,57,10,47
49146,37,167,2015,246,128,118
49147,37,121,2015,25,14,11
49148,37,19,2015,75,21,54
49149,37,168,2015,25,11,14
49150,37,46,2015,144,83,61
49151,37,20,2015,111,16,95
49152,37,149,2015,4,3,1
49153,37,159,2015,3,1,2
49154,37,143,2015,59,13,46
49155,37,70,2015,7,3,4
49156,37,47,2015,142,84,58
49157,37,71,2015,57,28,29
49158,37,122,2015,18,8,10
49159,37,123,2015,6,1,5
49160,37,7,2015,1,0,1
49161,37,58,2015,27,11,16
49162,37,124,2015,11,5,6
49163,37,100,2015,93,31,62
49164,37,72,2015,5,1,4
49165,37,59,2015,39,14,25
49166,37,144,2015,55,8,47
49167,37,125,2015,4,0,4
49168,37,150,2015,1,0,1
49169,37,8,2015,9,2,7
49170,37,73,2015,585,171,414
49171,37,101,2015,11,0,11
49172,37,162,2015,111,7,104
49173,37,60,2015,760,230,530
49174,37,48,2015,750,406,344
49175,37,21,2015,3,3,0
49176,37,9,2015,90,6,84
49177,37,102,2015,14,6,8
49178,37,111,2015,6,3,3
49179,37,112,2015,59,19,40
49180,37,33,2015,6721,3602,3119
49181,37,61,2015,172,53,119
49182,37,22,2015,2,1,1
49183,37,35,2015,8299,3143,5156
49184,37,36,2015,2780,1805,975
49185,37,126,2015,2,1,1
49186,37,90,2015,1,0,1
49187,37,91,2015,1,1,0
49188,37,62,2015,1,1,0
49189,37,140,2015,2,0,2
49190,37,23,2015,39,4,35
49191,37,164,2015,15,3,12
49192,37,63,2015,1917,688,1229
49193,37,127,2015,7,3,4
49194,37,165,2015,2,0,2
49195,37,64,2015,311,95,216
49196,37,128,2015,14,6,8
49197,37,115,2015,112,33,79
49198,37,65,2015,885,388,497
49199,37,10,2015,15,9,6
49200,37,145,2015,19,2,17
49201,37,49,2015,270,111,159
49202,37,74,2015,677,284,393
49203,37,25,2015,237,46,191
49204,37,169,2015,12,7,5
49205,37,166,2015,3,0,3
49206,37,93,2015,6,1,5
49207,37,146,2015,153,11,142
49208,37,26,2015,322,53,269
49209,37,170,2015,11,6,5
49210,37,130,2015,8,5,3
49211,37,38,2015,10092,6147,3945
49212,37,27,2015,75,31,44
49213,37,50,2015,5501,2402,3099
49214,37,131,2015,1,0,1
49215,37,114,2015,12,5,7
49216,37,171,2015,46,27,19
49217,37,1,2015,2145,842,1303
49218,37,28,2015,34,6,28
49219,37,132,2015,11,2,9
49220,37,133,2015,6,3,3
49221,64,2,2015,25,0,25
49222,64,51,2015,148,69,79
49223,64,141,2015,28,6,22
49224,64,134,2015,2,1,1
49225,64,103,2015,417,205,212
49226,64,11,2015,13,9,4
49227,64,77,2015,6,2,4
49228,64,66,2015,2820,1462,1358
49229,64,12,2015,10,3,7
49230,64,78,2015,0,0,0
49231,64,3,2015,3,0,3
49232,64,79,2015,1,1,0
49233,64,29,2015,143,103,40
49234,64,67,2015,310,153,157
49235,64,95,2015,2,0,2
49236,64,151,2015,2,1,1
49237,64,53,2015,100880,39496,61384
49238,64,147,2015,2,0,2
49239,64,105,2015,114,77,37
49240,64,30,2015,1179,457,722
49241,64,152,2015,4,0,4
49242,64,116,2015,3,0,3
49243,64,153,2015,4,1,3
49244,64,135,2015,17,1,16
49245,64,136,2015,1,0,1
49246,64,106,2015,28,11,17
49247,64,172,2015,863,394,469
49248,64,107,2015,41,29,12
49249,64,117,2015,0,0,0
49250,64,137,2015,9,3,6
49251,64,96,2015,4,2,2
49252,64,54,2015,46995,23908,23087
49253,64,81,2015,70,34,36
49254,64,14,2015,16,9,7
49255,64,31,2015,388,275,113
49256,64,176,2015,1,1,0
49257,64,137,2015,6,3,3
49258,64,39,2015,58,28,30
49259,64,82,2015,2,2,0
49260,64,83,2015,166,144,22
49261,64,108,2015,9,5,4
49262,64,142,2015,113,27,86
49263,64,97,2015,0,0,0
49264,64,119,2015,8,2,6
49265,64,40,2015,28,15,13
49266,64,120,2015,16,5,11
49267,64,42,2015,33,21,12
49268,64,68,2015,1167,609,558
49269,64,139,2015,1,0,1
49270,64,155,2015,16,2,14
49271,64,15,2015,18,9,9
49272,64,69,2015,7586,3744,3842
49273,64,156,2015,38,17,21
49274,64,56,2015,91,44,47
49275,64,98,2015,1,1,0
49276,64,157,2015,5,2,3
49277,64,158,2015,18,8,10
49278,64,110,2015,2,1,1
49279,64,85,2015,10,4,6
49280,64,99,2015,5,2,3
49281,64,32,2015,402,238,164
49282,64,43,2015,8,6,2
49283,64,5,2015,143,41,102
49284,64,6,2015,89,28,61
49285,64,16,2015,58,16,42
49286,64,44,2015,44,18,26
49287,64,17,2015,34,11,23
49288,64,57,2015,3646,1617,2029
49289,64,86,2015,9,3,6
49290,64,177,2015,81,46,35
49291,64,18,2015,60,11,49
49292,64,167,2015,100,61,39
49293,64,121,2015,25,14,11
49294,64,19,2015,11,3,8
49295,64,168,2015,7,6,1
49296,64,46,2015,38,32,6
49297,64,20,2015,23,2,21
49298,64,159,2015,4,0,4
49299,64,143,2015,40,16,24
49300,64,70,2015,11,4,7
49301,64,47,2015,33,27,6
49302,64,71,2015,39,15,24
49303,64,122,2015,15,11,4
49304,64,123,2015,2,0,2
49305,64,7,2015,1,0,1
49306,64,160,2015,6,4,2
49307,64,58,2015,8,4,4
49308,64,161,2015,0,0,0
49309,64,124,2015,8,2,6
49310,64,100,2015,69,29,40
49311,64,59,2015,2843,1310,1533
49312,64,87,2015,1,1,0
49313,64,144,2015,22,6,16
49314,64,125,2015,4,2,2
49315,64,150,2015,3,1,2
49316,64,8,2015,14,5,9
49317,64,73,2015,325,139,186
49318,64,101,2015,2,2,0
49319,64,162,2015,49,12,37
49320,64,60,2015,15637,6267,9370
49321,64,48,2015,16,10,6
49322,64,21,2015,1,0,1
49323,64,9,2015,26,6,20
49324,64,102,2015,2,1,1
49325,64,111,2015,3,0,3
49326,64,112,2015,52,26,26
49327,64,33,2015,413,258,155
49328,64,61,2015,52,24,28
49329,64,22,2015,1,0,1
49330,64,35,2015,466,247,219
49331,64,36,2015,2082,1273,809
49332,64,126,2015,11,6,5
49333,64,62,2015,1,0,1
49334,64,140,2015,1,0,1
49335,64,23,2015,17,4,13
49336,64,164,2015,5,1,4
49337,64,63,2015,39025,15618,23407
49338,64,165,2015,5,0,5
49339,64,37,2015,600,370,230
49340,64,128,2015,35,12,23
49341,64,115,2015,47,27,20
49342,64,65,2015,463,267,196
49343,64,10,2015,17,7,10
49344,64,145,2015,16,4,12
49345,64,113,2015,0,0,0
49346,64,49,2015,332,155,177
49347,64,74,2015,980,464,516
49348,64,25,2015,61,19,42
49349,64,169,2015,3,2,1
49350,64,166,2015,3,0,3
49351,64,93,2015,4,2,2
49352,64,146,2015,53,8,45
49353,64,26,2015,116,30,86
49354,64,170,2015,5,4,1
49355,64,130,2015,4,2,2
49356,64,38,2015,1803,1266,537
49357,64,27,2015,12,7,5
49358,64,50,2015,559,238,321
49359,64,131,2015,2,1,1
49360,64,114,2015,11,7,4
49361,64,171,2015,32,23,9
49362,64,1,2015,15,14,1
49363,64,28,2015,13,4,9
49364,64,132,2015,5,1,4
49365,64,133,2015,12,5,7
49366,128,120,2015,13641,6820,6821
49367,128,119,2015,34,15,19
49368,128,28,2015,5883,2892,2991
49369,115,2,2015,96,42,54
49370,115,51,2015,168,101,67
49371,115,141,2015,463,123,340
49372,115,134,2015,41296,20724,20572
49373,115,103,2015,2459,1357,1102
49374,115,66,2015,5595,2557,3038
49375,115,13,2015,170,76,94
49376,115,3,2015,22965,6054,16911
49377,115,79,2015,29,12,17
49378,115,29,2015,247,134,113
49379,115,67,2015,8249,4091,4158
49380,115,151,2015,199,77,122
49381,115,53,2015,210,130,80
49382,115,147,2015,43461,16988,26473
49383,115,105,2015,3045,1706,1339
49384,115,30,2015,4081,2051,2030
49385,115,116,2015,6800,3874,2926
49386,115,135,2015,2562,813,1749
49387,115,106,2015,692,352,340
49388,115,172,2015,7845,3132,4713
49389,115,107,2015,615,414,201
49390,115,117,2015,202,28,174
49391,115,137,2015,20425,8871,11554
49392,115,54,2015,1038,517,521
49393,115,81,2015,1590,704,886
49394,115,14,2015,5098,2633,2465
49395,115,31,2015,2068,1003,1065
49396,115,176,2015,141,116,25
49397,115,137,2015,85380,40344,45036
49398,115,39,2015,2622,1310,1312
49399,115,142,2015,4793,2332,2461
49400,115,119,2015,593,264,329
49401,115,40,2015,149,28,121
49402,115,120,2015,66761,26034,40727
49403,115,42,2015,672,507,165
49404,115,68,2015,7859,4080,3779
49405,115,139,2015,322,146,176
49406,115,69,2015,13896,7093,6803
49407,115,156,2015,6920,2392,4528
49408,115,55,2015,55,12,43
49409,115,56,2015,9370,4467,4903
49410,115,98,2015,92,28,64
49411,115,157,2015,79,28,51
49412,115,158,2015,29,19,10
49413,115,110,2015,58,32,26
49414,115,173,2015,1674,874,800
49415,115,43,2015,30,5,25
49416,115,5,2015,34606,15202,19404
49417,115,6,2015,730,372,358
49418,115,16,2015,170,44,126
49419,115,44,2015,12560,7348,5212
49420,115,17,2015,4636,2308,2328
49421,115,57,2015,24222,11781,12441
49422,115,86,2015,199,126,73
49423,115,177,2015,1814,1029,785
49424,115,18,2015,58,23,35
49425,115,121,2015,17141,9890,7251
49426,115,19,2015,92,27,65
49427,115,168,2015,37,23,14
49428,115,46,2015,434,147,287
49429,115,20,2015,960,467,493
49430,115,149,2015,181832,99855,81977
49431,115,159,2015,779,510,269
49432,115,143,2015,168,32,136
49433,115,47,2015,416,247,169
49434,115,71,2015,25,19,6
49435,115,122,2015,444,268,176
49436,115,123,2015,92969,29405,63564
49437,115,7,2015,58,19,39
49438,115,160,2015,109,54,55
49439,115,58,2015,352,249,103
49440,115,124,2015,8823,4516,4307
49441,115,100,2015,296,165,131
49442,115,72,2015,25,3,22
49443,115,144,2015,1126,419,707
49444,115,125,2015,315533,113116,202417
49445,115,150,2015,40708,20514,20194
49446,115,8,2015,130,51,79
49447,115,73,2015,8528,4332,4196
49448,115,101,2015,112,73,39
49449,115,162,2015,46037,14966,31071
49450,115,48,2015,1163,723,440
49451,115,21,2015,31,12,19
49452,115,9,2015,19360,6281,13079
49453,115,102,2015,59,28,31
49454,115,111,2015,121,63,58
49455,115,112,2015,210,99,111
49456,115,33,2015,10233,5301,4932
49457,115,61,2015,9931,4917,5014
49458,115,35,2015,1678,929,749
49459,115,36,2015,3523,1917,1606
49460,115,126,2015,4901,3036,1865
49461,115,90,2015,25,9,16
49462,115,23,2015,641,308,333
49463,115,164,2015,2864,264,2600
49464,115,63,2015,4023,2083,1940
49465,115,127,2015,693,435,258
49466,115,165,2015,513,183,330
49467,115,37,2015,437,123,314
49468,115,128,2015,76935,37860,39075
49469,115,65,2015,1522,766,756
49470,115,10,2015,1022,512,510
49471,115,145,2015,3145,1516,1629
49472,115,148,2015,42038,21535,20503
49473,115,49,2015,248,115,133
49474,115,74,2015,2037,1152,885
49475,115,25,2015,119,63,56
49476,115,60,2015,124,28,96
49477,115,93,2015,25,12,13
49478,115,146,2015,117,55,62
49479,115,26,2015,1171,432,739
49480,115,130,2015,5032,2148,2884
49481,115,38,2015,3952,2268,1684
49482,115,27,2015,185,97,88
49483,115,50,2015,61413,31904,29509
49484,115,131,2015,9943,3649,6294
49485,115,114,2015,117,32,85
49486,115,1,2015,166,101,65
49487,115,28,2015,83,42,41
49488,115,132,2015,19527,10151,9376
49489,115,133,2015,676383,306719,369664
49490,129,136,2015,5184,2062,3122
49491,129,137,2015,87755,39217,48538
49492,129,142,2015,5145,2046,3099
49493,129,119,2015,3318,1319,1999
49494,129,120,2015,12786,6002,6784
49495,129,5,2015,1414,562,852
49496,129,121,2015,9558,3801,5757
49497,129,143,2015,153,67,86
49498,129,160,2015,203,81,122
49499,129,162,2015,3537,1406,2131
49500,129,145,2015,562381,285260,277121
49501,129,130,2015,145607,68427,77180
49502,65,2,2015,458,110,348
49503,65,51,2015,1938,888,1050
49504,65,141,2015,56038,20909,35129
49505,65,52,2015,5900,3039,2861
49506,65,134,2015,3553,1587,1966
49507,65,103,2015,251841,123256,128585
49508,65,11,2015,9516,4838,4678
49509,65,66,2015,8844,4781,4063
49510,65,12,2015,616,333,283
49511,65,78,2015,58,30,28
49512,65,13,2015,56,22,34
49513,65,3,2015,9836,2764,7072
49514,65,79,2015,43,21,22
49515,65,29,2015,3886,2679,1207
49516,65,67,2015,44130,21803,22327
49517,65,95,2015,34,20,14
49518,65,151,2015,398,125,273
49519,65,53,2015,2119,1091,1028
49520,65,105,2015,99187,64157,35030
49521,65,30,2015,126875,61903,64972
49522,65,152,2015,1147,322,825
49523,65,116,2015,107,58,49
49524,65,153,2015,4445,2619,1826
49525,65,135,2015,5178,2051,3127
49526,65,136,2015,122,32,90
49527,65,106,2015,54400,28369,26031
49528,65,172,2015,155713,83793,71920
49529,65,107,2015,347505,203598,143907
49530,65,137,2015,2105,853,1252
49531,65,96,2015,3339,1840,1499
49532,65,54,2015,1684,872,812
49533,65,81,2015,131134,72270,58864
49534,65,14,2015,366,173,193
49535,65,31,2015,8548,5152,3396
49536,65,176,2015,115,63,52
49537,65,137,2015,1468,592,876
49538,65,39,2015,11539,5724,5815
49539,65,118,2015,21,6,15
49540,65,82,2015,966,644,322
49541,65,83,2015,156905,95863,61042
49542,65,108,2015,416394,221070,195324
49543,65,142,2015,4128,1360,2768
49544,65,97,2015,9192,5891,3301
49545,65,138,2015,19339,11877,7462
49546,65,119,2015,137,56,81
49547,65,40,2015,1875,1176,699
49548,65,120,2015,3713,1705,2008
49549,65,42,2015,12359,6820,5539
49550,65,68,2015,203692,104834,98858
49551,65,139,2015,278,143,135
49552,65,155,2015,17017,3697,13320
49553,65,15,2015,8760,4744,4016
49554,65,69,2015,200641,101878,98763
49555,65,156,2015,12043,3058,8985
49556,65,56,2015,3982,1674,2308
49557,65,84,2015,622,313,309
49558,65,98,2015,7411,4579,2832
49559,65,157,2015,9689,3480,6209
49560,65,158,2015,5369,1218,4151
49561,65,110,2015,111,59,52
49562,65,85,2015,723,327,396
49563,65,99,2015,41333,30374,10959
49564,65,32,2015,9297,5052,4245
49565,65,43,2015,1122,604,518
49566,65,5,2015,34447,13637,20810
49567,65,6,2015,5888,2452,3436
49568,65,16,2015,1829,688,1141
49569,65,44,2015,14925,7215,7710
49570,65,17,2015,2858,1089,1769
49571,65,57,2015,106324,41889,64435
49572,65,86,2015,282,148,134
49573,65,177,2015,6128,3837,2291
49574,65,18,2015,2261,624,1637
49575,65,167,2015,1797,1076,721
49576,65,121,2015,1555,1089,466
49577,65,19,2015,483,162,321
49578,65,168,2015,333,231,102
49579,65,46,2015,3987,2455,1532
49580,65,20,2015,3341,1123,2218
49581,65,159,2015,819,268,551
49582,65,143,2015,966,370,596
49583,65,70,2015,115,62,53
49584,65,47,2015,16284,8737,7547
49585,65,71,2015,1425,720,705
49586,65,122,2015,462,310,152
49587,65,123,2015,65,34,31
49588,65,160,2015,17576,2368,15208
49589,65,58,2015,312,158,154
49590,65,161,2015,8532,2280,6252
49591,65,124,2015,241,112,129
49592,65,100,2015,48613,28088,20525
49593,65,72,2015,235,124,111
49594,65,59,2015,167,71,96
49595,65,144,2015,699880,304877,395003
49596,65,125,2015,1197,603,594
49597,65,150,2015,126,69,57
49598,65,8,2015,3136,1221,1915
49599,65,73,2015,46711,22421,24290
49600,65,101,2015,20361,15542,4819
49601,65,162,2015,30198,12590,17608
49602,65,60,2015,627,309,318
49603,65,48,2015,16018,8061,7957
49604,65,21,2015,51,18,33
49605,65,9,2015,54547,16594,37953
49606,65,102,2015,4246,2462,1784
49607,65,111,2015,58926,42452,16474
49608,65,112,2015,184802,102721,82081
49609,65,33,2015,63864,34222,29642
49610,65,61,2015,112032,47779,64253
49611,65,22,2015,91,31,60
49612,65,35,2015,646181,323572,322609
49613,65,36,2015,79255,50669,28586
49614,65,126,2015,283,129,154
49615,65,91,2015,45,20,25
49616,65,62,2015,37,18,19
49617,65,140,2015,189,95,94
49618,65,23,2015,845,311,534
49619,65,164,2015,49461,10741,38720
49620,65,63,2015,3900,2006,1894
49621,65,127,2015,40,21,19
49622,65,165,2015,1025,329,696
49623,65,37,2015,7297,4212,3085
49624,65,64,2015,1312,702,610
49625,65,128,2015,272,104,168
49626,65,115,2015,2829,1335,1494
49627,65,10,2015,628,239,389
49628,65,145,2015,389,118,271
49629,65,113,2015,218,129,89
49630,65,49,2015,19318,10582,8736
49631,65,74,2015,62286,31355,30931
49632,65,25,2015,5910,2006,3904
49633,65,169,2015,84,40,44
49634,65,166,2015,508,163,345
49635,65,93,2015,206,132,74
49636,65,146,2015,2734,890,1844
49637,65,26,2015,3969,1502,2467
49638,65,170,2015,60,40,20
49639,65,130,2015,211,101,110
49640,65,38,2015,81618,47115,34503
49641,65,27,2015,326,140,186
49642,65,50,2015,305969,153421,152548
49643,65,131,2015,360,185,175
49644,65,114,2015,73640,36354,37286
49645,65,171,2015,642,415,227
49646,65,1,2015,1634,881,753
49647,65,28,2015,139,38,101
49648,65,132,2015,148,79,69
49649,65,133,2015,335,165,170
49650,10,2,2015,131,62,69
49651,10,13,2015,398,193,205
49652,10,3,2015,665,174,491
49653,10,4,2015,231,102,129
49654,10,172,2015,2447,300,2147
49655,10,14,2015,250,122,128
49656,10,42,2015,61,41,20
49657,10,68,2015,297,141,156
49658,10,69,2015,554,252,302
49659,10,56,2015,90,40,50
49660,10,85,2015,37,21,16
49661,10,5,2015,10658,5183,5475
49662,10,6,2015,104,39,65
49663,10,16,2015,40,18,22
49664,10,17,2015,55,18,37
49665,10,57,2015,5096,2647,2449
49666,10,177,2015,838,447,391
49667,10,18,2015,274,148,126
49668,10,19,2015,1731,915,816
49669,10,20,2015,732,387,345
49670,10,143,2015,40,15,25
49671,10,7,2015,1390,845,545
49672,10,21,2015,328,175,153
49673,10,8,2015,340,115,225
49674,10,48,2015,117,58,59
49675,10,9,2015,1085,490,595
49676,10,61,2015,33,17,16
49677,10,22,2015,273,124,149
49678,10,36,2015,148,93,55
49679,10,23,2015,1397,658,739
49680,10,127,2015,25,12,13
49681,10,115,2015,260,156,104
49682,10,65,2015,35,20,15
49683,10,49,2015,129,50,79
49684,10,74,2015,288,137,151
49685,10,25,2015,73,38,35
49686,10,27,2015,1665,837,828
49687,10,26,2015,45,21,24
49688,10,142,2015,130,43,87
49689,10,50,2015,1177,591,586
49690,145,136,2015,74514,36883,37631
49691,145,172,2015,1111,537,574
49692,145,137,2015,7445,2896,4549
49693,145,120,2015,50734,26502,24232
49694,145,119,2015,159748,77761,81987
49695,145,5,2015,1277,617,660
49696,145,121,2015,2575,1248,1327
49697,145,143,2015,1557,753,804
49698,145,160,2015,678,331,347
49699,145,162,2015,14828,7173,7655
49700,145,128,2015,130,66,64
49701,145,129,2015,255959,129638,126321
49702,145,130,2015,1250,610,640
49703,145,142,2015,13423,6493,6930
49704,113,105,2015,5023,2280,2743
49705,113,172,2015,4915,2232,2683
49706,113,110,2015,12232,5554,6678
49707,113,73,2015,3138,1425,1713
49708,49,2,2015,53678,21476,32202
49709,49,51,2015,2023,878,1145
49710,49,141,2015,2811,1020,1791
49711,49,52,2015,4,4,0
49712,49,134,2015,710,379,331
49713,49,76,2015,8,2,6
49714,49,103,2015,2979,1444,1535
49715,49,11,2015,2358,1236,1122
49716,49,66,2015,5553,2534,3019
49717,49,12,2015,2697,1414,1283
49718,49,78,2015,28,7,21
49719,49,13,2015,84,35,49
49720,49,3,2015,6839,2815,4024
49721,49,79,2015,106,31,75
49722,49,29,2015,2606,1621,985
49723,49,67,2015,2267,1052,1215
49724,49,95,2015,17,8,9
49725,49,151,2015,85,24,61
49726,49,4,2015,25,7,18
49727,49,53,2015,54799,27972,26827
49728,49,147,2015,102,62,40
49729,49,105,2015,6633,4258,2375
49730,49,30,2015,7964,3902,4062
49731,49,152,2015,80,36,44
49732,49,116,2015,2746,1465,1281
49733,49,153,2015,356,189,167
49734,49,135,2015,1320,514,806
49735,49,136,2015,63,20,43
49736,49,106,2015,26990,13491,13499
49737,49,172,2015,28014,16930,11084
49738,49,173,2015,0,0,0
49739,49,107,2015,11201,5621,5580
49740,49,117,2015,5,2,3
49741,49,137,2015,764,384,380
49742,49,96,2015,397,203,194
49743,49,54,2015,7124,3542,3582
49744,49,81,2015,2538,1193,1345
49745,49,14,2015,674,292,382
49746,49,31,2015,1627,880,747
49747,49,176,2015,80,34,46
49748,49,137,2015,2958,1486,1472
49749,49,39,2015,40533,19134,21399
49750,49,118,2015,286,152,134
49751,49,82,2015,41,21,20
49752,49,83,2015,678,350,328
49753,49,108,2015,2251,1099,1152
49754,49,142,2015,5551,1982,3569
49755,49,97,2015,2758,1371,1387
49756,49,138,2015,42,23,19
49757,49,119,2015,26801,12675,14126
49758,49,40,2015,9822,5748,4074
49759,49,148,2015,28,15,13
49760,49,120,2015,15444,7729,7715
49761,49,42,2015,151599,91945,59654
49762,49,68,2015,8614,3645,4969
49763,49,139,2015,23,10,13
49764,49,155,2015,4523,1917,2606
49765,49,15,2015,1193,613,580
49766,49,69,2015,47214,25238,21976
49767,49,156,2015,2446,1036,1410
49768,49,55,2015,6,4,2
49769,49,56,2015,14517,6096,8421
49770,49,84,2015,40,11,29
49771,49,98,2015,775,376,399
49772,49,157,2015,485,173,312
49773,49,158,2015,130,53,77
49774,49,110,2015,119,79,40
49775,49,85,2015,138,72,66
49776,49,99,2015,353,178,175
49777,49,32,2015,15490,7906,7584
49778,49,43,2015,5103,2567,2536
49779,49,5,2015,20976,10344,10632
49780,49,6,2015,65462,31583,33879
49781,49,16,2015,124520,58112,66408
49782,49,44,2015,2365,763,1602
49783,49,17,2015,2462,990,1472
49784,49,57,2015,9581,3515,6066
49785,49,86,2015,329,125,204
49786,49,177,2015,3056,2150,906
49787,49,18,2015,3514,1452,2062
49788,49,167,2015,1771,1038,733
49789,49,121,2015,3384,1970,1414
49790,49,19,2015,1981,842,1139
49791,49,168,2015,900,521,379
49792,49,46,2015,6244,3583,2661
49793,49,20,2015,24582,10997,13585
49794,49,149,2015,53,30,23
49795,49,159,2015,902,458,444
49796,49,143,2015,2069,597,1472
49797,49,70,2015,3,1,2
49798,49,47,2015,10035,4998,5037
49799,49,71,2015,295,155,140
49800,49,122,2015,108,73,35
49801,49,123,2015,70,43,27
49802,49,7,2015,21,11,10
49803,49,160,2015,129,55,74
49804,49,58,2015,158,75,83
49805,49,161,2015,61,11,50
49806,49,124,2015,177,106,71
49807,49,100,2015,2327,1286,1041
49808,49,72,2015,41,19,22
49809,49,59,2015,799,371,428
49810,49,144,2015,8638,4267,4371
49811,49,125,2015,312,183,129
49812,49,150,2015,120,51,69
49813,49,8,2015,844,313,531
49814,49,73,2015,9741,4189,5552
49815,49,101,2015,741,411,330
49816,49,162,2015,4168,1469,2699
49817,49,60,2015,5815,2809,3006
49818,49,48,2015,40463,22710,17753
49819,49,21,2015,49,25,24
49820,49,9,2015,10698,4005,6693
49821,49,102,2015,285,161,124
49822,49,111,2015,191,121,70
49823,49,112,2015,7077,3851,3226
49824,49,33,2015,78146,43829,34317
49825,49,61,2015,3307,1534,1773
49826,49,22,2015,131,61,70
49827,49,35,2015,23594,12230,11364
49828,49,36,2015,18201,12128,6073
49829,49,126,2015,516,261,255
49830,49,90,2015,1,0,1
49831,49,91,2015,34,12,22
49832,49,92,2015,15,4,11
49833,49,62,2015,4,3,1
49834,49,140,2015,11,3,8
49835,49,23,2015,2862,1327,1535
49836,49,164,2015,719,264,455
49837,49,63,2015,14812,7027,7785
49838,49,127,2015,66,47,19
49839,49,165,2015,772,365,407
49840,49,37,2015,1422,779,643
49841,49,64,2015,1137,568,569
49842,49,128,2015,55339,27909,27430
49843,49,115,2015,2284,989,1295
49844,49,129,2015,14,5,9
49845,49,65,2015,9083,4021,5062
49846,49,10,2015,6656,3760,2896
49847,49,145,2015,3162,1454,1708
49848,49,113,2015,37,22,15
49849,49,74,2015,3267,1535,1732
49850,49,25,2015,101949,43464,58485
49851,49,169,2015,289,159,130
49852,49,166,2015,337,146,191
49853,49,93,2015,281,152,129
49854,49,146,2015,4624,1623,3001
49855,49,26,2015,44141,19973,24168
49856,49,170,2015,223,143,80
49857,49,130,2015,3806,1949,1857
49858,49,38,2015,6532,4477,2055
49859,49,27,2015,1339,611,728
49860,49,50,2015,23339,8001,15338
49861,49,131,2015,1611,818,793
49862,49,114,2015,2078,1024,1054
49863,49,171,2015,3326,1665,1661
49864,49,1,2015,15907,8677,7230
49865,49,28,2015,1276,529,747
49866,49,132,2015,493,287,206
49867,49,133,2015,518,255,263
49868,74,2,2015,11929,4271,7658
49869,74,51,2015,2416,1291,1125
49870,74,141,2015,9219,3878,5341
49871,74,52,2015,94,39,55
49872,74,134,2015,6666,3357,3309
49873,74,76,2015,81,36,45
49874,74,103,2015,8548,4482,4066
49875,74,11,2015,893,517,376
49876,74,66,2015,59233,35986,23247
49877,74,12,2015,715,389,326
49878,74,78,2015,124,61,63
49879,74,13,2015,248,122,126
49880,74,3,2015,2257,815,1442
49881,74,79,2015,77,31,46
49882,74,29,2015,1383,1038,345
49883,74,67,2015,15840,8264,7576
49884,74,95,2015,51,27,24
49885,74,151,2015,583,223,360
49886,74,4,2015,72,34,38
49887,74,53,2015,54673,28435,26238
49888,74,147,2015,71,36,35
49889,74,105,2015,36098,25617,10481
49890,74,30,2015,6759,4526,2233
49891,74,152,2015,632,292,340
49892,74,116,2015,582,353,229
49893,74,153,2015,2436,1246,1190
49894,74,135,2015,7103,4578,2525
49895,74,136,2015,291,160,131
49896,74,106,2015,7174,3802,3372
49897,74,172,2015,20556,12187,8369
49898,74,107,2015,12240,7633,4607
49899,74,117,2015,38,18,20
49900,74,137,2015,1176,580,596
49901,74,96,2015,876,506,370
49902,74,54,2015,19550,11022,8528
49903,74,81,2015,3214,1824,1390
49904,74,14,2015,428,182,246
49905,74,31,2015,14125,8270,5855
49906,74,176,2015,366,250,116
49907,74,137,2015,6640,3430,3210
49908,74,39,2015,5546,3124,2422
49909,74,118,2015,104,53,51
49910,74,82,2015,387,276,111
49911,74,83,2015,10960,7731,3229
49912,74,108,2015,5961,3519,2442
49913,74,142,2015,6246,2250,3996
49914,74,97,2015,860,491,369
49915,74,138,2015,67,47,20
49916,74,119,2015,30588,14546,16042
49917,74,40,2015,690,477,213
49918,74,148,2015,98,65,33
49919,74,120,2015,6101,3388,2713
49920,74,42,2015,5132,3640,1492
49921,74,68,2015,151189,78099,73090
49922,74,139,2015,312,183,129
49923,74,155,2015,765,122,643
49924,74,15,2015,790,468,322
49925,74,69,2015,343773,173455,170318
49926,74,156,2015,2638,1337,1301
49927,74,56,2015,11258,5230,6028
49928,74,84,2015,47,26,21
49929,74,98,2015,990,571,419
49930,74,157,2015,1365,439,926
49931,74,158,2015,527,156,371
49932,74,110,2015,139,95,44
49933,74,85,2015,1714,1126,588
49934,74,99,2015,612,406,206
49935,74,32,2015,21020,11058,9962
49936,74,43,2015,422,217,205
49937,74,5,2015,19336,9407,9929
49938,74,6,2015,9731,4581,5150
49939,74,16,2015,7708,2922,4786
49940,74,44,2015,3663,1849,1814
49941,74,17,2015,3697,1681,2016
49942,74,57,2015,255036,112031,143005
49943,74,86,2015,761,441,320
49944,74,177,2015,7316,5076,2240
49945,74,18,2015,718,300,418
49946,74,167,2015,2941,1694,1247
49947,74,121,2015,3364,2028,1336
49948,74,19,2015,475,220,255
49949,74,168,2015,554,358,196
49950,74,46,2015,1952,1415,537
49951,74,20,2015,6114,2254,3860
49952,74,149,2015,78,46,32
49953,74,159,2015,426,187,239
49954,74,143,2015,1184,505,679
49955,74,70,2015,2255,1387,868
49956,74,47,2015,1576,1098,478
49957,74,71,2015,2324,1210,1114
49958,74,122,2015,1782,1133,649
49959,74,123,2015,114,62,52
49960,74,7,2015,67,14,53
49961,74,160,2015,509,205,304
49962,74,58,2015,283,167,116
49963,74,161,2015,119,44,75
49964,74,124,2015,2759,1975,784
49965,74,100,2015,6617,4086,2531
49966,74,72,2015,286,153,133
49967,74,59,2015,2770,1442,1328
49968,74,144,2015,16859,9666,7193
49969,74,125,2015,1324,696,628
49970,74,150,2015,270,144,126
49971,74,8,2015,934,416,518
49972,74,73,2015,22549,11724,10825
49973,74,101,2015,616,387,229
49974,74,162,2015,3461,1186,2275
49975,74,60,2015,58450,28312,30138
49976,74,48,2015,2139,1158,981
49977,74,21,2015,112,46,66
49978,74,9,2015,4495,1724,2771
49979,74,102,2015,463,266,197
49980,74,111,2015,1051,659,392
49981,74,112,2015,9489,6216,3273
49982,74,33,2015,31175,17443,13732
49983,74,61,2015,215912,98347,117565
49984,74,22,2015,95,46,49
49985,74,35,2015,18118,11709,6409
49986,74,36,2015,21072,13948,7124
49987,74,126,2015,1010,568,442
49988,74,90,2015,10,6,4
49989,74,91,2015,57,25,32
49990,74,92,2015,13,4,9
49991,74,62,2015,28,13,15
49992,74,140,2015,64,36,28
49993,74,23,2015,1123,522,601
49994,74,164,2015,2467,1006,1461
49995,74,63,2015,62585,31670,30915
49996,74,127,2015,239,168,71
49997,74,165,2015,312,118,194
49998,74,37,2015,15121,8899,6222
49999,74,64,2015,4716,2544,2172
50000,74,128,2015,5707,2512,3195
50001,74,115,2015,7441,3966,3475
50002,74,129,2015,22,11,11
50003,74,65,2015,66213,32252,33961
50004,74,10,2015,30931,14435,16496
50005,74,145,2015,1425,660,765
50006,74,113,2015,117,76,41
50007,74,49,2015,9265,5221,4044
50008,74,25,2015,13157,5455,7702
50009,74,169,2015,210,125,85
50010,74,166,2015,1888,863,1025
50011,74,93,2015,332,192,140
50012,74,146,2015,11020,3864,7156
50013,74,26,2015,77208,36524,40684
50014,74,170,2015,110,77,33
50015,74,130,2015,751,431,320
50016,74,38,2015,8468,6385,2083
50017,74,27,2015,526,267,259
50018,74,50,2015,44650,20923,23727
50019,74,131,2015,847,457,390
50020,74,114,2015,1583,858,725
50021,74,171,2015,822,537,285
50022,74,1,2015,11272,6490,4782
50023,74,28,2015,540,234,306
50024,74,132,2015,349,197,152
50025,74,133,2015,993,539,454
50026,25,2,2015,1487,708,779
50027,25,16,2015,195204,95643,99561
50028,25,128,2015,1040,495,545
50029,25,145,2015,203,96,107
50030,169,2,2015,12393,6843,5550
50031,169,141,2015,129,71,58
50032,169,12,2015,169,105,64
50033,169,66,2015,63,34,29
50034,169,11,2015,194,119,75
50035,169,29,2015,680,403,277
50036,169,172,2015,48,17,31
50037,169,39,2015,130,51,79
50038,169,15,2015,664,323,341
50039,169,69,2015,133,59,74
50040,169,5,2015,617,231,386
50041,169,6,2015,1197,567,630
50042,169,16,2015,62,28,34
50043,169,167,2015,839,439,400
50044,169,176,2015,155,62,93
50045,169,168,2015,11301,5534,5767
50046,169,21,2015,36,18,18
50047,169,73,2015,50,32,18
50048,169,9,2015,105,51,54
50049,169,33,2015,37,18,19
50050,169,36,2015,234154,135466,98688
50051,169,74,2015,52,23,29
50052,169,26,2015,776,361,415
50053,169,170,2015,446,229,217
50054,169,38,2015,1209,472,737
50055,169,50,2015,314,82,232
50056,169,171,2015,7539,3896,3643
50057,169,132,2015,23,11,12
50058,131,134,2015,1249,498,751
50059,131,147,2015,141,42,99
50060,131,116,2015,175325,87662,87663
50061,131,117,2015,596,236,360
50062,131,137,2015,25017,12618,12399
50063,131,137,2015,59508,31093,28415
50064,131,69,2015,967,494,473
50065,131,5,2015,8010,3427,4583
50066,131,57,2015,575,242,333
50067,131,121,2015,27247,15513,11734
50068,131,149,2015,149,75,74
50069,131,123,2015,6907,3156,3751
50070,131,124,2015,192,88,104
50071,131,125,2015,14651,7288,7363
50072,131,150,2015,644,251,393
50073,131,9,2015,668,269,399
50074,131,126,2015,581,202,379
50075,131,127,2015,374,116,258
50076,131,128,2015,2967,1415,1552
50077,131,115,2015,712,279,433
50078,131,148,2015,88,30,58
50079,131,130,2015,4857,2315,2542
50080,131,50,2015,1061,613,448
50081,131,132,2015,8573,4312,4261
50082,131,133,2015,852,508,344
50083,166,67,2015,65,21,44
50084,166,135,2015,697,251,446
50085,166,153,2015,40,18,22
50086,166,136,2015,713,230,483
50087,166,172,2015,517,95,422
50088,166,137,2015,257,100,157
50089,166,137,2015,651,331,320
50090,166,151,2015,71638,37391,34247
50091,166,138,2015,107,40,67
50092,166,68,2015,792,354,438
50093,166,139,2015,896,397,499
50094,166,155,2015,1063,460,603
50095,166,69,2015,200,106,94
50096,166,156,2015,46794,27549,19245
50097,166,157,2015,3338,1510,1828
50098,166,159,2015,168,83,85
50099,166,160,2015,8122,3555,4567
50100,166,161,2015,145,80,65
50101,166,162,2015,31974,13928,18046
50102,166,158,2015,130,73,57
50103,166,126,2015,665,344,321
50104,166,140,2015,41,20,21
50105,166,164,2015,1008,440,568
50106,166,165,2015,105,56,49
50107,166,152,2015,13641,6198,7443
50108,93,79,2015,1066,554,512
50109,93,172,2015,866,386,480
50110,93,81,2015,157,71,86
50111,93,69,2015,253,123,130
50112,93,84,2015,8026,4475,3551
50113,93,110,2015,9830,5190,4640
50114,93,5,2015,959,397,562
50115,93,86,2015,1497,710,787
50116,93,162,2015,502,179,323
50117,93,91,2015,880,455,425
50118,93,92,2015,6430,3557,2873
50119,93,50,2015,2368,1095,1273
50120,146,141,2015,10411,5033,5378
50121,146,135,2015,715,346,369
50122,146,68,2015,8612,4165,4447
50123,146,69,2015,1448,700,748
50124,146,16,2015,636,304,332
50125,146,57,2015,2208,1065,1143
50126,146,143,2015,9119,4410,4709
50127,146,160,2015,996,489,507
50128,146,161,2015,528,255,273
50129,146,144,2015,5785,2798,2987
50130,146,162,2015,542,262,280
50131,146,164,2015,409,198,211
50132,146,25,2015,1228,582,646
50133,146,142,2015,1136,549,587
50134,26,2,2015,94002,42394,51608
50135,26,51,2015,3261,1721,1540
50136,26,141,2015,636,185,451
50137,26,12,2015,16529,8529,8000
50138,26,103,2015,138,72,66
50139,26,66,2015,14115,7580,6535
50140,26,3,2015,323,28,295
50141,26,11,2015,781,522,259
50142,26,67,2015,8617,4835,3782
50143,26,53,2015,2330,1257,1073
50144,26,105,2015,338,221,117
50145,26,30,2015,473482,304275,169207
50146,26,29,2015,295,240,55
50147,26,10,2015,51,12,39
50148,26,106,2015,43,30,13
50149,26,172,2015,1730,932,798
50150,26,107,2015,46,32,14
50151,26,137,2015,72,27,45
50152,26,96,2015,52,26,26
50153,26,54,2015,218,131,87
50154,26,81,2015,42,21,21
50155,26,14,2015,10231,5869,4362
50156,26,31,2015,1115,594,521
50157,26,39,2015,3313,1831,1482
50158,26,120,2015,148,76,72
50159,26,40,2015,110,73,37
50160,26,42,2015,1645,943,702
50161,26,68,2015,15730,8566,7164
50162,26,15,2015,6410,3942,2468
50163,26,69,2015,269361,167224,102137
50164,26,156,2015,142,16,126
50165,26,56,2015,58312,33856,24456
50166,26,173,2015,55,31,24
50167,26,32,2015,511,317,194
50168,26,43,2015,42,23,19
50169,26,5,2015,511,204,307
50170,26,6,2015,38569,15429,23140
50171,26,16,2015,139629,55859,83770
50172,26,44,2015,529,286,243
50173,26,17,2015,2677,1376,1301
50174,26,57,2015,2798,1308,1490
50175,26,177,2015,1970,1158,812
50176,26,167,2015,4918,2898,2020
50177,26,18,2015,901,347,554
50178,26,121,2015,170,65,105
50179,26,176,2015,28,13,15
50180,26,19,2015,281,104,177
50181,26,168,2015,1931,889,1042
50182,26,20,2015,1113,596,517
50183,26,46,2015,62,45,17
50184,26,143,2015,3023,1388,1635
50185,26,47,2015,255,165,90
50186,26,71,2015,44,25,19
50187,26,58,2015,42,29,13
50188,26,100,2015,151,83,68
50189,26,144,2015,472,201,271
50190,26,21,2015,24,14,10
50191,26,73,2015,21488,11603,9885
50192,26,162,2015,863,289,574
50193,26,48,2015,3498,1905,1593
50194,26,9,2015,2015,857,1158
50195,26,112,2015,51,33,18
50196,26,33,2015,3362,1888,1474
50197,26,61,2015,220,121,99
50198,26,22,2015,30,11,19
50199,26,35,2015,20418,12971,7447
50200,26,36,2015,19557,12695,6862
50201,26,23,2015,4331,2188,2143
50202,26,164,2015,64,26,38
50203,26,37,2015,308,174,134
50204,26,1,2015,29,17,12
50205,26,64,2015,144,81,63
50206,26,128,2015,3962,1695,2267
50207,26,115,2015,290,149,141
50208,26,65,2015,1190,665,525
50209,26,145,2015,393,131,262
50210,26,148,2015,75,51,24
50211,26,49,2015,5252,2998,2254
50212,26,74,2015,10209,5701,4508
50213,26,25,2015,2714774,1058902,1655872
50214,26,169,2015,272,72,200
50215,26,27,2015,43,15,28
50216,26,146,2015,507,210,297
50217,26,170,2015,2001,596,1405
50218,26,38,2015,4114,3069,1045
50219,26,60,2015,141740,61007,80733
50220,26,142,2015,773,339,434
50221,26,50,2015,18624,10609,8015
50222,26,131,2015,218,24,194
50223,26,114,2015,43,21,22
50224,26,171,2015,7842,4325,3517
50225,26,28,2015,99,43,56
50226,170,2,2015,231,115,116
50227,170,12,2015,7654,3922,3732
50228,170,11,2015,7113,3674,3439
50229,170,29,2015,2059,736,1323
50230,170,69,2015,1038,606,432
50231,170,6,2015,1904,974,930
50232,170,167,2015,20145,10419,9726
50233,170,36,2015,75153,41619,33534
50234,170,169,2015,1478,739,739
50235,170,38,2015,8012,3981,4031
50236,170,171,2015,67505,36160,31345
50237,94,78,2015,273,131,142
50238,94,83,2015,1756,877,879
50239,94,85,2015,13928,6963,6965
50240,94,50,2015,416,185,231
50241,130,141,2015,0,0,0
50242,130,3,2015,126,108,18
50243,130,67,2015,38,19,19
50244,130,116,2015,44379,21225,23154
50245,130,172,2015,366,135,231
50246,130,137,2015,286214,147997,138217
50247,130,81,2015,16,1,15
50248,130,39,2015,154,80,74
50249,130,120,2015,2507,1259,1248
50250,130,119,2015,9250,4652,4598
50251,130,68,2015,222,86,136
50252,130,155,2015,0,0,0
50253,130,69,2015,209,102,107
50254,130,156,2015,0,0,0
50255,130,56,2015,35,19,16
50256,130,32,2015,8,8,0
50257,130,5,2015,3520,1318,2202
50258,130,57,2015,362,33,329
50259,130,177,2015,183,64,119
50260,130,121,2015,38254,21939,16315
50261,130,176,2015,131,31,100
50262,130,143,2015,0,0,0
50263,130,123,2015,6,1,5
50264,130,161,2015,0,0,0
50265,130,125,2015,26,12,14
50266,130,73,2015,191,99,92
50267,130,162,2015,3,0,3
50268,130,48,2015,7,0,7
50269,130,9,2015,1004,349,655
50270,130,36,2015,272,161,111
50271,130,126,2015,72393,36784,35609
50272,130,164,2015,0,0,0
50273,130,128,2015,35224,17713,17511
50274,130,133,2015,2,0,2
50275,130,65,2015,53,36,17
50276,130,129,2015,262321,130784,131537
50277,130,145,2015,66853,36640,30213
50278,130,49,2015,25,0,25
50279,130,166,2015,3,0,3
50280,130,142,2015,0,0,0
50281,130,50,2015,1072,505,567
50282,130,131,2015,21916,11287,10629
50283,130,132,2015,6,2,4
50284,38,2,2015,4812,1076,3736
50285,38,12,2015,82299,36415,45884
50286,38,11,2015,47307,19891,27416
50287,38,30,2015,1732,560,1172
50288,38,29,2015,245534,144545,100989
50289,38,172,2015,6560,2357,4203
50290,38,40,2015,10222,5096,5126
50291,38,15,2015,64399,29408,34991
50292,38,69,2015,1083,498,585
50293,38,5,2015,3816,745,3071
50294,38,6,2015,2136,395,1741
50295,38,17,2015,3752,1822,1930
50296,38,167,2015,222245,122050,100195
50297,38,18,2015,3714,83,3631
50298,38,168,2015,26729,14443,12286
50299,38,20,2015,1764,97,1667
50300,38,46,2015,19497,9718,9779
50301,38,47,2015,24418,12173,12245
50302,38,144,2015,1737,488,1249
50303,38,33,2015,3078,1661,1417
50304,38,36,2015,3275758,1928582,1347176
50305,38,1,2015,12390,5260,7130
50306,38,25,2015,3720,144,3576
50307,38,169,2015,29367,14775,14592
50308,38,26,2015,1355,191,1164
50309,38,170,2015,22602,12013,10589
50310,38,171,2015,219814,110516,109298
50311,27,2,2015,7515,2339,5176
50312,27,13,2015,1834,1046,788
50313,27,3,2015,1004611,131213,873398
50314,27,10,2015,110523,49177,61346
50315,27,136,2015,4909,1523,3386
50316,27,120,2015,10136,3155,6981
50317,27,119,2015,17735,5524,12211
50318,27,68,2015,16642,6134,10508
50319,27,5,2015,3184043,738080,2445963
50320,27,18,2015,154989,53840,101149
50321,27,19,2015,61939,19445,42494
50322,27,20,2015,38446,11977,26469
50323,27,144,2015,8204,2554,5650
50324,27,8,2015,25580,7966,17614
50325,27,73,2015,2896,1117,1779
50326,27,162,2015,14399,4486,9913
50327,27,9,2015,913855,203076,710779
50328,27,22,2015,2452,1554,898
50329,27,23,2015,6036,1830,4206
50330,27,128,2015,8930,2780,6150
50331,27,129,2015,14607,5095,9512
50332,27,145,2015,122204,42630,79574
50333,27,25,2015,48547,15188,33359
50334,27,146,2015,5389,1677,3712
50335,27,26,2015,35027,10910,24117
50336,27,142,2015,825178,273430,551748
50337,27,50,2015,26777,9114,17663
50338,27,28,2015,188606,58760,129846
50339,50,2,2015,45516,17462,28054
50340,50,51,2015,9267,3429,5838
50341,50,141,2015,20714,6770,13944
50342,50,52,2015,48,21,27
50343,50,134,2015,11936,6378,5558
50344,50,75,2015,717,375,342
50345,50,76,2015,4435,2464,1971
50346,50,103,2015,10087,5766,4321
50347,50,11,2015,1310,720,590
50348,50,77,2015,831,472,359
50349,50,66,2015,20067,11293,8774
50350,50,12,2015,2014,1086,928
50351,50,78,2015,2166,1165,1001
50352,50,13,2015,5826,2885,2941
50353,50,3,2015,215649,101608,114041
50354,50,79,2015,23586,12317,11269
50355,50,29,2015,3222,2130,1092
50356,50,67,2015,23934,12551,11383
50357,50,95,2015,1503,1047,456
50358,50,151,2015,500,237,263
50359,50,4,2015,299,105,194
50360,50,53,2015,8486,4765,3721
50361,50,147,2015,3089,1592,1497
50362,50,105,2015,39136,22340,16796
50363,50,30,2015,65868,34138,31730
50364,50,152,2015,183,82,101
50365,50,116,2015,3780,2126,1654
50366,50,153,2015,881,504,377
50367,50,135,2015,7828,4037,3791
50368,50,80,2015,1123,642,481
50369,50,136,2015,307,110,197
50370,50,106,2015,7143,3951,3192
50371,50,172,2015,199428,113764,85664
50372,50,173,2015,109963,54145,55818
50373,50,107,2015,22151,13256,8895
50374,50,117,2015,118,67,51
50375,50,137,2015,7069,4041,3028
50376,50,96,2015,632,347,285
50377,50,54,2015,5934,2614,3320
50378,50,81,2015,2067,1092,975
50379,50,14,2015,74836,40581,34255
50380,50,31,2015,42812,26421,16391
50381,50,176,2015,10087,5892,4195
50382,50,137,2015,16324,8837,7487
50383,50,39,2015,25684,15372,10312
50384,50,118,2015,401,227,174
50385,50,82,2015,7641,4106,3535
50386,50,83,2015,1104,538,566
50387,50,108,2015,6857,3769,3088
50388,50,142,2015,32631,14510,18121
50389,50,97,2015,855,523,332
50390,50,138,2015,199,130,69
50391,50,119,2015,15103,7905,7198
50392,50,40,2015,13633,9148,4485
50393,50,148,2015,1361,749,612
50394,50,120,2015,13536,7434,6102
50395,50,41,2015,389,239,150
50396,50,42,2015,15019,11835,3184
50397,50,68,2015,149752,81547,68205
50398,50,139,2015,288,165,123
50399,50,155,2015,8874,4111,4763
50400,50,15,2015,2151,1133,1018
50401,50,69,2015,305973,168941,137032
50402,50,156,2015,116139,56749,59390
50403,50,55,2015,10989,5674,5315
50404,50,56,2015,53324,25786,27538
50405,50,84,2015,11126,6057,5069
50406,50,98,2015,855,520,335
50407,50,157,2015,1517,699,818
50408,50,158,2015,1611,831,780
50409,50,110,2015,24874,14694,10180
50410,50,85,2015,276,157,119
50411,50,99,2015,616,386,230
50412,50,32,2015,80777,37904,42873
50413,50,43,2015,2102,1172,930
50414,50,5,2015,807790,393154,414636
50415,50,6,2015,74004,30835,43169
50416,50,16,2015,62520,23715,38805
50417,50,44,2015,389731,218627,171104
50418,50,45,2015,9732,5019,4713
50419,50,17,2015,17540,8483,9057
50420,50,57,2015,152535,74514,78021
50421,50,86,2015,138858,84230,54628
50422,50,177,2015,43623,27707,15916
50423,50,18,2015,5225,2020,3205
50424,50,167,2015,3441,2179,1262
50425,50,121,2015,131845,69971,61874
50426,50,19,2015,11020,4777,6243
50427,50,168,2015,687,455,232
50428,50,46,2015,103879,55157,48722
50429,50,20,2015,15356,6579,8777
50430,50,149,2015,650,394,256
50431,50,159,2015,2995,1306,1689
50432,50,143,2015,14887,6473,8414
50433,50,70,2015,31,23,8
50434,50,47,2015,139429,76204,63225
50435,50,71,2015,1979,1783,196
50436,50,122,2015,1067,713,354
50437,50,123,2015,16865,8769,8096
50438,50,7,2015,331,164,167
50439,50,160,2015,292,125,167
50440,50,58,2015,27203,13234,13969
50441,50,161,2015,142,56,86
50442,50,124,2015,40190,20272,19918
50443,50,100,2015,8619,4823,3796
50444,50,72,2015,361,160,201
50445,50,59,2015,1031,520,511
50446,50,87,2015,9632,5523,4109
50447,50,144,2015,19914,9506,10408
50448,50,125,2015,5398,2935,2463
50449,50,150,2015,2151,1154,997
50450,50,8,2015,32969,14386,18583
50451,50,73,2015,67096,33752,33344
50452,50,101,2015,350,216,134
50453,50,162,2015,181046,91044,90002
50454,50,60,2015,2460,1448,1012
50455,50,48,2015,17918,10723,7195
50456,50,21,2015,3032,1321,1711
50457,50,9,2015,532502,245331,287171
50458,50,102,2015,701,413,288
50459,50,111,2015,732,409,323
50460,50,112,2015,6581,4178,2403
50461,50,33,2015,804481,424613,379868
50462,50,61,2015,129278,70945,58333
50463,50,22,2015,2079,847,1232
50464,50,35,2015,172953,82361,90592
50465,50,36,2015,32073,21263,10810
50466,50,126,2015,3967,2228,1739
50467,50,90,2015,7087,3841,3246
50468,50,91,2015,10144,5634,4510
50469,50,92,2015,8470,4449,4021
50470,50,140,2015,605,386,219
50471,50,23,2015,24638,10684,13954
50472,50,164,2015,1573,693,880
50473,50,63,2015,8280,4528,3752
50474,50,127,2015,3791,2316,1475
50475,50,165,2015,23618,13005,10613
50476,50,37,2015,76005,42099,33906
50477,50,64,2015,3512,1486,2026
50478,50,128,2015,133284,84729,48555
50479,50,115,2015,204440,109876,94564
50480,50,65,2015,121378,67447,53931
50481,50,10,2015,141998,66351,75647
50482,50,145,2015,16904,7367,9537
50483,50,113,2015,409,249,160
50484,50,49,2015,21303,12698,8605
50485,50,74,2015,20952,12710,8242
50486,50,25,2015,8144,3217,4927
50487,50,169,2015,302,168,134
50488,50,166,2015,1259,544,715
50489,50,93,2015,26142,16263,9879
50490,50,146,2015,5359,1741,3618
50491,50,26,2015,86116,39023,47093
50492,50,170,2015,477,295,182
50493,50,94,2015,134,70,64
50494,50,130,2015,67625,34732,32893
50495,50,38,2015,19596,10679,8917
50496,50,27,2015,9805,4298,5507
50497,50,131,2015,39975,20261,19714
50498,50,114,2015,1359,740,619
50499,50,171,2015,1850,983,867
50500,50,1,2015,31158,17135,14023
50501,50,28,2015,17782,8020,9762
50502,50,132,2015,29271,16026,13245
50503,50,133,2015,150915,84665,66250
50504,114,103,2015,27662,15576,12086
50505,114,105,2015,12369,7404,4965
50506,114,106,2015,1288,674,614
50507,114,68,2015,470,245,225
50508,114,69,2015,1384,755,629
50509,114,57,2015,7327,3340,3987
50510,114,100,2015,532,297,235
50511,114,111,2015,1027,701,326
50512,114,112,2015,90,28,62
50513,114,33,2015,1166,658,508
50514,114,61,2015,560,270,290
50515,114,35,2015,611,321,290
50516,114,65,2015,16232,8879,7353
50517,114,50,2015,454,263,191
50518,171,12,2015,20357,9612,10745
50519,171,11,2015,5870,2806,3064
50520,171,29,2015,26532,13651,12881
50521,171,69,2015,8610,4541,4069
50522,171,167,2015,13194,7225,5969
50523,171,168,2015,4894,2673,2221
50524,171,36,2015,877690,474188,403502
50525,171,169,2015,11496,5436,6060
50526,171,170,2015,763,311,452
50527,171,38,2015,124602,66049,58553
50528,1,3,2015,7895,3589,4306
50529,1,10,2015,79,32,47
50530,1,172,2015,3005,1252,1753
50531,1,68,2015,205,59,146
50532,1,5,2015,1938,796,1142
50533,1,177,2015,1843,665,1178
50534,1,176,2015,1503,656,847
50535,1,8,2015,2315,1062,1253
50536,1,9,2015,591,268,323
50537,1,50,2015,1119,516,603
50538,28,120,2015,15740,6587,9153
50539,28,119,2015,1902,718,1184
50540,28,6,2015,7,3,4
50541,28,16,2015,9801,4733,5068
50542,28,1,2015,15,7,8
50543,28,128,2015,275683,130423,145260
50544,28,129,2015,541,259,282
50545,28,145,2015,26541,12710,13831
50546,28,25,2015,3943,1893,2050
50547,28,142,2015,7596,3653,3943
50548,132,134,2015,27864,13831,14033
50549,132,147,2015,808,437,371
50550,132,116,2015,4856,2337,2519
50551,132,135,2015,214,100,114
50552,132,172,2015,887,270,617
50553,132,137,2015,7471,3730,3741
50554,132,137,2015,26440,13066,13374
50555,132,68,2015,61,36,25
50556,132,69,2015,245,113,132
50557,132,156,2015,154,49,105
50558,132,5,2015,4078,1867,2211
50559,132,177,2015,88,44,44
50560,132,121,2015,472,213,259
50561,132,123,2015,10363,5248,5115
50562,132,160,2015,191,66,125
50563,132,125,2015,1146,561,585
50564,132,150,2015,554,308,246
50565,132,162,2015,447,197,250
50566,132,126,2015,6573,3186,3387
50567,132,164,2015,125,30,95
50568,132,115,2015,2706,1334,1372
50569,132,133,2015,13175,7301,5874
50570,132,130,2015,401,156,245
50571,132,142,2015,144,53,91
50572,132,50,2015,1132,535,597
50573,132,131,2015,4726,2550,2176
50574,133,147,2015,3725,1626,2099
50575,133,123,2015,104247,45332,58915
50576,133,125,2015,118442,51767,66675
50577,133,115,2015,19013,8299,10714
50578,133,50,2015,12243,5347,6896
50579,133,132,2015,30538,13433,17105
50580,2,9,2020,102500,52512,49988
50581,2,169,2020,4422,2687,1735
50582,2,171,2020,219,133,86
50583,51,56,2020,29643,15397,14246
50584,51,57,2020,8344,3852,4492
50585,51,26,2020,1838,576,1262
50586,51,60,2020,499,253,246
50587,141,68,2020,543,310,233
50588,141,69,2020,761,508,253
50589,141,16,2020,7441,3906,3535
50590,141,57,2020,725,447,278
50591,141,18,2020,2216,1051,1165
50592,141,19,2020,1172,404,768
50593,141,20,2020,1199,738,461
50594,141,143,2020,2281,1084,1197
50595,141,36,2020,785,460,325
50596,141,23,2020,3852,1491,2361
50597,141,128,2020,11361,5134,6227
50598,141,145,2020,1566,738,828
50599,141,25,2020,7757,3677,4080
50600,141,50,2020,782,456,326
50601,141,28,2020,2320,985,1335
50602,52,103,2020,734,355,379
50603,52,67,2020,230,101,129
50604,52,106,2020,229,104,125
50605,52,39,2020,119,0,119
50606,52,68,2020,4194,1898,2296
50607,52,69,2020,364,167,197
50608,52,57,2020,492,228,264
50609,52,144,2020,505,231,274
50610,52,73,2020,262,116,146
50611,52,61,2020,11534,5330,6204
50612,52,65,2020,22196,11173,11023
50613,52,49,2020,51,0,51
50614,52,74,2020,85,0,85
50615,52,50,2020,1135,519,616
50616,52,114,2020,108,48,60
50617,134,153,2020,9215,4603,4612
50618,134,136,2020,1889,763,1126
50619,134,137,2020,1059,614,445
50620,134,137,2020,90444,36588,53856
50621,134,157,2020,18142,7338,10804
50622,134,125,2020,248,124,124
50623,134,150,2020,890,453,437
50624,134,61,2020,5292,2676,2616
50625,134,126,2020,1260,701,559
50626,134,140,2020,6852,3537,3315
50627,134,115,2020,6295,3220,3075
50628,134,132,2020,307,191,116
50629,75,83,2020,680,242,438
50630,75,110,2020,397,163,234
50631,75,86,2020,483,207,276
50632,75,87,2020,296,87,209
50633,75,90,2020,942,328,614
50634,75,50,2020,435,287,148
50635,76,78,2020,1,0,1
50636,76,79,2020,315,129,186
50637,76,95,2020,13,5,8
50638,76,172,2020,139,70,69
50639,76,81,2020,19,10,9
50640,76,82,2020,4963,2776,2187
50641,76,83,2020,1865,1162,703
50642,76,120,2020,92,49,43
50643,76,68,2020,41,21,20
50644,76,109,2020,4,1,3
50645,76,69,2020,85,43,42
50646,76,156,2020,31,15,16
50647,76,84,2020,199,87,112
50648,76,110,2020,6811,3784,3027
50649,76,85,2020,33,16,17
50650,76,99,2020,6,2,4
50651,76,5,2020,81,40,41
50652,76,57,2020,73,36,37
50653,76,86,2020,4173,2779,1394
50654,76,177,2020,19,10,9
50655,76,20,2020,56,28,28
50656,76,100,2020,4,1,3
50657,76,87,2020,1189,590,599
50658,76,73,2020,15,8,7
50659,76,77,2020,4,1,3
50660,76,162,2020,40,21,19
50661,76,9,2020,0,0,0
50662,76,88,2020,54,27,27
50663,76,90,2020,497,265,232
50664,76,75,2020,39,19,20
50665,76,91,2020,706,400,306
50666,76,92,2020,959,385,574
50667,76,115,2020,45,23,22
50668,76,65,2020,11,5,6
50669,76,113,2020,45,23,22
50670,76,25,2020,254,131,123
50671,76,93,2020,752,387,365
50672,76,94,2020,5,2,3
50673,76,142,2020,9,4,5
50674,76,50,2020,1038,529,509
50675,103,2,2020,9,7,2
50676,103,51,2020,66,27,39
50677,103,141,2020,103,39,64
50678,103,52,2020,1,0,1
50679,103,134,2020,9,6,3
50680,103,66,2020,1030,552,478
50681,103,13,2020,12,4,8
50682,103,11,2020,565,269,296
50683,103,79,2020,7,6,1
50684,103,67,2020,541,270,271
50685,103,105,2020,49267,28324,20943
50686,103,95,2020,6,5,1
50687,103,30,2020,298,158,140
50688,103,29,2020,307,163,144
50689,103,153,2020,24,14,10
50690,103,10,2020,2,0,2
50691,103,106,2020,215198,115290,99908
50692,103,172,2020,14537,6710,7827
50693,103,107,2020,8723,4320,4403
50694,103,137,2020,41,20,21
50695,103,96,2020,124,55,69
50696,103,54,2020,995,486,509
50697,103,81,2020,1116,512,604
50698,103,14,2020,46,24,22
50699,103,31,2020,1810,1075,735
50700,103,39,2020,247,125,122
50701,103,82,2020,4,4,0
50702,103,83,2020,689,500,189
50703,103,108,2020,963,477,486
50704,103,97,2020,74,35,39
50705,103,120,2020,31,17,14
50706,103,40,2020,48,30,18
50707,103,42,2020,71,47,24
50708,103,68,2020,8239,4054,4185
50709,103,69,2020,9332,4966,4366
50710,103,55,2020,14,9,5
50711,103,56,2020,1025,511,514
50712,103,84,2020,11,10,1
50713,103,98,2020,96,47,49
50714,103,157,2020,1,1,0
50715,103,85,2020,40,11,29
50716,103,99,2020,66,33,33
50717,103,173,2020,4,0,4
50718,103,32,2020,822,440,382
50719,103,43,2020,8,7,1
50720,103,5,2020,97,51,46
50721,103,6,2020,137,62,75
50722,103,16,2020,36,20,16
50723,103,44,2020,64,28,36
50724,103,17,2020,562,269,293
50725,103,57,2020,153824,86883,66941
50726,103,86,2020,11,0,11
50727,103,177,2020,4496,2328,2168
50728,103,18,2020,74,24,50
50729,103,121,2020,2,2,0
50730,103,176,2020,14,0,14
50731,103,20,2020,797,428,369
50732,103,46,2020,125,77,48
50733,103,143,2020,50,18,32
50734,103,70,2020,78,27,51
50735,103,47,2020,394,237,157
50736,103,71,2020,96,66,30
50737,103,122,2020,7,5,2
50738,103,58,2020,2,2,0
50739,103,100,2020,1463,698,765
50740,103,72,2020,10,9,1
50741,103,144,2020,213,118,95
50742,103,125,2020,11,10,1
50743,103,150,2020,2,0,2
50744,103,73,2020,389,170,219
50745,103,77,2020,1,1,0
50746,103,101,2020,91,42,49
50747,103,162,2020,42,28,14
50748,103,48,2020,57,13,44
50749,103,9,2020,5,0,5
50750,103,102,2020,161,67,94
50751,103,111,2020,685714,378257,307457
50752,103,112,2020,197226,107058,90168
50753,103,33,2020,7386,4061,3325
50754,103,61,2020,5008,2398,2610
50755,103,88,2020,76,40,36
50756,103,35,2020,1087,575,512
50757,103,36,2020,1902,994,908
50758,103,62,2020,16,2,14
50759,103,23,2020,80,28,52
50760,103,1,2020,5,2,3
50761,103,64,2020,817,403,414
50762,103,128,2020,2,0,2
50763,103,115,2020,127,63,64
50764,103,133,2020,2,2,0
50765,103,65,2020,99006,56332,42674
50766,103,145,2020,8,0,8
50767,103,113,2020,5,5,0
50768,103,49,2020,205,97,108
50769,103,74,2020,800,374,426
50770,103,25,2020,1135,534,601
50771,103,93,2020,33,11,22
50772,103,146,2020,44,14,30
50773,103,26,2020,641,312,329
50774,103,130,2020,1,1,0
50775,103,38,2020,4451,2250,2201
50776,103,60,2020,1503,801,702
50777,103,142,2020,240,102,138
50778,103,50,2020,951,473,478
50779,103,131,2020,1,0,1
50780,103,152,2020,11,9,2
50781,103,114,2020,134043,70146,63897
50782,103,132,2020,1,0,1
50783,11,12,2020,78560,45640,32920
50784,11,29,2020,304,185,119
50785,11,15,2020,37921,23089,14832
50786,11,69,2020,631,314,317
50787,11,56,2020,1015,558,457
50788,11,6,2020,8097,4123,3974
50789,11,16,2020,1088,600,488
50790,11,167,2020,786,528,258
50791,11,20,2020,848,449,399
50792,11,36,2020,19082,12806,6276
50793,11,25,2020,17416,9062,8354
50794,11,26,2020,539,347,192
50795,11,170,2020,811,501,310
50796,11,38,2020,2452,1800,652
50797,11,171,2020,983,640,343
50798,77,172,2020,1260,625,635
50799,77,107,2020,10926,6865,4061
50800,77,82,2020,119,85,34
50801,77,83,2020,4839,3091,1748
50802,77,84,2020,287,220,67
50803,77,110,2020,322,173,149
50804,77,85,2020,1824,1183,641
50805,77,5,2020,368,128,240
50806,77,86,2020,833,574,259
50807,77,73,2020,5128,2529,2599
50808,77,101,2020,119,65,54
50809,77,112,2020,1268,635,633
50810,77,61,2020,182,93,89
50811,77,92,2020,126,99,27
50812,77,113,2020,1494,809,685
50813,77,26,2020,11,4,7
50814,66,2,2020,47602,15255,32347
50815,66,51,2020,4398,2264,2134
50816,66,141,2020,1581,423,1158
50817,66,52,2020,3,0,3
50818,66,134,2020,436,204,232
50819,66,76,2020,8,7,1
50820,66,103,2020,1698,851,847
50821,66,11,2020,3433,1828,1605
50822,66,77,2020,1,1,0
50823,66,12,2020,1410,721,689
50824,66,78,2020,23,9,14
50825,66,13,2020,41,24,17
50826,66,3,2020,3326,1168,2158
50827,66,79,2020,19,8,11
50828,66,29,2020,2113,1576,537
50829,66,67,2020,3013,1512,1501
50830,66,95,2020,9,7,2
50831,66,151,2020,113,28,85
50832,66,4,2020,23,13,10
50833,66,53,2020,168798,85540,83258
50834,66,147,2020,23,17,6
50835,66,105,2020,6173,3948,2225
50836,66,30,2020,29257,16112,13145
50837,66,152,2020,159,71,88
50838,66,116,2020,99,50,49
50839,66,153,2020,54,35,19
50840,66,135,2020,793,354,439
50841,66,80,2020,6,2,4
50842,66,136,2020,18,7,11
50843,66,106,2020,1384,715,669
50844,66,172,2020,17776,10274,7502
50845,66,173,2020,0,0,0
50846,66,174,2020,0,0,0
50847,66,107,2020,2139,1298,841
50848,66,117,2020,0,0,0
50849,66,137,2020,327,146,181
50850,66,96,2020,220,125,95
50851,66,54,2020,46770,24779,21991
50852,66,81,2020,1020,654,366
50853,66,14,2020,346,174,172
50854,66,31,2020,37118,23443,13675
50855,66,176,2020,113,57,56
50856,66,137,2020,1007,487,520
50857,66,39,2020,1368,764,604
50858,66,118,2020,8,2,6
50859,66,82,2020,38,25,13
50860,66,83,2020,3224,2197,1027
50861,66,108,2020,796,459,337
50862,66,142,2020,14779,5554,9225
50863,66,97,2020,108,66,42
50864,66,138,2020,7,5,2
50865,66,119,2020,357,141,216
50866,66,40,2020,571,402,169
50867,66,148,2020,23,13,10
50868,66,120,2020,1382,783,599
50869,66,41,2020,0,0,0
50870,66,42,2020,1771,1215,556
50871,66,68,2020,9184,4971,4213
50872,66,139,2020,46,24,22
50873,66,155,2020,760,137,623
50874,66,15,2020,3716,2089,1627
50875,66,69,2020,232836,123022,109814
50876,66,156,2020,2339,979,1360
50877,66,55,2020,11,5,6
50878,66,56,2020,6778,2851,3927
50879,66,84,2020,18,11,7
50880,66,98,2020,433,205,228
50881,66,157,2020,461,136,325
50882,66,158,2020,96,20,76
50883,66,110,2020,19,14,5
50884,66,85,2020,108,56,52
50885,66,99,2020,124,76,48
50886,66,32,2020,79205,43103,36102
50887,66,43,2020,206,93,113
50888,66,5,2020,14992,6317,8675
50889,66,6,2020,24092,10308,13784
50890,66,16,2020,15343,5542,9801
50891,66,44,2020,1290,539,751
50892,66,17,2020,2226,943,1283
50893,66,57,2020,34205,15782,18423
50894,66,86,2020,222,130,92
50895,66,177,2020,2867,2010,857
50896,66,18,2020,958,360,598
50897,66,167,2020,2414,1569,845
50898,66,121,2020,1254,878,376
50899,66,19,2020,490,183,307
50900,66,168,2020,980,645,335
50901,66,46,2020,1708,1125,583
50902,66,20,2020,1942,838,1104
50903,66,149,2020,6,5,1
50904,66,159,2020,240,52,188
50905,66,143,2020,910,369,541
50906,66,70,2020,332,200,132
50907,66,47,2020,1537,1028,509
50908,66,71,2020,1178,515,663
50909,66,122,2020,133,94,39
50910,66,123,2020,51,20,31
50911,66,7,2020,14,3,11
50912,66,160,2020,125,35,90
50913,66,58,2020,121,66,55
50914,66,161,2020,31,3,28
50915,66,124,2020,126,75,51
50916,66,100,2020,2277,1334,943
50917,66,72,2020,23,9,14
50918,66,59,2020,1937,994,943
50919,66,144,2020,2411,1091,1320
50920,66,125,2020,98,58,40
50921,66,150,2020,246,147,99
50922,66,8,2020,799,365,434
50923,66,73,2020,9128,4549,4579
50924,66,101,2020,275,164,111
50925,66,162,2020,8535,3157,5378
50926,66,60,2020,26880,12850,14030
50927,66,48,2020,860,480,380
50928,66,21,2020,102,31,71
50929,66,9,2020,6097,2021,4076
50930,66,102,2020,65,39,26
50931,66,111,2020,217,126,91
50932,66,112,2020,1816,1180,636
50933,66,33,2020,75752,39249,36503
50934,66,61,2020,2930,1200,1730
50935,66,88,2020,0,0,0
50936,66,22,2020,63,23,40
50937,66,35,2020,121355,63819,57536
50938,66,36,2020,34745,20893,13852
50939,66,126,2020,250,126,124
50940,66,90,2020,0,0,0
50941,66,91,2020,16,6,10
50942,66,92,2020,12,6,6
50943,66,62,2020,1,1,0
50944,66,140,2020,1,0,1
50945,66,23,2020,828,361,467
50946,66,164,2020,383,118,265
50947,66,63,2020,177609,91510,86099
50948,66,127,2020,32,19,13
50949,66,165,2020,236,66,170
50950,66,37,2020,42800,26965,15835
50951,66,64,2020,24263,13131,11132
50952,66,128,2020,8547,3074,5473
50953,66,115,2020,2871,1571,1300
50954,66,65,2020,7575,3906,3669
50955,66,10,2020,973,458,515
50956,66,145,2020,783,254,529
50957,66,113,2020,22,13,9
50958,66,49,2020,3051,1783,1268
50959,66,74,2020,15405,8359,7046
50960,66,25,2020,53259,21903,31356
50961,66,169,2020,633,323,310
50962,66,166,2020,220,83,137
50963,66,93,2020,111,62,49
50964,66,146,2020,4181,1409,2772
50965,66,26,2020,159999,76372,83627
50966,66,170,2020,230,151,79
50967,66,130,2020,374,195,179
50968,66,38,2020,14046,9684,4362
50969,66,27,2020,558,269,289
50970,66,50,2020,11721,5346,6375
50971,66,131,2020,223,115,108
50972,66,114,2020,273,141,132
50973,66,171,2020,1190,679,511
50974,66,1,2020,3412,1948,1464
50975,66,28,2020,366,135,231
50976,66,132,2020,130,78,52
50977,66,133,2020,352,183,169
50978,12,2,2020,176,50,126
50979,12,11,2020,141756,69684,72072
50980,12,29,2020,437,330,107
50981,12,40,2020,462,242,220
50982,12,15,2020,48815,25175,23640
50983,12,69,2020,270,150,120
50984,12,6,2020,1460,533,927
50985,12,167,2020,3456,2007,1449
50986,12,168,2020,2438,1254,1184
50987,12,36,2020,27452,18458,8994
50988,12,169,2020,236,140,96
50989,12,26,2020,2023,516,1507
50990,12,170,2020,1644,917,727
50991,12,38,2020,2687,1957,730
50992,12,171,2020,16254,8398,7856
50993,78,76,2020,13,7,6
50994,78,103,2020,117,39,78
50995,78,66,2020,41,20,21
50996,78,79,2020,253,91,162
50997,78,67,2020,30,11,19
50998,78,147,2020,13,4,9
50999,78,105,2020,128,65,63
51000,78,95,2020,45,29,16
51001,78,30,2020,21,4,17
51002,78,80,2020,23,9,14
51003,78,10,2020,40,17,23
51004,78,106,2020,36,20,16
51005,78,172,2020,183,77,106
51006,78,107,2020,205,83,122
51007,78,96,2020,56,34,22
51008,78,81,2020,429,295,134
51009,78,39,2020,15,8,7
51010,78,82,2020,79,41,38
51011,78,83,2020,310,126,184
51012,78,108,2020,44,14,30
51013,78,97,2020,77,4,73
51014,78,40,2020,15,9,6
51015,78,68,2020,152,53,99
51016,78,69,2020,308,160,148
51017,78,156,2020,49,8,41
51018,78,56,2020,96,32,64
51019,78,84,2020,34,19,15
51020,78,98,2020,36,19,17
51021,78,110,2020,1430,807,623
51022,78,85,2020,29629,12867,16762
51023,78,99,2020,44,8,36
51024,78,173,2020,26,13,13
51025,78,5,2020,640,280,360
51026,78,44,2020,61,27,34
51027,78,57,2020,168,55,113
51028,78,86,2020,8042,5602,2440
51029,78,177,2020,36,27,9
51030,78,121,2020,21,12,9
51031,78,100,2020,143,51,92
51032,78,73,2020,56,23,33
51033,78,101,2020,9,3,6
51034,78,162,2020,170,81,89
51035,78,48,2020,11,7,4
51036,78,9,2020,0,0,0
51037,78,102,2020,54,36,18
51038,78,112,2020,335,187,148
51039,78,33,2020,20,12,8
51040,78,61,2020,15,2,13
51041,78,35,2020,108,3,105
51042,78,36,2020,58,47,11
51043,78,90,2020,35,21,14
51044,78,91,2020,82,40,42
51045,78,92,2020,41,10,31
51046,78,115,2020,110,51,59
51047,78,133,2020,14,7,7
51048,78,65,2020,117,23,94
51049,78,148,2020,11,6,5
51050,78,49,2020,29,14,15
51051,78,74,2020,327,227,100
51052,78,93,2020,418,225,193
51053,78,94,2020,1655,988,667
51054,78,130,2020,11,8,3
51055,78,38,2020,18,13,5
51056,78,142,2020,31,12,19
51057,78,50,2020,2135,904,1231
51058,78,114,2020,17,7,10
51059,13,2,2020,860,259,601
51060,13,3,2020,115071,14602,100469
51061,13,10,2020,12667,5471,7196
51062,13,136,2020,562,167,395
51063,13,120,2020,1159,350,809
51064,13,119,2020,2032,614,1418
51065,13,68,2020,1911,685,1226
51066,13,5,2020,365098,82224,282874
51067,13,18,2020,17769,5999,11770
51068,13,19,2020,7098,2164,4934
51069,13,20,2020,4413,1335,3078
51070,13,144,2020,939,284,655
51071,13,8,2020,2942,887,2055
51072,13,73,2020,330,124,206
51073,13,162,2020,1655,502,1153
51074,13,9,2020,104698,22603,82095
51075,13,22,2020,281,171,110
51076,13,23,2020,690,203,487
51077,13,128,2020,1020,309,711
51078,13,129,2020,1671,565,1106
51079,13,145,2020,13982,4738,9244
51080,13,25,2020,5553,1680,3873
51081,13,27,2020,7954,3538,4416
51082,13,146,2020,618,186,432
51083,13,26,2020,4007,1213,2794
51084,13,142,2020,94638,30466,64172
51085,13,50,2020,3062,1009,2053
51086,13,28,2020,21605,6538,15067
51087,3,13,2020,29574,20438,9136
51088,3,105,2020,14628,10110,4518
51089,3,172,2020,159619,110317,49302
51090,3,5,2020,33762,23334,10428
51091,3,177,2020,13494,9326,4168
51092,3,8,2020,38301,26470,11831
51093,3,48,2020,14032,9697,4335
51094,3,1,2020,26986,18650,8336
51095,3,50,2020,32820,22683,10137
51096,79,76,2020,194,112,82
51097,79,78,2020,48,27,21
51098,79,95,2020,21,10,11
51099,79,172,2020,42,17,25
51100,79,81,2020,57,28,29
51101,79,82,2020,339,225,114
51102,79,84,2020,391,251,140
51103,79,110,2020,6667,3539,3128
51104,79,85,2020,32,22,10
51105,79,5,2020,467,238,229
51106,79,86,2020,1004,656,348
51107,79,90,2020,109,59,50
51108,79,91,2020,2200,1327,873
51109,79,92,2020,3148,1881,1267
51110,79,113,2020,46,34,12
51111,79,93,2020,1506,955,551
51112,79,50,2020,2537,1432,1105
51113,29,2,2020,277,87,190
51114,29,141,2020,51,7,44
51115,29,12,2020,13294,5627,7667
51116,29,103,2020,99,65,34
51117,29,66,2020,57,39,18
51118,29,11,2020,5643,2259,3384
51119,29,67,2020,34,13,21
51120,29,105,2020,91,66,25
51121,29,30,2020,59,28,31
51122,29,81,2020,42,1,41
51123,29,31,2020,93,65,28
51124,29,39,2020,195,78,117
51125,29,120,2020,23,0,23
51126,29,40,2020,3194,2107,1087
51127,29,42,2020,2079,1114,965
51128,29,15,2020,8381,3542,4839
51129,29,69,2020,64,29,35
51130,29,56,2020,105,71,34
51131,29,32,2020,335,210,125
51132,29,5,2020,46,7,39
51133,29,6,2020,47,8,39
51134,29,44,2020,22,14,8
51135,29,17,2020,380,204,176
51136,29,57,2020,22,1,21
51137,29,167,2020,68934,35688,33246
51138,29,18,2020,28,0,28
51139,29,176,2020,58,39,19
51140,29,168,2020,5156,2661,2495
51141,29,20,2020,63,0,63
51142,29,46,2020,10332,7289,3043
51143,29,47,2020,17130,12605,4525
51144,29,48,2020,59,25,34
51145,29,9,2020,45,0,45
51146,29,33,2020,470,252,218
51147,29,35,2020,21,11,10
51148,29,36,2020,672481,371772,300709
51149,29,63,2020,33,11,22
51150,29,37,2020,25,16,9
51151,29,1,2020,359,190,169
51152,29,65,2020,33,17,16
51153,29,49,2020,333,159,174
51154,29,74,2020,27,14,13
51155,29,25,2020,80,0,80
51156,29,169,2020,5595,2732,2863
51157,29,27,2020,21,10,11
51158,29,26,2020,23,0,23
51159,29,170,2020,5382,2755,2627
51160,29,38,2020,222436,114804,107632
51161,29,50,2020,453,285,168
51162,29,114,2020,26,22,4
51163,29,171,2020,14570,7523,7047
51164,29,28,2020,31,4,27
51165,67,2,2020,24670,7221,17449
51166,67,51,2020,11937,6012,5925
51167,67,141,2020,27491,12311,15180
51168,67,52,2020,42,21,21
51169,67,134,2020,7095,3516,3579
51170,67,76,2020,1,1,0
51171,67,103,2020,2587,1389,1198
51172,67,11,2020,1834,870,964
51173,67,66,2020,3354,1913,1441
51174,67,12,2020,292,133,159
51175,67,78,2020,13,7,6
51176,67,13,2020,60,29,31
51177,67,3,2020,2694,1097,1597
51178,67,79,2020,22,11,11
51179,67,29,2020,585,315,270
51180,67,95,2020,12,8,4
51181,67,151,2020,1640,706,934
51182,67,4,2020,269,84,185
51183,67,53,2020,714,367,347
51184,67,147,2020,38,18,20
51185,67,105,2020,16345,9798,6547
51186,67,30,2020,37595,18885,18710
51187,67,152,2020,1664,832,832
51188,67,116,2020,8485,4724,3761
51189,67,153,2020,919,498,421
51190,67,135,2020,21165,11133,10032
51191,67,80,2020,0,0,0
51192,67,136,2020,545,246,299
51193,67,106,2020,4350,2257,2093
51194,67,172,2020,21418,12578,8840
51195,67,107,2020,7250,4312,2938
51196,67,117,2020,91,58,33
51197,67,137,2020,3948,2087,1861
51198,67,96,2020,349,190,159
51199,67,54,2020,558,302,256
51200,67,81,2020,1926,1184,742
51201,67,14,2020,557,276,281
51202,67,31,2020,800,448,352
51203,67,176,2020,94,51,43
51204,67,137,2020,86925,47268,39657
51205,67,39,2020,2467,1332,1135
51206,67,118,2020,1464,759,705
51207,67,82,2020,198,125,73
51208,67,83,2020,3078,1898,1180
51209,67,108,2020,6712,4016,2696
51210,67,142,2020,5188,1725,3463
51211,67,97,2020,1081,593,488
51212,67,138,2020,118,84,34
51213,67,119,2020,2464,875,1589
51214,67,40,2020,962,671,291
51215,67,148,2020,61,41,20
51216,67,120,2020,5283,2357,2926
51217,67,42,2020,2666,1734,932
51218,67,68,2020,189544,102641,86903
51219,67,139,2020,770,430,340
51220,67,155,2020,934,349,585
51221,67,15,2020,690,324,366
51222,67,69,2020,81650,44171,37479
51223,67,156,2020,10443,4983,5460
51224,67,55,2020,11,7,4
51225,67,56,2020,18201,9160,9041
51226,67,84,2020,5,3,2
51227,67,98,2020,890,469,421
51228,67,157,2020,17039,8367,8672
51229,67,158,2020,364,151,213
51230,67,110,2020,101,64,37
51231,67,85,2020,2038,1136,902
51232,67,99,2020,322,223,99
51233,67,32,2020,8293,4698,3595
51234,67,43,2020,231,134,97
51235,67,5,2020,25900,12401,13499
51236,67,6,2020,11918,5375,6543
51237,67,16,2020,21413,7938,13475
51238,67,44,2020,3425,1701,1724
51239,67,17,2020,3418,1419,1999
51240,67,57,2020,121283,58864,62419
51241,67,86,2020,463,264,199
51242,67,177,2020,4804,2728,2076
51243,67,18,2020,1388,547,841
51244,67,167,2020,1176,594,582
51245,67,121,2020,1692,1105,587
51246,67,19,2020,519,189,330
51247,67,168,2020,391,203,188
51248,67,46,2020,1854,1191,663
51249,67,20,2020,8301,3297,5004
51250,67,149,2020,15,12,3
51251,67,159,2020,983,361,622
51252,67,143,2020,1291,507,784
51253,67,70,2020,6,4,2
51254,67,47,2020,2447,1617,830
51255,67,71,2020,14435,7556,6879
51256,67,122,2020,2391,1710,681
51257,67,123,2020,85,36,49
51258,67,7,2020,4,2,2
51259,67,160,2020,1028,484,544
51260,67,58,2020,488,261,227
51261,67,161,2020,2441,625,1816
51262,67,124,2020,3419,2583,836
51263,67,100,2020,3133,1937,1196
51264,67,72,2020,138,80,58
51265,67,59,2020,36,19,17
51266,67,144,2020,225217,110579,114638
51267,67,125,2020,480,267,213
51268,67,150,2020,90,52,38
51269,67,8,2020,4021,1960,2061
51270,67,73,2020,133062,66999,66063
51271,67,101,2020,407,240,167
51272,67,162,2020,6401,3297,3104
51273,67,60,2020,1803,904,899
51274,67,48,2020,1195,615,580
51275,67,21,2020,53,25,28
51276,67,9,2020,13246,5103,8143
51277,67,102,2020,211,135,76
51278,67,111,2020,521,339,182
51279,67,112,2020,3979,2567,1412
51280,67,33,2020,78798,44793,34005
51281,67,61,2020,37506,18146,19360
51282,67,22,2020,105,41,64
51283,67,35,2020,92559,42547,50012
51284,67,36,2020,8210,4061,4149
51285,67,126,2020,14688,8116,6572
51286,67,90,2020,0,0,0
51287,67,91,2020,19,12,7
51288,67,92,2020,6,3,3
51289,67,62,2020,14,7,7
51290,67,140,2020,132,61,71
51291,67,23,2020,1025,435,590
51292,67,164,2020,6767,3046,3721
51293,67,63,2020,769,379,390
51294,67,127,2020,83,54,29
51295,67,165,2020,2407,845,1562
51296,67,37,2020,1752,900,852
51297,67,64,2020,268,142,126
51298,67,128,2020,7393,3422,3971
51299,67,115,2020,4176,2217,1959
51300,67,65,2020,49754,26400,23354
51301,67,10,2020,2246,1113,1133
51302,67,145,2020,1524,483,1041
51303,67,113,2020,4694,2598,2096
51304,67,49,2020,3204,1764,1440
51305,67,74,2020,5370,2894,2476
51306,67,25,2020,33724,14509,19215
51307,67,169,2020,70,37,33
51308,67,166,2020,6373,2789,3584
51309,67,93,2020,106,70,36
51310,67,146,2020,16137,6055,10082
51311,67,26,2020,101925,49131,52794
51312,67,170,2020,15,7,8
51313,67,130,2020,843,483,360
51314,67,38,2020,2648,1409,1239
51315,67,27,2020,864,394,470
51316,67,50,2020,22472,10479,11993
51317,67,131,2020,732,394,338
51318,67,114,2020,533,260,273
51319,67,171,2020,418,205,213
51320,67,1,2020,8596,4942,3654
51321,67,28,2020,426,136,290
51322,67,132,2020,359,215,144
51323,67,133,2020,503,269,234
51324,95,172,2020,2323,1046,1277
51325,95,97,2020,10016,4882,5134
51326,95,69,2020,76,25,51
51327,95,98,2020,26767,13838,12929
51328,95,85,2020,60,25,35
51329,95,99,2020,9784,4872,4912
51330,95,173,2020,78,37,41
51331,95,5,2020,670,300,370
51332,95,86,2020,561,218,343
51333,95,20,2020,60,16,44
51334,95,100,2020,3997,1885,2112
51335,95,162,2020,49,6,43
51336,95,50,2020,462,177,285
51337,151,136,2020,1042,387,655
51338,151,137,2020,4071,1962,2109
51339,151,68,2020,1402,691,711
51340,151,156,2020,16226,9309,6917
51341,151,160,2020,3508,1380,2128
51342,151,162,2020,87145,43352,43793
51343,151,166,2020,113502,72344,41158
51344,151,152,2020,12920,5615,7305
51345,4,3,2020,53,16,37
51346,4,10,2020,33,14,19
51347,4,172,2020,949,243,706
51348,4,39,2020,38,12,26
51349,4,68,2020,30,14,16
51350,4,69,2020,27,11,16
51351,4,5,2020,46974,6566,40408
51352,4,57,2020,12,3,9
51353,4,177,2020,132,46,86
51354,4,8,2020,751,304,447
51355,4,73,2020,19,5,14
51356,4,9,2020,21,0,21
51357,4,49,2020,22,9,13
51358,4,74,2020,24,4,20
51359,4,50,2020,36,20,16
51360,53,66,2020,194,102,92
51361,53,54,2020,11956,6223,5733
51362,53,68,2020,162,86,76
51363,53,69,2020,516,275,241
51364,53,32,2020,148,102,46
51365,53,57,2020,106,63,43
51366,53,59,2020,4108,2138,1970
51367,53,35,2020,379,300,79
51368,53,36,2020,164,126,38
51369,53,63,2020,9550,4960,4590
51370,53,37,2020,3165,1628,1537
51371,53,64,2020,1831,1123,708
51372,53,60,2020,2875,1546,1329
51373,147,134,2020,779,406,373
51374,147,10,2020,988,475,513
51375,147,172,2020,4777,965,3812
51376,147,137,2020,1129,453,676
51377,147,39,2020,344,165,179
51378,147,69,2020,336,185,151
51379,147,5,2020,5650,2351,3299
51380,147,44,2020,626,287,339
51381,147,57,2020,545,193,352
51382,147,121,2020,1210,394,816
51383,147,149,2020,277,196,81
51384,147,122,2020,560,234,326
51385,147,123,2020,1478,558,920
51386,147,124,2020,231,115,116
51387,147,125,2020,604,255,349
51388,147,150,2020,988,302,686
51389,147,73,2020,637,259,378
51390,147,162,2020,1233,593,640
51391,147,48,2020,391,171,220
51392,147,9,2020,464,219,245
51393,147,61,2020,464,182,282
51394,147,127,2020,9,0,9
51395,147,115,2020,5733,2630,3103
51396,147,133,2020,64301,27377,36924
51397,147,148,2020,608,218,390
51398,147,49,2020,437,170,267
51399,147,130,2020,324,126,198
51400,147,50,2020,1315,475,840
51401,147,131,2020,814,359,455
51402,147,132,2020,4415,1956,2459
51403,105,2,2020,73,25,48
51404,105,141,2020,232,112,120
51405,105,52,2020,13,0,13
51406,105,134,2020,8184,3911,4273
51407,105,103,2020,36910,15156,21754
51408,105,66,2020,2968,1599,1369
51409,105,78,2020,19,12,7
51410,105,13,2020,32,0,32
51411,105,3,2020,5384,0,5384
51412,105,11,2020,65,11,54
51413,105,79,2020,35,25,10
51414,105,67,2020,2151,598,1553
51415,105,53,2020,86,46,40
51416,105,95,2020,5,5,0
51417,105,30,2020,301,146,155
51418,105,116,2020,27,0,27
51419,105,29,2020,10,0,10
51420,105,135,2020,175,72,103
51421,105,153,2020,1516,826,690
51422,105,106,2020,19596,7737,11859
51423,105,172,2020,24632,11093,13539
51424,105,107,2020,8700,4242,4458
51425,105,137,2020,99,10,89
51426,105,137,2020,4375,1138,3237
51427,105,96,2020,490,190,300
51428,105,54,2020,726,439,287
51429,105,81,2020,14798,6025,8773
51430,105,31,2020,566,250,316
51431,105,151,2020,32,10,22
51432,105,39,2020,626,197,429
51433,105,82,2020,27,13,14
51434,105,83,2020,1274,990,284
51435,105,108,2020,2195,1064,1131
51436,105,97,2020,289,75,214
51437,105,138,2020,70,50,20
51438,105,120,2020,13,12,1
51439,105,40,2020,231,160,71
51440,105,42,2020,655,301,354
51441,105,68,2020,12138,4391,7747
51442,105,109,2020,896,361,535
51443,105,139,2020,38,0,38
51444,105,15,2020,80,52,28
51445,105,69,2020,20625,8504,12121
51446,105,156,2020,2459,751,1708
51447,105,56,2020,1956,849,1107
51448,105,84,2020,32,5,27
51449,105,98,2020,369,170,199
51450,105,157,2020,73,30,43
51451,105,110,2020,2407,1226,1181
51452,105,85,2020,32796,21522,11274
51453,105,99,2020,160,62,98
51454,105,32,2020,1936,989,947
51455,105,43,2020,612,199,413
51456,105,5,2020,1118,386,732
51457,105,6,2020,678,313,365
51458,105,16,2020,646,228,418
51459,105,44,2020,217,44,173
51460,105,17,2020,2554,985,1569
51461,105,57,2020,47193,19070,28123
51462,105,86,2020,174,26,148
51463,105,177,2020,62296,30022,32274
51464,105,167,2020,30,30,0
51465,105,18,2020,1338,365,973
51466,105,121,2020,56,52,4
51467,105,176,2020,182,69,113
51468,105,19,2020,25,25,0
51469,105,20,2020,15664,5636,10028
51470,105,46,2020,179,139,40
51471,105,159,2020,43,19,24
51472,105,143,2020,121,55,66
51473,105,70,2020,20,0,20
51474,105,47,2020,801,603,198
51475,105,71,2020,68,18,50
51476,105,122,2020,44,38,6
51477,105,123,2020,11,0,11
51478,105,7,2020,11,11,0
51479,105,160,2020,7,0,7
51480,105,58,2020,35,0,35
51481,105,100,2020,3400,1548,1852
51482,105,72,2020,160,98,62
51483,105,59,2020,27,14,13
51484,105,144,2020,644,242,402
51485,105,125,2020,1809,1002,807
51486,105,21,2020,24,10,14
51487,105,150,2020,61,11,50
51488,105,8,2020,63,0,63
51489,105,73,2020,4219,1206,3013
51490,105,101,2020,465,216,249
51491,105,162,2020,3505,899,2606
51492,105,48,2020,728,193,535
51493,105,9,2020,2094,872,1222
51494,105,102,2020,660,226,434
51495,105,111,2020,49842,26595,23247
51496,105,112,2020,19074,7356,11718
51497,105,33,2020,4421,2243,2178
51498,105,61,2020,175251,85451,89800
51499,105,158,2020,1199,394,805
51500,105,35,2020,2164,1203,961
51501,105,36,2020,1761,1065,696
51502,105,126,2020,17,0,17
51503,105,90,2020,38,5,33
51504,105,91,2020,183,120,63
51505,105,92,2020,37,36,1
51506,105,62,2020,43,42,1
51507,105,140,2020,73,55,18
51508,105,23,2020,416,111,305
51509,105,164,2020,6267,694,5573
51510,105,63,2020,550,349,201
51511,105,127,2020,37,0,37
51512,105,165,2020,7,0,7
51513,105,37,2020,268,136,132
51514,105,1,2020,161,55,106
51515,105,64,2020,224,98,126
51516,105,115,2020,2014,567,1447
51517,105,133,2020,129,53,76
51518,105,65,2020,39028,17435,21593
51519,105,113,2020,346,142,204
51520,105,49,2020,804,256,548
51521,105,74,2020,3789,1212,2577
51522,105,25,2020,8003,3403,4600
51523,105,169,2020,8,0,8
51524,105,166,2020,11,0,11
51525,105,93,2020,238,128,110
51526,105,27,2020,40,0,40
51527,105,146,2020,99,14,85
51528,105,26,2020,459,145,314
51529,105,170,2020,27,19,8
51530,105,130,2020,80,35,45
51531,105,38,2020,930,523,407
51532,105,60,2020,48,18,30
51533,105,142,2020,3957,1810,2147
51534,105,50,2020,6281,2378,3903
51535,105,131,2020,111,44,67
51536,105,152,2020,31,18,13
51537,105,114,2020,30537,14593,15944
51538,105,171,2020,32,30,2
51539,30,2,2020,426,128,298
51540,30,51,2020,1351,574,777
51541,30,141,2020,460,177,283
51542,30,52,2020,0,0,0
51543,30,134,2020,15,10,5
51544,30,75,2020,30,8,22
51545,30,76,2020,4,1,3
51546,30,103,2020,127,62,65
51547,30,11,2020,1802,993,809
51548,30,77,2020,3,1,2
51549,30,66,2020,1938,874,1064
51550,30,12,2020,1930,1068,862
51551,30,78,2020,3,3,0
51552,30,13,2020,28,14,14
51553,30,3,2020,539,251,288
51554,30,79,2020,3,3,0
51555,30,29,2020,1110,810,300
51556,30,67,2020,2606,1229,1377
51557,30,95,2020,0,0,0
51558,30,151,2020,27,11,16
51559,30,4,2020,23,9,14
51560,30,53,2020,164,53,111
51561,30,147,2020,26,10,16
51562,30,105,2020,210,121,89
51563,30,152,2020,13,4,9
51564,30,116,2020,18,8,10
51565,30,153,2020,5,2,3
51566,30,135,2020,24,6,18
51567,30,80,2020,3,2,1
51568,30,136,2020,4,1,3
51569,30,106,2020,27,11,16
51570,30,172,2020,1550,808,742
51571,30,107,2020,68,36,32
51572,30,137,2020,26,15,11
51573,30,96,2020,8,2,6
51574,30,54,2020,125,52,73
51575,30,81,2020,301,115,186
51576,30,14,2020,1479,675,804
51577,30,31,2020,1533,845,688
51578,30,176,2020,37,23,14
51579,30,137,2020,13,2,11
51580,30,39,2020,555,241,314
51581,30,118,2020,2,0,2
51582,30,82,2020,0,0,0
51583,30,83,2020,56,31,25
51584,30,108,2020,28,20,8
51585,30,142,2020,358,96,262
51586,30,97,2020,11,3,8
51587,30,119,2020,13,1,12
51588,30,40,2020,103,69,34
51589,30,148,2020,1,1,0
51590,30,120,2020,63,19,44
51591,30,42,2020,211,104,107
51592,30,68,2020,3021,1353,1668
51593,30,139,2020,8,5,3
51594,30,155,2020,9,5,4
51595,30,15,2020,492,271,221
51596,30,69,2020,12588,5933,6655
51597,30,156,2020,29,10,19
51598,30,55,2020,9,7,2
51599,30,56,2020,8061,3554,4507
51600,30,98,2020,4,3,1
51601,30,157,2020,9,1,8
51602,30,158,2020,3,2,1
51603,30,110,2020,3,1,2
51604,30,85,2020,4,1,3
51605,30,99,2020,4,4,0
51606,30,32,2020,391,217,174
51607,30,43,2020,29,15,14
51608,30,5,2020,553,190,363
51609,30,6,2020,475,141,334
51610,30,16,2020,1389,418,971
51611,30,44,2020,385,176,209
51612,30,45,2020,18,6,12
51613,30,17,2020,824,306,518
51614,30,57,2020,3994,1593,2401
51615,30,86,2020,5,4,1
51616,30,177,2020,220,121,99
51617,30,18,2020,293,80,213
51618,30,167,2020,2308,1493,815
51619,30,121,2020,28,16,12
51620,30,19,2020,227,72,155
51621,30,168,2020,237,147,90
51622,30,46,2020,218,166,52
51623,30,20,2020,1026,290,736
51624,30,159,2020,6,2,4
51625,30,143,2020,294,124,170
51626,30,70,2020,1,1,0
51627,30,47,2020,158,114,44
51628,30,71,2020,109,53,56
51629,30,122,2020,1,0,1
51630,30,123,2020,2,0,2
51631,30,7,2020,0,0,0
51632,30,160,2020,3,2,1
51633,30,58,2020,165,74,91
51634,30,161,2020,2,0,2
51635,30,124,2020,5,4,1
51636,30,100,2020,97,48,49
51637,30,72,2020,12,6,6
51638,30,59,2020,41,18,23
51639,30,144,2020,156,67,89
51640,30,125,2020,38,16,22
51641,30,150,2020,8,4,4
51642,30,8,2020,16,5,11
51643,30,73,2020,1772,795,977
51644,30,101,2020,38,5,33
51645,30,162,2020,246,63,183
51646,30,60,2020,4614,1680,2934
51647,30,48,2020,545,262,283
51648,30,21,2020,9,0,9
51649,30,9,2020,290,108,182
51650,30,102,2020,7,2,5
51651,30,111,2020,3,1,2
51652,30,112,2020,33,15,18
51653,30,33,2020,1946,1263,683
51654,30,61,2020,569,284,285
51655,30,22,2020,58,18,40
51656,30,35,2020,3519,2074,1445
51657,30,36,2020,32789,22300,10489
51658,30,126,2020,1,1,0
51659,30,62,2020,4,4,0
51660,30,23,2020,139,42,97
51661,30,164,2020,14,4,10
51662,30,63,2020,3245,1489,1756
51663,30,127,2020,1,1,0
51664,30,165,2020,1,0,1
51665,30,37,2020,394,273,121
51666,30,64,2020,129,53,76
51667,30,128,2020,23,11,12
51668,30,115,2020,335,167,168
51669,30,65,2020,7450,3507,3943
51670,30,10,2020,20,6,14
51671,30,145,2020,48,8,40
51672,30,113,2020,2,0,2
51673,30,49,2020,514,250,264
51674,30,74,2020,600,268,332
51675,30,25,2020,17848,6872,10976
51676,30,169,2020,169,103,66
51677,30,166,2020,3,3,0
51678,30,93,2020,4,0,4
51679,30,146,2020,150,38,112
51680,30,26,2020,14454,4947,9507
51681,30,170,2020,317,201,116
51682,30,94,2020,1,0,1
51683,30,130,2020,9,3,6
51684,30,38,2020,11275,7419,3856
51685,30,27,2020,347,155,192
51686,30,50,2020,11981,5643,6338
51687,30,131,2020,13,1,12
51688,30,114,2020,17,5,12
51689,30,171,2020,925,610,315
51690,30,1,2020,709,278,431
51691,30,28,2020,93,27,66
51692,30,132,2020,13,6,7
51693,30,133,2020,41,18,23
51694,152,151,2020,4342,2135,2207
51695,152,156,2020,33487,21633,11854
51696,152,160,2020,37052,22275,14777
51697,152,162,2020,5373,2878,2495
51698,152,164,2020,4191,1911,2280
51699,152,166,2020,15999,10260,5739
51700,116,67,2020,718,375,343
51701,116,137,2020,199585,97828,101757
51702,116,68,2020,358,184,174
51703,116,121,2020,1226,533,693
51704,116,126,2020,76567,41839,34728
51705,116,130,2020,1058,439,619
51706,116,131,2020,33318,17783,15535
51707,153,134,2020,390,205,185
51708,153,103,2020,3,2,1
51709,153,67,2020,9,3,6
51710,153,105,2020,301,158,143
51711,153,172,2020,23,12,11
51712,153,81,2020,89,46,43
51713,153,68,2020,211,112,99
51714,153,139,2020,7,2,5
51715,153,155,2020,4,2,2
51716,153,69,2020,69,31,38
51717,153,156,2020,43,22,21
51718,153,157,2020,436,228,208
51719,153,57,2020,430,198,232
51720,153,177,2020,0,0,0
51721,153,71,2020,3,2,1
51722,153,160,2020,6,2,4
51723,153,100,2020,2,0,2
51724,153,125,2020,26,14,12
51725,153,73,2020,37,17,20
51726,153,162,2020,708,375,333
51727,153,112,2020,2,0,2
51728,153,61,2020,1225,639,586
51729,153,158,2020,5330,2386,2944
51730,153,36,2020,737,398,339
51731,153,140,2020,1809,1015,794
51732,153,164,2020,1562,740,822
51733,153,165,2020,14,7,7
51734,153,65,2020,150,78,72
51735,153,74,2020,12,6,6
51736,153,38,2020,22,9,13
51737,153,50,2020,53,26,27
51738,135,134,2020,2976,1663,1313
51739,135,136,2020,27852,13113,14739
51740,135,137,2020,3439,1878,1561
51741,135,137,2020,4750,2465,2285
51742,135,151,2020,2795,1337,1458
51743,135,138,2020,3911,2229,1682
51744,135,68,2020,5376,2740,2636
51745,135,139,2020,1228,659,569
51746,135,69,2020,340,182,158
51747,135,56,2020,220,80,140
51748,135,157,2020,5331,2991,2340
51749,135,57,2020,590,272,318
51750,135,159,2020,4956,2806,2150
51751,135,160,2020,9556,3126,6430
51752,135,73,2020,184,80,104
51753,135,162,2020,169602,93383,76219
51754,135,164,2020,3673,766,2907
51755,135,50,2020,295,133,162
51756,80,103,2020,12,8,4
51757,80,66,2020,55,10,45
51758,80,78,2020,205,97,108
51759,80,79,2020,203,71,132
51760,80,67,2020,12,5,7
51761,80,105,2020,78,40,38
51762,80,95,2020,392,174,218
51763,80,107,2020,467,246,221
51764,80,96,2020,144,41,103
51765,80,81,2020,844,435,409
51766,80,39,2020,19,6,13
51767,80,83,2020,72,14,58
51768,80,42,2020,10,5,5
51769,80,68,2020,41,14,27
51770,80,69,2020,151,48,103
51771,80,84,2020,17,6,11
51772,80,110,2020,373,151,222
51773,80,85,2020,19,6,13
51774,80,99,2020,2046,1285,761
51775,80,5,2020,648,147,501
51776,80,6,2020,10,3,7
51777,80,44,2020,257,136,121
51778,80,17,2020,12,10,2
51779,80,57,2020,101,11,90
51780,80,86,2020,11540,5732,5808
51781,80,177,2020,21,5,16
51782,80,121,2020,39,27,12
51783,80,100,2020,43,21,22
51784,80,73,2020,41,5,36
51785,80,101,2020,440,260,180
51786,80,162,2020,10,0,10
51787,80,9,2020,121,42,79
51788,80,102,2020,151,69,82
51789,80,112,2020,16,10,6
51790,80,88,2020,53,27,26
51791,80,91,2020,10,5,5
51792,80,92,2020,34,8,26
51793,80,115,2020,41,19,22
51794,80,133,2020,19,5,14
51795,80,65,2020,32,17,15
51796,80,74,2020,89,19,70
51797,80,93,2020,350,182,168
51798,80,50,2020,2394,1125,1269
51799,80,131,2020,16,13,3
51800,80,132,2020,10,3,7
51801,136,135,2020,35635,19708,15927
51802,136,137,2020,980,534,446
51803,136,137,2020,351,191,160
51804,136,68,2020,1216,663,553
51805,136,139,2020,401,218,183
51806,136,143,2020,1504,819,685
51807,136,162,2020,13033,7106,5927
51808,136,145,2020,372594,205024,167570
51809,106,103,2020,79253,39785,39468
51810,106,105,2020,18976,10572,8404
51811,106,172,2020,15921,6893,9028
51812,106,107,2020,173487,93545,79942
51813,106,81,2020,23929,10244,13685
51814,106,83,2020,36485,22079,14406
51815,106,108,2020,42266,21957,20309
51816,106,68,2020,9260,4538,4722
51817,106,69,2020,7559,4029,3530
51818,106,85,2020,236912,87312,149600
51819,106,57,2020,4670,1980,2690
51820,106,100,2020,10558,5645,4913
51821,106,111,2020,6045,3753,2292
51822,106,112,2020,240273,127564,112709
51823,106,65,2020,21798,9871,11927
51824,106,114,2020,5652,2551,3101
51825,172,3,2020,3115,1428,1687
51826,172,105,2020,57602,20552,37050
51827,172,10,2020,4214,2190,2024
51828,172,173,2020,209555,79101,130454
51829,172,5,2020,6953,2320,4633
51830,172,177,2020,5292,1668,3624
51831,172,174,2020,18918,8029,10889
51832,172,9,2020,3414,1124,2290
51833,172,112,2020,10455,3730,6725
51834,172,36,2020,2297,804,1493
51835,172,1,2020,303095,117113,185982
51836,172,50,2020,7061,2123,4938
51837,107,103,2020,5719,2269,3450
51838,107,105,2020,4685,2459,2226
51839,107,106,2020,4732,1980,2752
51840,107,172,2020,1584,633,951
51841,107,96,2020,1828,910,918
51842,107,81,2020,2534,943,1591
51843,107,83,2020,1046,469,577
51844,107,108,2020,19180,9388,9792
51845,107,97,2020,782,359,423
51846,107,68,2020,3180,1240,1940
51847,107,69,2020,2156,843,1313
51848,107,98,2020,857,376,481
51849,107,99,2020,690,371,319
51850,107,57,2020,3225,1095,2130
51851,107,177,2020,689,299,390
51852,107,100,2020,5641,2534,3107
51853,107,73,2020,635,208,427
51854,107,102,2020,3123,1519,1604
51855,107,112,2020,5680,2238,3442
51856,107,36,2020,646,411,235
51857,107,65,2020,17122,7361,9761
51858,107,74,2020,782,269,513
51859,107,50,2020,1686,625,1061
51860,107,114,2020,662,218,444
51861,117,68,2020,479,203,276
51862,117,121,2020,74,40,34
51863,117,122,2020,9605,5086,4519
51864,117,131,2020,143,72,71
51865,137,134,2020,40969,19763,21206
51866,137,135,2020,11225,4567,6658
51867,137,136,2020,10494,3634,6860
51868,137,172,2020,917,71,846
51869,137,137,2020,169268,83294,85974
51870,137,81,2020,531,367,164
51871,137,151,2020,15094,7179,7915
51872,137,138,2020,1570,719,851
51873,137,68,2020,10251,4671,5580
51874,137,139,2020,3141,1616,1525
51875,137,69,2020,574,308,266
51876,137,20,2020,1158,439,719
51877,137,160,2020,33696,11202,22494
51878,137,161,2020,3127,721,2406
51879,137,61,2020,1431,607,824
51880,137,36,2020,2558,1555,1003
51881,137,126,2020,24955,10860,14095
51882,137,164,2020,13178,3101,10077
51883,137,166,2020,2419,1308,1111
51884,137,134,2020,177028,88073,88955
51885,137,116,2020,59145,33249,25896
51886,137,137,2020,6242,5197,1045
51887,137,126,2020,251333,126071,125262
51888,137,129,2020,90971,49085,41886
51889,137,145,2020,5370,4789,581
51890,137,130,2020,5950,4947,1003
51891,96,2,2020,4,3,1
51892,96,51,2020,4,0,4
51893,96,141,2020,14,8,6
51894,96,134,2020,3,1,2
51895,96,12,2020,3,1,2
51896,96,103,2020,1761,869,892
51897,96,66,2020,152,40,112
51898,96,78,2020,14,3,11
51899,96,13,2020,1,0,1
51900,96,3,2020,3,0,3
51901,96,11,2020,8,3,5
51902,96,79,2020,13,4,9
51903,96,67,2020,350,136,214
51904,96,4,2020,4,1,3
51905,96,105,2020,652,315,337
51906,96,95,2020,167,63,104
51907,96,30,2020,85,44,41
51908,96,29,2020,6,3,3
51909,96,135,2020,11,5,6
51910,96,80,2020,9,1,8
51911,96,10,2020,1,0,1
51912,96,106,2020,2086,973,1113
51913,96,172,2020,348,123,225
51914,96,107,2020,25530,12373,13157
51915,96,137,2020,9,3,6
51916,96,137,2020,3,3,0
51917,96,54,2020,28,13,15
51918,96,81,2020,6908,3125,3783
51919,96,14,2020,3,0,3
51920,96,151,2020,1,1,0
51921,96,39,2020,75,31,44
51922,96,82,2020,6,5,1
51923,96,83,2020,1317,834,483
51924,96,108,2020,1526,662,864
51925,96,97,2020,16682,8826,7856
51926,96,120,2020,1,0,1
51927,96,40,2020,3,3,0
51928,96,42,2020,26,17,9
51929,96,68,2020,1046,443,603
51930,96,109,2020,14,8,6
51931,96,139,2020,1,1,0
51932,96,15,2020,14,8,6
51933,96,69,2020,2238,906,1332
51934,96,156,2020,1,0,1
51935,96,55,2020,4,4,0
51936,96,56,2020,39,13,26
51937,96,84,2020,9,3,6
51938,96,98,2020,3192,1486,1706
51939,96,110,2020,33,14,19
51940,96,85,2020,85,33,52
51941,96,99,2020,4708,2563,2145
51942,96,173,2020,3943,1758,2185
51943,96,32,2020,89,38,51
51944,96,43,2020,1,1,0
51945,96,5,2020,64,23,41
51946,96,6,2020,119,21,98
51947,96,16,2020,18,5,13
51948,96,44,2020,35,17,18
51949,96,17,2020,203,69,134
51950,96,57,2020,2558,930,1628
51951,96,86,2020,260,142,118
51952,96,177,2020,338,136,202
51953,96,167,2020,6,5,1
51954,96,18,2020,13,3,10
51955,96,121,2020,9,0,9
51956,96,176,2020,42,21,21
51957,96,20,2020,105,33,72
51958,96,46,2020,1,1,0
51959,96,143,2020,13,5,8
51960,96,70,2020,4,1,3
51961,96,47,2020,11,4,7
51962,96,71,2020,18,13,5
51963,96,174,2020,1,0,1
51964,96,122,2020,3,3,0
51965,96,7,2020,1,1,0
51966,96,100,2020,3720,1911,1809
51967,96,72,2020,1,0,1
51968,96,87,2020,4,3,1
51969,96,144,2020,4,3,1
51970,96,125,2020,4,3,1
51971,96,21,2020,3,0,3
51972,96,8,2020,9,1,8
51973,96,73,2020,702,269,433
51974,96,77,2020,38,13,25
51975,96,101,2020,350854,176779,174075
51976,96,162,2020,3,3,0
51977,96,48,2020,91,33,58
51978,96,9,2020,11,0,11
51979,96,102,2020,13711,6381,7330
51980,96,111,2020,99,65,34
51981,96,112,2020,4540,2100,2440
51982,96,33,2020,361,195,166
51983,96,61,2020,94,37,57
51984,96,88,2020,426,159,267
51985,96,22,2020,3,1,2
51986,96,35,2020,118,58,60
51987,96,36,2020,718,449,269
51988,96,126,2020,1,1,0
51989,96,90,2020,1,1,0
51990,96,91,2020,1,1,0
51991,96,92,2020,1,0,1
51992,96,23,2020,16,4,12
51993,96,164,2020,1,1,0
51994,96,37,2020,26,9,17
51995,96,1,2020,1,0,1
51996,96,128,2020,1,1,0
51997,96,115,2020,67,37,30
51998,96,133,2020,1,0,1
51999,96,65,2020,2595,1089,1506
52000,96,145,2020,1,0,1
52001,96,113,2020,23,10,13
52002,96,148,2020,1,0,1
52003,96,49,2020,164,69,95
52004,96,74,2020,805,339,466
52005,96,25,2020,13,1,12
52006,96,93,2020,40,27,13
52007,96,146,2020,4,3,1
52008,96,26,2020,9,4,5
52009,96,130,2020,11,3,8
52010,96,38,2020,186,114,72
52011,96,60,2020,31,14,17
52012,96,142,2020,13,1,12
52013,96,50,2020,622,245,377
52014,96,131,2020,4,3,1
52015,96,114,2020,374,172,202
52016,96,171,2020,1,1,0
52017,54,51,2020,160,90,70
52018,54,141,2020,50,26,24
52019,54,103,2020,186,115,71
52020,54,66,2020,4843,2394,2449
52021,54,29,2020,87,72,15
52022,54,67,2020,351,187,164
52023,54,53,2020,381100,201047,180053
52024,54,105,2020,180,117,63
52025,54,30,2020,285,194,91
52026,54,106,2020,117,71,46
52027,54,172,2020,417,212,205
52028,54,107,2020,41,26,15
52029,54,31,2020,891,654,237
52030,54,39,2020,95,47,48
52031,54,142,2020,232,125,107
52032,54,40,2020,17,12,5
52033,54,42,2020,36,23,13
52034,54,68,2020,1655,862,793
52035,54,69,2020,31783,15844,15939
52036,54,56,2020,136,70,66
52037,54,32,2020,981,670,311
52038,54,5,2020,61,24,37
52039,54,6,2020,44,19,25
52040,54,16,2020,75,16,59
52041,54,44,2020,48,25,23
52042,54,17,2020,49,16,33
52043,54,57,2020,2953,1442,1511
52044,54,177,2020,50,39,11
52045,54,18,2020,62,7,55
52046,54,167,2020,61,50,11
52047,54,46,2020,23,22,1
52048,54,20,2020,60,13,47
52049,54,143,2020,139,67,72
52050,54,47,2020,23,19,4
52051,54,71,2020,27,17,10
52052,54,100,2020,36,21,15
52053,54,59,2020,5815,3095,2720
52054,54,144,2020,25,16,9
52055,54,73,2020,759,403,356
52056,54,162,2020,25,11,14
52057,54,60,2020,9462,4831,4631
52058,54,48,2020,104,51,53
52059,54,112,2020,79,49,30
52060,54,33,2020,691,551,140
52061,54,61,2020,46,21,25
52062,54,35,2020,468,310,158
52063,54,36,2020,1231,1002,229
52064,54,63,2020,48170,28013,20157
52065,54,37,2020,603,467,136
52066,54,64,2020,18432,11684,6748
52067,54,115,2020,189,100,89
52068,54,65,2020,175,100,75
52069,54,145,2020,60,15,45
52070,54,49,2020,588,311,277
52071,54,74,2020,2830,1396,1434
52072,54,25,2020,167,21,146
52073,54,26,2020,79,31,48
52074,54,38,2020,711,557,154
52075,54,50,2020,628,291,337
52076,54,132,2020,42,17,25
52077,81,51,2020,0,0,0
52078,81,141,2020,8,5,3
52079,81,134,2020,30,19,11
52080,81,103,2020,35,23,12
52081,81,30,2020,13,10,3
52082,81,106,2020,67,29,38
52083,81,172,2020,42,15,27
52084,81,107,2020,42,23,19
52085,81,31,2020,24,17,7
52086,81,83,2020,14,11,3
52087,81,108,2020,47,28,19
52088,81,68,2020,69,34,35
52089,81,69,2020,106,58,48
52090,81,84,2020,0,0,0
52091,81,98,2020,18,10,8
52092,81,85,2020,54,25,29
52093,81,32,2020,9,5,4
52094,81,57,2020,371,144,227
52095,81,86,2020,38,22,16
52096,81,20,2020,9,3,6
52097,81,100,2020,106,59,47
52098,81,101,2020,71,46,25
52099,81,102,2020,11,8,3
52100,81,112,2020,39,23,16
52101,81,33,2020,11,9,2
52102,81,88,2020,10,7,3
52103,81,35,2020,60,43,17
52104,81,36,2020,343,250,93
52105,81,65,2020,505,280,225
52106,81,38,2020,131,98,33
52107,81,50,2020,31,17,14
52108,14,2,2020,6,0,6
52109,14,51,2020,274,115,159
52110,14,141,2020,34,16,18
52111,14,103,2020,81,35,46
52112,14,11,2020,1166,552,614
52113,14,66,2020,349,202,147
52114,14,12,2020,34,20,14
52115,14,13,2020,104,47,57
52116,14,3,2020,1526,24,1502
52117,14,29,2020,336,262,74
52118,14,67,2020,256,136,120
52119,14,151,2020,6,0,6
52120,14,53,2020,65,35,30
52121,14,147,2020,6,1,5
52122,14,105,2020,55,35,20
52123,14,30,2020,6121,4292,1829
52124,14,116,2020,1,0,1
52125,14,135,2020,1885,841,1044
52126,14,106,2020,46,28,18
52127,14,172,2020,1591,807,784
52128,14,107,2020,123,91,32
52129,14,96,2020,1,1,0
52130,14,54,2020,81,47,34
52131,14,81,2020,34,16,18
52132,14,31,2020,669,440,229
52133,14,176,2020,31,20,11
52134,14,137,2020,678,370,308
52135,14,39,2020,164,93,71
52136,14,118,2020,1,1,0
52137,14,83,2020,8,6,2
52138,14,108,2020,6,1,5
52139,14,142,2020,5156,2149,3007
52140,14,97,2020,8,1,7
52141,14,119,2020,1,1,0
52142,14,40,2020,26,20,6
52143,14,120,2020,78,47,31
52144,14,42,2020,489,365,124
52145,14,68,2020,908,543,365
52146,14,15,2020,15201,7167,8034
52147,14,69,2020,2582,1468,1114
52148,14,156,2020,81,39,42
52149,14,55,2020,1,0,1
52150,14,56,2020,23581,10366,13215
52151,14,85,2020,1,1,0
52152,14,99,2020,1,0,1
52153,14,32,2020,342,207,135
52154,14,43,2020,31,25,6
52155,14,5,2020,2732,1124,1608
52156,14,6,2020,1194,456,738
52157,14,16,2020,1274,575,699
52158,14,44,2020,770,513,257
52159,14,17,2020,379,171,208
52160,14,57,2020,477,245,232
52161,14,86,2020,13,6,7
52162,14,177,2020,81,47,34
52163,14,18,2020,437,162,275
52164,14,167,2020,232,144,88
52165,14,121,2020,81,39,42
52166,14,19,2020,229,97,132
52167,14,168,2020,22,11,11
52168,14,46,2020,161,115,46
52169,14,20,2020,2736,1242,1494
52170,14,143,2020,224,93,131
52171,14,47,2020,91,73,18
52172,14,71,2020,8,6,2
52173,14,122,2020,6,1,5
52174,14,123,2020,6,1,5
52175,14,58,2020,31,11,20
52176,14,124,2020,8,1,7
52177,14,100,2020,60,39,21
52178,14,144,2020,60,28,32
52179,14,125,2020,8,6,2
52180,14,150,2020,1,0,1
52181,14,8,2020,54,6,48
52182,14,73,2020,477,282,195
52183,14,101,2020,8,1,7
52184,14,162,2020,299,132,167
52185,14,60,2020,18,11,7
52186,14,48,2020,196,127,69
52187,14,21,2020,60,25,35
52188,14,9,2020,1374,89,1285
52189,14,102,2020,18,1,17
52190,14,111,2020,6,6,0
52191,14,112,2020,31,20,11
52192,14,33,2020,701,529,172
52193,14,61,2020,60,44,16
52194,14,88,2020,1,0,1
52195,14,22,2020,8,1,7
52196,14,35,2020,5377,3841,1536
52197,14,36,2020,12935,7620,5315
52198,14,23,2020,229,104,125
52199,14,164,2020,6,1,5
52200,14,63,2020,2518,1362,1156
52201,14,127,2020,6,1,5
52202,14,165,2020,1,0,1
52203,14,37,2020,135,83,52
52204,14,64,2020,13,6,7
52205,14,128,2020,8,1,7
52206,14,115,2020,4937,2707,2230
52207,14,65,2020,153,110,43
52208,14,10,2020,9821,7915,1906
52209,14,145,2020,514,262,252
52210,14,113,2020,1,1,0
52211,14,49,2020,905,596,309
52212,14,74,2020,373,243,130
52213,14,25,2020,11446,5225,6221
52214,14,169,2020,6,1,5
52215,14,93,2020,13,11,2
52216,14,146,2020,34,11,23
52217,14,26,2020,605,320,285
52218,14,170,2020,8,6,2
52219,14,130,2020,18,1,17
52220,14,38,2020,3257,2199,1058
52221,14,27,2020,149,59,90
52222,14,50,2020,35876,19575,16301
52223,14,131,2020,142,73,69
52224,14,114,2020,1,1,0
52225,14,171,2020,70,39,31
52226,14,1,2020,60,52,8
52227,14,28,2020,13,6,7
52228,14,132,2020,135,88,47
52229,14,133,2020,299,176,123
52230,31,2,2020,484,151,333
52231,31,51,2020,487,188,299
52232,31,141,2020,805,130,675
52233,31,52,2020,0,0,0
52234,31,134,2020,161,23,138
52235,31,76,2020,0,0,0
52236,31,103,2020,366,132,234
52237,31,11,2020,2096,945,1151
52238,31,77,2020,0,0,0
52239,31,66,2020,3002,471,2531
52240,31,12,2020,1596,624,972
52241,31,78,2020,1,1,0
52242,31,13,2020,25,6,19
52243,31,3,2020,718,52,666
52244,31,79,2020,1,0,1
52245,31,29,2020,5864,3013,2851
52246,31,67,2020,819,198,621
52247,31,95,2020,1,0,1
52248,31,151,2020,39,12,27
52249,31,4,2020,3,2,1
52250,31,53,2020,3178,939,2239
52251,31,147,2020,30,16,14
52252,31,105,2020,1150,478,672
52253,31,30,2020,15166,5529,9637
52254,31,152,2020,17,5,12
52255,31,116,2020,5,1,4
52256,31,153,2020,17,7,10
52257,31,135,2020,131,29,102
52258,31,80,2020,0,0,0
52259,31,136,2020,4,1,3
52260,31,106,2020,244,99,145
52261,31,172,2020,6620,3104,3516
52262,31,173,2020,0,0,0
52263,31,107,2020,424,194,230
52264,31,117,2020,0,0,0
52265,31,137,2020,60,18,42
52266,31,96,2020,158,70,88
52267,31,54,2020,1898,621,1277
52268,31,81,2020,489,176,313
52269,31,14,2020,137,33,104
52270,31,176,2020,3,3,0
52271,31,137,2020,91,32,59
52272,31,39,2020,423,111,312
52273,31,118,2020,1,1,0
52274,31,82,2020,2,0,2
52275,31,83,2020,93,42,51
52276,31,108,2020,116,48,68
52277,31,142,2020,1145,169,976
52278,31,97,2020,45,21,24
52279,31,138,2020,0,0,0
52280,31,119,2020,8,4,4
52281,31,40,2020,256,143,113
52282,31,148,2020,0,0,0
52283,31,120,2020,122,44,78
52284,31,42,2020,412,166,246
52285,31,68,2020,3817,1091,2726
52286,31,139,2020,10,5,5
52287,31,155,2020,13,0,13
52288,31,15,2020,1453,550,903
52289,31,69,2020,17983,3341,14642
52290,31,156,2020,426,84,342
52291,31,55,2020,2,2,0
52292,31,56,2020,1248,349,899
52293,31,84,2020,0,0,0
52294,31,98,2020,51,22,29
52295,31,157,2020,79,18,61
52296,31,158,2020,22,3,19
52297,31,110,2020,5,0,5
52298,31,85,2020,10,4,6
52299,31,99,2020,40,22,18
52300,31,32,2020,1695,676,1019
52301,31,43,2020,43,11,32
52302,31,5,2020,4315,1148,3167
52303,31,6,2020,896,386,510
52304,31,16,2020,657,204,453
52305,31,44,2020,689,153,536
52306,31,17,2020,796,266,530
52307,31,57,2020,4893,776,4117
52308,31,86,2020,25,7,18
52309,31,177,2020,1764,896,868
52310,31,18,2020,223,53,170
52311,31,167,2020,8015,3934,4081
52312,31,121,2020,137,52,85
52313,31,19,2020,128,38,90
52314,31,168,2020,1262,534,728
52315,31,46,2020,679,349,330
52316,31,20,2020,433,103,330
52317,31,149,2020,0,0,0
52318,31,159,2020,12,4,8
52319,31,143,2020,205,56,149
52320,31,70,2020,0,0,0
52321,31,47,2020,748,395,353
52322,31,71,2020,26,6,20
52323,31,122,2020,27,9,18
52324,31,123,2020,7,1,6
52325,31,7,2020,5,0,5
52326,31,160,2020,28,8,20
52327,31,58,2020,32,8,24
52328,31,161,2020,5,0,5
52329,31,124,2020,54,18,36
52330,31,100,2020,888,358,530
52331,31,72,2020,6,2,4
52332,31,59,2020,148,66,82
52333,31,144,2020,449,92,357
52334,31,125,2020,20,3,17
52335,31,150,2020,36,20,16
52336,31,8,2020,1286,231,1055
52337,31,73,2020,3045,873,2172
52338,31,101,2020,22,10,12
52339,31,162,2020,771,136,635
52340,31,60,2020,2572,681,1891
52341,31,48,2020,238,65,173
52342,31,21,2020,34,2,32
52343,31,9,2020,662,161,501
52344,31,102,2020,47,11,36
52345,31,111,2020,23,6,17
52346,31,112,2020,319,118,201
52347,31,33,2020,21694,10389,11305
52348,31,61,2020,507,153,354
52349,31,22,2020,7,5,2
52350,31,35,2020,9659,2812,6847
52351,31,36,2020,37471,20965,16506
52352,31,126,2020,19,7,12
52353,31,90,2020,0,0,0
52354,31,91,2020,4,2,2
52355,31,92,2020,0,0,0
52356,31,62,2020,0,0,0
52357,31,140,2020,0,0,0
52358,31,23,2020,299,84,215
52359,31,164,2020,76,7,69
52360,31,63,2020,3665,1104,2561
52361,31,127,2020,5,3,2
52362,31,165,2020,23,1,22
52363,31,37,2020,113773,51859,61914
52364,31,64,2020,478,172,306
52365,31,128,2020,17,7,10
52366,31,115,2020,554,226,328
52367,31,65,2020,1524,440,1084
52368,31,10,2020,209,50,159
52369,31,145,2020,63,16,47
52370,31,113,2020,13,4,9
52371,31,49,2020,576,153,423
52372,31,74,2020,684,209,475
52373,31,25,2020,1358,460,898
52374,31,169,2020,348,143,205
52375,31,166,2020,20,4,16
52376,31,93,2020,13,6,7
52377,31,146,2020,1135,109,1026
52378,31,26,2020,3077,820,2257
52379,31,170,2020,189,107,82
52380,31,130,2020,47,23,24
52381,31,38,2020,131316,58170,73146
52382,31,27,2020,211,80,131
52383,31,50,2020,6410,1309,5101
52384,31,131,2020,30,12,18
52385,31,114,2020,45,19,26
52386,31,171,2020,2777,923,1854
52387,31,1,2020,50350,22109,28241
52388,31,28,2020,190,75,115
52389,31,132,2020,73,20,53
52390,31,133,2020,116,44,72
52391,39,2,2020,13715,6119,7596
52392,39,51,2020,568,294,274
52393,39,141,2020,1004,410,594
52394,39,52,2020,5,3,2
52395,39,134,2020,169,90,79
52396,39,76,2020,3,3,0
52397,39,103,2020,2361,1148,1213
52398,39,11,2020,733,408,325
52399,39,77,2020,0,0,0
52400,39,66,2020,1984,1035,949
52401,39,12,2020,394,225,169
52402,39,78,2020,20,13,7
52403,39,13,2020,109,51,58
52404,39,3,2020,1919,845,1074
52405,39,79,2020,49,16,33
52406,39,29,2020,820,570,250
52407,39,67,2020,2426,1140,1286
52408,39,95,2020,6,5,1
52409,39,151,2020,52,23,29
52410,39,4,2020,632,306,326
52411,39,53,2020,17182,8654,8528
52412,39,147,2020,67,44,23
52413,39,105,2020,4605,2981,1624
52414,39,30,2020,10026,4279,5747
52415,39,152,2020,131,57,74
52416,39,116,2020,539,304,235
52417,39,153,2020,35,19,16
52418,39,135,2020,846,373,473
52419,39,136,2020,25,14,11
52420,39,106,2020,2078,1032,1046
52421,39,172,2020,14576,9088,5488
52422,39,173,2020,0,0,0
52423,39,174,2020,0,0,0
52424,39,107,2020,3660,1756,1904
52425,39,117,2020,13,9,4
52426,39,137,2020,419,221,198
52427,39,96,2020,196,90,106
52428,39,54,2020,2244,1045,1199
52429,39,81,2020,568,317,251
52430,39,14,2020,280,150,130
52431,39,31,2020,1986,1036,950
52432,39,176,2020,406,223,183
52433,39,137,2020,1732,871,861
52434,39,118,2020,18,11,7
52435,39,82,2020,15,10,5
52436,39,83,2020,208,129,79
52437,39,108,2020,650,360,290
52438,39,142,2020,1944,646,1298
52439,39,97,2020,104,60,44
52440,39,138,2020,8,6,2
52441,39,119,2020,5599,2154,3445
52442,39,40,2020,1485,1031,454
52443,39,148,2020,51,18,33
52444,39,120,2020,2296,1021,1275
52445,39,41,2020,11057,6502,4555
52446,39,42,2020,4104,2826,1278
52447,39,68,2020,8182,3784,4398
52448,39,109,2020,0,0,0
52449,39,139,2020,10,6,4
52450,39,155,2020,684,306,378
52451,39,15,2020,251,153,98
52452,39,69,2020,37111,19074,18037
52453,39,156,2020,2263,972,1291
52454,39,56,2020,3702,1489,2213
52455,39,84,2020,13,7,6
52456,39,98,2020,254,126,128
52457,39,157,2020,122,51,71
52458,39,158,2020,111,33,78
52459,39,110,2020,100,67,33
52460,39,85,2020,162,69,93
52461,39,99,2020,155,91,64
52462,39,32,2020,5668,2909,2759
52463,39,43,2020,8479,4551,3928
52464,39,5,2020,14638,7098,7540
52465,39,6,2020,17125,7326,9799
52466,39,16,2020,22040,9977,12063
52467,39,44,2020,2209,748,1461
52468,39,17,2020,1753,678,1075
52469,39,57,2020,9887,3678,6209
52470,39,86,2020,168,92,76
52471,39,177,2020,2149,1426,723
52472,39,18,2020,1324,586,738
52473,39,167,2020,272,193,79
52474,39,121,2020,1900,1147,753
52475,39,19,2020,1449,614,835
52476,39,168,2020,64,48,16
52477,39,46,2020,5301,2839,2462
52478,39,20,2020,13092,6041,7051
52479,39,149,2020,47,30,17
52480,39,159,2020,163,91,72
52481,39,143,2020,309,124,185
52482,39,70,2020,24,15,9
52483,39,47,2020,13429,6392,7037
52484,39,71,2020,599,294,305
52485,39,122,2020,76,44,32
52486,39,123,2020,89,46,43
52487,39,7,2020,8,8,0
52488,39,160,2020,53,21,32
52489,39,58,2020,136,65,71
52490,39,161,2020,30,16,14
52491,39,124,2020,157,87,70
52492,39,100,2020,1576,871,705
52493,39,72,2020,20,9,11
52494,39,59,2020,313,165,148
52495,39,144,2020,5885,2959,2926
52496,39,125,2020,240,150,90
52497,39,150,2020,90,60,30
52498,39,8,2020,4496,2108,2388
52499,39,73,2020,8085,3502,4583
52500,39,101,2020,222,134,88
52501,39,162,2020,1637,674,963
52502,39,60,2020,3740,1706,2034
52503,39,48,2020,20581,12561,8020
52504,39,21,2020,33,17,16
52505,39,9,2020,14318,6815,7503
52506,39,102,2020,101,58,43
52507,39,111,2020,95,58,37
52508,39,112,2020,1223,800,423
52509,39,33,2020,42528,19756,22772
52510,39,61,2020,2900,1257,1643
52511,39,88,2020,0,0,0
52512,39,22,2020,169,95,74
52513,39,35,2020,28985,12344,16641
52514,39,36,2020,6499,4498,2001
52515,39,126,2020,426,227,199
52516,39,90,2020,2,0,2
52517,39,91,2020,12,5,7
52518,39,92,2020,4,2,2
52519,39,62,2020,0,0,0
52520,39,140,2020,2,2,0
52521,39,23,2020,448,215,233
52522,39,164,2020,192,84,108
52523,39,63,2020,3674,1791,1883
52524,39,127,2020,20,15,5
52525,39,165,2020,341,174,167
52526,39,37,2020,2896,1398,1498
52527,39,64,2020,468,237,231
52528,39,128,2020,11361,5456,5905
52529,39,115,2020,2332,1096,1236
52530,39,129,2020,16,11,5
52531,39,65,2020,7934,3792,4142
52532,39,10,2020,8054,4095,3959
52533,39,145,2020,830,347,483
52534,39,113,2020,32,15,17
52535,39,49,2020,24246,13557,10689
52536,39,74,2020,2916,1423,1493
52537,39,25,2020,36184,16006,20178
52538,39,169,2020,37,26,11
52539,39,166,2020,150,56,94
52540,39,93,2020,176,99,77
52541,39,146,2020,975,323,652
52542,39,26,2020,33385,16024,17361
52543,39,170,2020,19,17,2
52544,39,130,2020,1713,1036,677
52545,39,38,2020,11400,5838,5562
52546,39,27,2020,647,292,355
52547,39,50,2020,21428,8281,13147
52548,39,131,2020,1078,632,446
52549,39,114,2020,231,116,115
52550,39,171,2020,314,175,139
52551,39,1,2020,10384,5788,4596
52552,39,28,2020,171,94,77
52553,39,132,2020,675,439,236
52554,39,133,2020,445,232,213
52555,118,120,2020,12578,7016,5562
52556,118,128,2020,94976,44100,50876
52557,118,28,2020,5322,2727,2595
52558,82,76,2020,451,233,218
52559,82,78,2020,11,6,5
52560,82,79,2020,169,76,93
52561,82,172,2020,37,12,25
52562,82,81,2020,11,8,3
52563,82,68,2020,80,26,54
52564,82,109,2020,22,16,6
52565,82,69,2020,29,16,13
52566,82,110,2020,193,85,108
52567,82,85,2020,2537,1285,1252
52568,82,5,2020,27,11,16
52569,82,86,2020,130,85,45
52570,82,20,2020,33,6,27
52571,82,87,2020,164,76,88
52572,82,73,2020,9,4,5
52573,82,77,2020,46,29,17
52574,82,162,2020,50,29,21
52575,82,88,2020,15,0,15
52576,82,90,2020,63,36,27
52577,82,75,2020,18,4,14
52578,82,91,2020,286,140,146
52579,82,92,2020,126,55,71
52580,82,113,2020,18,6,12
52581,82,25,2020,15,4,11
52582,82,93,2020,312,124,188
52583,82,50,2020,647,310,337
52584,83,76,2020,186,87,99
52585,83,103,2020,1116,491,625
52586,83,66,2020,214,76,138
52587,83,78,2020,40,9,31
52588,83,13,2020,21,3,18
52589,83,67,2020,266,102,164
52590,83,4,2020,8,0,8
52591,83,53,2020,5,0,5
52592,83,105,2020,671,338,333
52593,83,30,2020,76,31,45
52594,83,116,2020,3,3,0
52595,83,135,2020,23,11,12
52596,83,153,2020,3,3,0
52597,83,136,2020,3,0,3
52598,83,106,2020,661,292,369
52599,83,172,2020,3942,1388,2554
52600,83,107,2020,2962,1455,1507
52601,83,96,2020,320,149,171
52602,83,81,2020,3402,1418,1984
52603,83,31,2020,29,13,16
52604,83,39,2020,25,9,16
52605,83,82,2020,14,8,6
52606,83,108,2020,605,295,310
52607,83,97,2020,278,146,132
52608,83,42,2020,27,16,11
52609,83,68,2020,3894,1160,2734
52610,83,69,2020,1938,717,1221
52611,83,56,2020,65,17,48
52612,83,98,2020,446,205,241
52613,83,110,2020,23,6,17
52614,83,85,2020,496112,172316,323796
52615,83,99,2020,442,229,213
52616,83,32,2020,21,6,15
52617,83,5,2020,97,25,72
52618,83,6,2020,31,6,25
52619,83,16,2020,27,8,19
52620,83,44,2020,33,13,20
52621,83,17,2020,63,17,46
52622,83,57,2020,4375,1120,3255
52623,83,86,2020,137,37,100
52624,83,177,2020,359,177,182
52625,83,167,2020,10,5,5
52626,83,20,2020,154,50,104
52627,83,58,2020,25,11,14
52628,83,100,2020,1563,748,815
52629,83,144,2020,34,8,26
52630,83,73,2020,617,217,400
52631,83,77,2020,167,64,103
52632,83,101,2020,303,172,131
52633,83,162,2020,25,5,20
52634,83,48,2020,56,23,33
52635,83,9,2020,81,20,61
52636,83,102,2020,789,379,410
52637,83,111,2020,25,11,14
52638,83,112,2020,1489,583,906
52639,83,33,2020,45,14,31
52640,83,61,2020,110,43,67
52641,83,88,2020,4780,2118,2662
52642,83,35,2020,44,25,19
52643,83,36,2020,503,296,207
52644,83,90,2020,142,55,87
52645,83,75,2020,34,13,21
52646,83,23,2020,17,3,14
52647,83,63,2020,75,41,34
52648,83,115,2020,10,7,3
52649,83,65,2020,7272,2738,4534
52650,83,113,2020,27,10,17
52651,83,49,2020,76,31,45
52652,83,74,2020,1088,369,719
52653,83,25,2020,25,9,16
52654,83,93,2020,23,9,14
52655,83,26,2020,31,9,22
52656,83,94,2020,35,20,15
52657,83,38,2020,77,51,26
52658,83,60,2020,26,10,16
52659,83,50,2020,503,235,268
52660,83,114,2020,189,91,98
52661,108,2,2020,167,71,96
52662,108,51,2020,73,30,43
52663,108,141,2020,50,10,40
52664,108,134,2020,43,23,20
52665,108,103,2020,5645,2085,3560
52666,108,66,2020,571,222,349
52667,108,78,2020,50,18,32
52668,108,11,2020,38,17,21
52669,108,67,2020,893,392,501
52670,108,105,2020,2774,1336,1438
52671,108,30,2020,201,98,103
52672,108,135,2020,46,12,34
52673,108,106,2020,11859,4812,7047
52674,108,172,2020,3061,1105,1956
52675,108,107,2020,203470,89785,113685
52676,108,96,2020,1027,471,556
52677,108,54,2020,84,24,60
52678,108,81,2020,3130,1252,1878
52679,108,31,2020,329,79,250
52680,108,39,2020,191,52,139
52681,108,83,2020,369,184,185
52682,108,97,2020,544,255,289
52683,108,42,2020,131,73,58
52684,108,68,2020,2366,1046,1320
52685,108,155,2020,34,4,30
52686,108,69,2020,4606,2069,2537
52687,108,156,2020,38,10,28
52688,108,56,2020,73,12,61
52689,108,98,2020,449,207,242
52690,108,85,2020,100,24,76
52691,108,99,2020,489,241,248
52692,108,173,2020,101,37,64
52693,108,32,2020,225,122,103
52694,108,5,2020,238,68,170
52695,108,6,2020,200,51,149
52696,108,16,2020,72,30,42
52697,108,44,2020,207,77,130
52698,108,17,2020,542,185,357
52699,108,57,2020,4020,1466,2554
52700,108,86,2020,38,18,20
52701,108,177,2020,766,289,477
52702,108,18,2020,73,12,61
52703,108,176,2020,507,204,303
52704,108,20,2020,463,146,317
52705,108,100,2020,2361,1140,1221
52706,108,144,2020,50,17,33
52707,108,73,2020,867,342,525
52708,108,101,2020,408,179,229
52709,108,162,2020,38,16,22
52710,108,48,2020,245,112,133
52711,108,9,2020,38,16,22
52712,108,102,2020,1008,438,570
52713,108,111,2020,252,105,147
52714,108,112,2020,14331,5245,9086
52715,108,33,2020,326,146,180
52716,108,61,2020,382,126,256
52717,108,88,2020,523,227,296
52718,108,35,2020,315,156,159
52719,108,36,2020,1562,892,670
52720,108,23,2020,91,30,61
52721,108,37,2020,51,23,28
52722,108,1,2020,50,18,32
52723,108,115,2020,127,32,95
52724,108,65,2020,7814,3435,4379
52725,108,49,2020,365,152,213
52726,108,74,2020,2051,622,1429
52727,108,25,2020,164,69,95
52728,108,93,2020,46,23,23
52729,108,38,2020,418,211,207
52730,108,60,2020,15,6,9
52731,108,142,2020,87,23,64
52732,108,50,2020,2255,949,1306
52733,108,114,2020,1002,333,669
52734,142,2,2020,210,46,164
52735,142,51,2020,119,44,75
52736,142,141,2020,889,571,318
52737,142,134,2020,28,12,16
52738,142,76,2020,15,7,8
52739,142,12,2020,31,0,31
52740,142,103,2020,251,96,155
52741,142,66,2020,607,330,277
52742,142,78,2020,14,11,3
52743,142,13,2020,404,201,203
52744,142,3,2020,255,28,227
52745,142,11,2020,160,96,64
52746,142,67,2020,564,278,286
52747,142,53,2020,61,28,33
52748,142,105,2020,130,74,56
52749,142,30,2020,68,38,30
52750,142,116,2020,35,1,34
52751,142,29,2020,279,158,121
52752,142,135,2020,126,19,107
52753,142,10,2020,222,95,127
52754,142,136,2020,334,118,216
52755,142,106,2020,27,11,16
52756,142,172,2020,771,243,528
52757,142,107,2020,57,12,45
52758,142,117,2020,913,160,753
52759,142,137,2020,72,22,50
52760,142,137,2020,130,44,86
52761,142,54,2020,102,22,80
52762,142,14,2020,86,38,48
52763,142,31,2020,201,112,89
52764,142,151,2020,35,0,35
52765,142,39,2020,302,145,157
52766,142,108,2020,11,7,4
52767,142,97,2020,212,116,96
52768,142,120,2020,16256,9189,7067
52769,142,119,2020,18232,10308,7924
52770,142,40,2020,25,11,14
52771,142,42,2020,249,142,107
52772,142,68,2020,2874,1323,1551
52773,142,118,2020,371,143,228
52774,142,155,2020,28,7,21
52775,142,69,2020,7771,3528,4243
52776,142,156,2020,234,55,179
52777,142,55,2020,8,1,7
52778,142,56,2020,1284,725,559
52779,142,98,2020,8,3,5
52780,142,157,2020,143,11,132
52781,142,32,2020,133,76,57
52782,142,5,2020,1249,445,804
52783,142,6,2020,150,60,90
52784,142,16,2020,20042,11221,8821
52785,142,44,2020,95,55,40
52786,142,17,2020,710,278,432
52787,142,57,2020,4206,1954,2252
52788,142,177,2020,1158,542,616
52789,142,167,2020,212,95,117
52790,142,18,2020,5277,2360,2917
52791,142,121,2020,137,43,94
52792,142,176,2020,102,40,62
52793,142,19,2020,3008,1090,1918
52794,142,168,2020,61,12,49
52795,142,20,2020,3197,1766,1431
52796,142,159,2020,47,19,28
52797,142,143,2020,5047,2207,2840
52798,142,122,2020,39,1,38
52799,142,123,2020,28,3,25
52800,142,7,2020,28,7,21
52801,142,160,2020,216,46,170
52802,142,161,2020,154,40,114
52803,142,100,2020,64,40,24
52804,142,72,2020,82,40,42
52805,142,144,2020,1066,790,276
52806,142,125,2020,15,6,9
52807,142,21,2020,544,183,361
52808,142,150,2020,268,171,97
52809,142,73,2020,997,502,495
52810,142,162,2020,814,218,596
52811,142,48,2020,120,53,67
52812,142,9,2020,619,211,408
52813,142,33,2020,380,190,190
52814,142,61,2020,44,23,21
52815,142,158,2020,93,0,93
52816,142,22,2020,401,152,249
52817,142,35,2020,243,136,107
52818,142,36,2020,7536,4606,2930
52819,142,126,2020,44,7,37
52820,142,23,2020,8238,2965,5273
52821,142,164,2020,425,79,346
52822,142,127,2020,19,6,13
52823,142,165,2020,61,31,30
52824,142,37,2020,61,35,26
52825,142,128,2020,20501,8505,11996
52826,142,115,2020,222,93,129
52827,142,133,2020,32,6,26
52828,142,65,2020,416,197,219
52829,142,129,2020,19013,9032,9981
52830,142,145,2020,60066,28250,31816
52831,142,49,2020,355,154,201
52832,142,74,2020,1371,640,731
52833,142,25,2020,125673,63869,61804
52834,142,169,2020,129,35,94
52835,142,27,2020,719,289,430
52836,142,146,2020,785,420,365
52837,142,26,2020,898,251,647
52838,142,170,2020,47,11,36
52839,142,130,2020,86,12,74
52840,142,38,2020,171,109,62
52841,142,60,2020,119,46,73
52842,142,50,2020,3161,1444,1717
52843,142,131,2020,144,31,113
52844,142,152,2020,64,7,57
52845,142,171,2020,112,22,90
52846,142,28,2020,9158,3693,5465
52847,142,132,2020,25,7,18
52848,97,103,2020,218,85,133
52849,97,66,2020,11,6,5
52850,97,3,2020,6,0,6
52851,97,79,2020,40,20,20
52852,97,67,2020,52,26,26
52853,97,105,2020,245,129,116
52854,97,95,2020,344,180,164
52855,97,106,2020,232,115,117
52856,97,172,2020,262,100,162
52857,97,107,2020,585,300,285
52858,97,96,2020,889,478,411
52859,97,81,2020,129,57,72
52860,97,83,2020,72,32,40
52861,97,108,2020,124,65,59
52862,97,68,2020,216,86,130
52863,97,69,2020,230,100,130
52864,97,98,2020,9036,4812,4224
52865,97,99,2020,11878,7017,4861
52866,97,173,2020,8,4,4
52867,97,5,2020,11,4,7
52868,97,6,2020,18,6,12
52869,97,44,2020,11,5,6
52870,97,17,2020,43,24,19
52871,97,57,2020,285,102,183
52872,97,86,2020,10,4,6
52873,97,177,2020,54,17,37
52874,97,100,2020,1742,943,799
52875,97,73,2020,33,11,22
52876,97,101,2020,7956,3740,4216
52877,97,102,2020,458,248,210
52878,97,111,2020,11,4,7
52879,97,112,2020,237,97,140
52880,97,61,2020,13,3,10
52881,97,88,2020,62,27,35
52882,97,36,2020,18,10,8
52883,97,65,2020,542,233,309
52884,97,49,2020,35,12,23
52885,97,74,2020,59,34,25
52886,97,50,2020,91,36,55
52887,97,114,2020,76,25,51
52888,138,135,2020,957,314,643
52889,138,68,2020,5482,2932,2550
52890,138,139,2020,307,132,175
52891,138,162,2020,430,196,234
52892,138,140,2020,1794,693,1101
52893,138,65,2020,1536,616,920
52894,119,134,2020,301,123,178
52895,119,116,2020,913,417,496
52896,119,172,2020,117,11,106
52897,119,117,2020,166,77,89
52898,119,137,2020,1474,656,818
52899,119,120,2020,94,42,52
52900,119,68,2020,380,177,203
52901,119,5,2020,103,62,41
52902,119,121,2020,305,126,179
52903,119,123,2020,673,294,379
52904,119,125,2020,966,558,408
52905,119,126,2020,407,211,196
52906,119,128,2020,2156,1021,1135
52907,119,115,2020,106,45,61
52908,119,133,2020,282,80,202
52909,119,129,2020,1300,444,856
52910,119,145,2020,181,61,120
52911,119,130,2020,1331,450,881
52912,119,50,2020,48,29,19
52913,119,131,2020,459,217,242
52914,119,132,2020,209,72,137
52915,40,2,2020,65,19,46
52916,40,51,2020,41,16,25
52917,40,141,2020,32,6,26
52918,40,52,2020,1,1,0
52919,40,134,2020,3,1,2
52920,40,76,2020,7,2,5
52921,40,103,2020,54,16,38
52922,40,11,2020,746,329,417
52923,40,66,2020,196,99,97
52924,40,12,2020,1625,671,954
52925,40,13,2020,0,0,0
52926,40,3,2020,263,51,212
52927,40,79,2020,1,0,1
52928,40,29,2020,10521,6439,4082
52929,40,67,2020,273,108,165
52930,40,95,2020,0,0,0
52931,40,151,2020,1,0,1
52932,40,4,2020,3,3,0
52933,40,53,2020,2,0,2
52934,40,105,2020,244,100,144
52935,40,30,2020,336,67,269
52936,40,153,2020,0,0,0
52937,40,135,2020,80,23,57
52938,40,106,2020,28,3,25
52939,40,172,2020,495,250,245
52940,40,173,2020,0,0,0
52941,40,107,2020,57,27,30
52942,40,137,2020,5,1,4
52943,40,96,2020,12,4,8
52944,40,54,2020,47,23,24
52945,40,81,2020,32,12,20
52946,40,14,2020,47,14,33
52947,40,31,2020,302,162,140
52948,40,176,2020,3,0,3
52949,40,137,2020,12,3,9
52950,40,39,2020,225,60,165
52951,40,83,2020,5,0,5
52952,40,108,2020,24,4,20
52953,40,142,2020,161,23,138
52954,40,97,2020,4,1,3
52955,40,120,2020,14,3,11
52956,40,41,2020,0,0,0
52957,40,42,2020,5928,2279,3649
52958,40,68,2020,960,386,574
52959,40,155,2020,2,0,2
52960,40,15,2020,1771,874,897
52961,40,69,2020,2507,1202,1305
52962,40,156,2020,59,11,48
52963,40,55,2020,0,0,0
52964,40,56,2020,171,66,105
52965,40,98,2020,10,1,9
52966,40,157,2020,1,0,1
52967,40,110,2020,2,2,0
52968,40,99,2020,12,5,7
52969,40,32,2020,246,122,124
52970,40,43,2020,42,9,33
52971,40,5,2020,712,162,550
52972,40,6,2020,216,75,141
52973,40,16,2020,63,22,41
52974,40,44,2020,330,147,183
52975,40,17,2020,102,44,58
52976,40,57,2020,1251,459,792
52977,40,86,2020,3,0,3
52978,40,177,2020,160,79,81
52979,40,18,2020,28,8,20
52980,40,167,2020,3754,2125,1629
52981,40,121,2020,22,10,12
52982,40,19,2020,12,1,11
52983,40,168,2020,545,309,236
52984,40,46,2020,6029,2917,3112
52985,40,20,2020,41,6,35
52986,40,143,2020,9,3,6
52987,40,70,2020,0,0,0
52988,40,47,2020,2169,1198,971
52989,40,71,2020,28,7,21
52990,40,122,2020,1,0,1
52991,40,123,2020,0,0,0
52992,40,58,2020,14,6,8
52993,40,161,2020,1,1,0
52994,40,124,2020,10,4,6
52995,40,100,2020,132,51,81
52996,40,72,2020,0,0,0
52997,40,59,2020,8,1,7
52998,40,144,2020,37,5,32
52999,40,125,2020,2,0,2
53000,40,150,2020,4,3,1
53001,40,8,2020,145,33,112
53002,40,73,2020,342,86,256
53003,40,101,2020,3,2,1
53004,40,162,2020,600,151,449
53005,40,60,2020,19,6,13
53006,40,48,2020,458,156,302
53007,40,21,2020,3,1,2
53008,40,9,2020,261,66,195
53009,40,102,2020,7,1,6
53010,40,111,2020,0,0,0
53011,40,112,2020,39,12,27
53012,40,33,2020,744,358,386
53013,40,61,2020,236,102,134
53014,40,22,2020,4,0,4
53015,40,35,2020,306,65,241
53016,40,36,2020,119097,74749,44348
53017,40,126,2020,4,1,3
53018,40,90,2020,0,0,0
53019,40,23,2020,18,5,13
53020,40,164,2020,3,0,3
53021,40,63,2020,52,23,29
53022,40,165,2020,8,0,8
53023,40,37,2020,177,81,96
53024,40,64,2020,40,23,17
53025,40,128,2020,3,0,3
53026,40,115,2020,59,18,41
53027,40,65,2020,730,322,408
53028,40,10,2020,62,15,47
53029,40,145,2020,26,1,25
53030,40,113,2020,2,0,2
53031,40,49,2020,952,232,720
53032,40,74,2020,136,46,90
53033,40,25,2020,174,75,99
53034,40,169,2020,373,191,182
53035,40,166,2020,2,0,2
53036,40,93,2020,2,2,0
53037,40,146,2020,26,2,24
53038,40,26,2020,468,97,371
53039,40,170,2020,332,215,117
53040,40,130,2020,9,1,8
53041,40,38,2020,24170,11796,12374
53042,40,27,2020,32,8,24
53043,40,50,2020,1297,414,883
53044,40,131,2020,5,1,4
53045,40,114,2020,6,1,5
53046,40,171,2020,1096,601,495
53047,40,1,2020,53,29,24
53048,40,28,2020,19,7,12
53049,40,132,2020,3,0,3
53050,40,133,2020,10,1,9
53051,148,134,2020,133,66,67
53052,148,147,2020,39,26,13
53053,148,116,2020,469,238,231
53054,148,137,2020,71,35,36
53055,148,137,2020,675,339,336
53056,148,120,2020,28,13,15
53057,148,149,2020,223,199,24
53058,148,159,2020,44,23,21
53059,148,125,2020,10011,3922,6089
53060,148,126,2020,387,193,194
53061,148,128,2020,305,143,162
53062,148,115,2020,12712,7699,5013
53063,148,130,2020,54,27,27
53064,120,116,2020,166,85,81
53065,120,137,2020,1468,747,721
53066,120,119,2020,191256,97462,93794
53067,120,118,2020,3439,1735,1704
53068,120,126,2020,138,70,68
53069,120,128,2020,411152,207466,203686
53070,120,129,2020,409890,204235,205655
53071,120,145,2020,41959,22350,19609
53072,120,130,2020,202,101,101
53073,120,28,2020,2053,1018,1035
53074,41,105,2020,31,20,11
53075,41,30,2020,61,4,57
53076,41,172,2020,35,23,12
53077,41,107,2020,36,20,16
53078,41,54,2020,24,10,14
53079,41,39,2020,4150,1935,2215
53080,41,120,2020,39,13,26
53081,41,69,2020,29,15,14
53082,41,156,2020,23,12,11
53083,41,43,2020,256,115,141
53084,41,5,2020,72,40,32
53085,41,121,2020,22,14,8
53086,41,47,2020,30,6,24
53087,41,48,2020,200,100,100
53088,41,112,2020,19,12,7
53089,41,33,2020,129,26,103
53090,41,35,2020,228,50,178
53091,41,36,2020,32,24,8
53092,41,63,2020,59,26,33
53093,41,115,2020,22,8,14
53094,41,49,2020,83,32,51
53095,41,146,2020,17,4,13
53096,41,50,2020,123,57,66
53097,42,2,2020,7019,2702,4317
53098,42,51,2020,706,221,485
53099,42,141,2020,1014,240,774
53100,42,52,2020,2,0,2
53101,42,134,2020,441,179,262
53102,42,76,2020,1,1,0
53103,42,103,2020,460,179,281
53104,42,11,2020,115,63,52
53105,42,77,2020,0,0,0
53106,42,66,2020,660,297,363
53107,42,12,2020,178,92,86
53108,42,78,2020,6,2,4
53109,42,13,2020,20,7,13
53110,42,3,2020,2983,1027,1956
53111,42,79,2020,12,3,9
53112,42,29,2020,443,276,167
53113,42,67,2020,690,242,448
53114,42,95,2020,0,0,0
53115,42,151,2020,19,6,13
53116,42,4,2020,2,2,0
53117,42,53,2020,811,371,440
53118,42,147,2020,19,8,11
53119,42,105,2020,1889,1075,814
53120,42,30,2020,2566,1151,1415
53121,42,152,2020,29,6,23
53122,42,116,2020,76,35,41
53123,42,153,2020,13,4,9
53124,42,135,2020,1094,418,676
53125,42,136,2020,11,3,8
53126,42,106,2020,542,256,286
53127,42,172,2020,11614,6721,4893
53128,42,107,2020,1228,599,629
53129,42,117,2020,2,1,1
53130,42,137,2020,125,52,73
53131,42,96,2020,73,25,48
53132,42,54,2020,293,126,167
53133,42,81,2020,551,200,351
53134,42,14,2020,203,63,140
53135,42,31,2020,332,176,156
53136,42,176,2020,5,3,2
53137,42,137,2020,1981,1040,941
53138,42,39,2020,1122,428,694
53139,42,118,2020,12,7,5
53140,42,82,2020,7,0,7
53141,42,83,2020,205,92,113
53142,42,108,2020,225,99,126
53143,42,142,2020,1505,351,1154
53144,42,97,2020,74,41,33
53145,42,138,2020,10,7,3
53146,42,119,2020,866,265,601
53147,42,40,2020,47280,23540,23740
53148,42,148,2020,10,5,5
53149,42,120,2020,2456,1065,1391
53150,42,68,2020,2684,987,1697
53151,42,139,2020,14,9,5
53152,42,155,2020,902,169,733
53153,42,15,2020,111,60,51
53154,42,69,2020,6834,2968,3866
53155,42,156,2020,1820,589,1231
53156,42,56,2020,1674,540,1134
53157,42,84,2020,1,0,1
53158,42,98,2020,85,35,50
53159,42,157,2020,111,24,87
53160,42,158,2020,8,2,6
53161,42,110,2020,16,7,9
53162,42,85,2020,11,4,7
53163,42,99,2020,92,55,37
53164,42,32,2020,2376,1154,1222
53165,42,43,2020,179,60,119
53166,42,5,2020,6954,2859,4095
53167,42,6,2020,7611,3325,4286
53168,42,16,2020,18304,6598,11706
53169,42,44,2020,668,179,489
53170,42,17,2020,793,248,545
53171,42,57,2020,3023,996,2027
53172,42,86,2020,86,30,56
53173,42,177,2020,1453,900,553
53174,42,18,2020,348,134,214
53175,42,167,2020,344,206,138
53176,42,121,2020,1562,841,721
53177,42,19,2020,220,77,143
53178,42,168,2020,84,43,41
53179,42,46,2020,2436,1198,1238
53180,42,20,2020,731,295,436
53181,42,159,2020,114,42,72
53182,42,143,2020,249,80,169
53183,42,47,2020,1366,709,657
53184,42,71,2020,105,51,54
53185,42,122,2020,19,12,7
53186,42,123,2020,103,50,53
53187,42,7,2020,0,0,0
53188,42,160,2020,23,4,19
53189,42,58,2020,53,20,33
53190,42,161,2020,37,13,24
53191,42,124,2020,49,23,26
53192,42,100,2020,995,434,561
53193,42,72,2020,9,4,5
53194,42,59,2020,15,7,8
53195,42,144,2020,2528,808,1720
53196,42,125,2020,73,38,35
53197,42,150,2020,152,90,62
53198,42,8,2020,3595,1207,2388
53199,42,73,2020,1653,436,1217
53200,42,101,2020,118,66,52
53201,42,162,2020,2915,891,2024
53202,42,60,2020,212,100,112
53203,42,48,2020,1852,864,988
53204,42,21,2020,16,9,7
53205,42,9,2020,3134,1044,2090
53206,42,102,2020,29,13,16
53207,42,111,2020,28,12,16
53208,42,112,2020,613,336,277
53209,42,33,2020,5018,2237,2781
53210,42,61,2020,598,200,398
53211,42,22,2020,27,9,18
53212,42,35,2020,3871,1623,2248
53213,42,36,2020,15212,8371,6841
53214,42,126,2020,524,261,263
53215,42,90,2020,0,0,0
53216,42,91,2020,3,1,2
53217,42,92,2020,1,0,1
53218,42,62,2020,0,0,0
53219,42,23,2020,484,229,255
53220,42,164,2020,216,33,183
53221,42,63,2020,252,122,130
53222,42,127,2020,6,6,0
53223,42,165,2020,145,36,109
53224,42,37,2020,334,162,172
53225,42,64,2020,102,49,53
53226,42,128,2020,12070,5775,6295
53227,42,115,2020,1022,402,620
53228,42,129,2020,9,7,2
53229,42,65,2020,3046,1240,1806
53230,42,10,2020,1148,519,629
53231,42,145,2020,1179,526,653
53232,42,113,2020,1,0,1
53233,42,49,2020,33412,15945,17467
53234,42,74,2020,1148,453,695
53235,42,25,2020,6223,2699,3524
53236,42,169,2020,63,25,38
53237,42,166,2020,93,16,77
53238,42,93,2020,44,25,19
53239,42,146,2020,808,191,617
53240,42,26,2020,7644,2404,5240
53241,42,170,2020,34,23,11
53242,42,94,2020,0,0,0
53243,42,130,2020,271,150,121
53244,42,38,2020,2851,1548,1303
53245,42,27,2020,257,104,153
53246,42,50,2020,6460,1800,4660
53247,42,131,2020,561,223,338
53248,42,114,2020,126,55,71
53249,42,171,2020,382,112,270
53250,42,1,2020,8677,4782,3895
53251,42,28,2020,223,75,148
53252,42,132,2020,341,170,171
53253,42,133,2020,143,57,86
53254,68,2,2020,35348,18061,17287
53255,68,51,2020,8925,4365,4560
53256,68,141,2020,1637211,769360,867851
53257,68,52,2020,1120,657,463
53258,68,134,2020,24350,12234,12116
53259,68,75,2020,9,3,6
53260,68,76,2020,67,52,15
53261,68,103,2020,14807,8768,6039
53262,68,11,2020,21830,12834,8996
53263,68,77,2020,10,7,3
53264,68,66,2020,9993,5938,4055
53265,68,12,2020,4702,2499,2203
53266,68,78,2020,48,30,18
53267,68,13,2020,181,103,78
53268,68,3,2020,12878,6582,6296
53269,68,79,2020,86,47,39
53270,68,29,2020,3887,2519,1368
53271,68,67,2020,163609,88940,74669
53272,68,95,2020,8,8,0
53273,68,151,2020,23352,11342,12010
53274,68,4,2020,162,83,79
53275,68,53,2020,15944,8577,7367
53276,68,147,2020,43,25,18
53277,68,105,2020,65671,41786,23885
53278,68,30,2020,34807,19043,15764
53279,68,152,2020,9997,4881,5116
53280,68,116,2020,2133,1253,880
53281,68,153,2020,25501,14697,10804
53282,68,135,2020,92983,58769,34214
53283,68,136,2020,8484,3934,4550
53284,68,106,2020,16473,9053,7420
53285,68,172,2020,125893,76571,49322
53286,68,173,2020,587,342,245
53287,68,174,2020,16,9,7
53288,68,107,2020,31151,18642,12509
53289,68,117,2020,41908,23120,18788
53290,68,137,2020,79478,40069,39409
53291,68,96,2020,858,505,353
53292,68,54,2020,8974,4691,4283
53293,68,81,2020,5466,3406,2060
53294,68,14,2020,1116,621,495
53295,68,31,2020,8907,5717,3190
53296,68,176,2020,67,42,25
53297,68,137,2020,87772,48001,39771
53298,68,39,2020,5805,3425,2380
53299,68,118,2020,7515,3807,3708
53300,68,82,2020,7368,5147,2221
53301,68,83,2020,3992,2788,1204
53302,68,108,2020,4730,3188,1542
53303,68,142,2020,35390,13421,21969
53304,68,97,2020,1271,798,473
53305,68,138,2020,443,267,176
53306,68,119,2020,7811,3986,3825
53307,68,40,2020,1312,946,366
53308,68,148,2020,21,15,6
53309,68,120,2020,9923,6516,3407
53310,68,41,2020,4,3,1
53311,68,42,2020,3479,2543,936
53312,68,139,2020,22627,12650,9977
53313,68,155,2020,2178,1114,1064
53314,68,15,2020,8673,4755,3918
53315,68,69,2020,203426,115405,88021
53316,68,156,2020,7658,3888,3770
53317,68,55,2020,77,57,20
53318,68,56,2020,15488,8168,7320
53319,68,98,2020,3423,1877,1546
53320,68,157,2020,34557,16500,18057
53321,68,158,2020,3506,1537,1969
53322,68,110,2020,5398,3358,2040
53323,68,85,2020,85042,50417,34625
53324,68,99,2020,669,414,255
53325,68,32,2020,11882,6890,4992
53326,68,43,2020,436,287,149
53327,68,5,2020,54982,30292,24690
53328,68,6,2020,26069,12705,13364
53329,68,16,2020,10159,4601,5558
53330,68,44,2020,10765,5982,4783
53331,68,45,2020,12,11,1
53332,68,17,2020,10520,5633,4887
53333,68,57,2020,325933,166419,159514
53334,68,86,2020,589,383,206
53335,68,177,2020,24453,18053,6400
53336,68,18,2020,1647,568,1079
53337,68,167,2020,2954,1802,1152
53338,68,121,2020,1999,1442,557
53339,68,19,2020,836,352,484
53340,68,168,2020,821,595,226
53341,68,46,2020,3470,2009,1461
53342,68,20,2020,53953,24106,29847
53343,68,149,2020,52,21,31
53344,68,159,2020,896,373,523
53345,68,143,2020,2688,1342,1346
53346,68,70,2020,29,13,16
53347,68,47,2020,3729,2421,1308
53348,68,71,2020,15941,7955,7986
53349,68,122,2020,137740,87513,50227
53350,68,123,2020,120,63,57
53351,68,7,2020,5,2,3
53352,68,160,2020,86437,35554,50883
53353,68,58,2020,442,220,222
53354,68,161,2020,20324,7209,13115
53355,68,124,2020,50721,31999,18722
53356,68,100,2020,14390,9550,4840
53357,68,72,2020,28539,15099,13440
53358,68,59,2020,1604,816,788
53359,68,87,2020,5,5,0
53360,68,144,2020,1059918,516420,543498
53361,68,125,2020,1474,859,615
53362,68,150,2020,195,112,83
53363,68,8,2020,1512,859,653
53364,68,73,2020,40825,21859,18966
53365,68,101,2020,738,505,233
53366,68,162,2020,7722,3697,4025
53367,68,60,2020,5133,2713,2420
53368,68,48,2020,4653,3211,1442
53369,68,21,2020,122,52,70
53370,68,9,2020,27203,10862,16341
53371,68,102,2020,582,361,221
53372,68,111,2020,1178,688,490
53373,68,112,2020,13361,8332,5029
53374,68,33,2020,94525,58489,36036
53375,68,61,2020,639888,314963,324925
53376,68,88,2020,57,29,28
53377,68,22,2020,167,95,72
53378,68,35,2020,138550,71817,66733
53379,68,36,2020,73208,48683,24525
53380,68,126,2020,7082,4063,3019
53381,68,90,2020,4,3,1
53382,68,91,2020,5433,3899,1534
53383,68,92,2020,30,23,7
53384,68,62,2020,251,130,121
53385,68,140,2020,254,157,97
53386,68,23,2020,2845,1366,1479
53387,68,164,2020,134848,60414,74434
53388,68,63,2020,96899,50700,46199
53389,68,127,2020,681,508,173
53390,68,165,2020,1486,817,669
53391,68,37,2020,5560,3661,1899
53392,68,64,2020,2752,1493,1259
53393,68,128,2020,8430,4305,4125
53394,68,115,2020,5925,3694,2231
53395,68,65,2020,282397,157336,125061
53396,68,10,2020,54756,27028,27728
53397,68,145,2020,21153,10806,10347
53398,68,113,2020,27892,16985,10907
53399,68,49,2020,8272,5240,3032
53400,68,74,2020,108987,66499,42488
53401,68,25,2020,21488,9347,12141
53402,68,169,2020,276,165,111
53403,68,166,2020,27183,13372,13811
53404,68,93,2020,467,350,117
53405,68,146,2020,444572,201691,242881
53406,68,26,2020,340271,165422,174849
53407,68,170,2020,239,140,99
53408,68,94,2020,7,3,4
53409,68,130,2020,663,406,257
53410,68,38,2020,18166,12780,5386
53411,68,27,2020,895,410,485
53412,68,50,2020,169565,85074,84491
53413,68,131,2020,735,442,293
53414,68,114,2020,2784,1590,1194
53415,68,171,2020,1258,758,500
53416,68,1,2020,143865,81033,62832
53417,68,28,2020,554,317,237
53418,68,132,2020,392,226,166
53419,68,133,2020,801,471,330
53420,109,141,2020,403,168,235
53421,109,67,2020,212,103,109
53422,109,105,2020,25759,11476,14283
53423,109,172,2020,1647,881,766
53424,109,82,2020,465,348,117
53425,109,68,2020,23526,11131,12395
53426,109,110,2020,3958,2159,1799
53427,109,85,2020,22084,12689,9395
53428,109,57,2020,179,69,110
53429,109,112,2020,656,322,334
53430,109,91,2020,882,498,384
53431,109,113,2020,26064,13792,12272
53432,139,141,2020,108,36,72
53433,139,134,2020,1111,377,734
53434,139,67,2020,501,187,314
53435,139,116,2020,166,53,113
53436,139,135,2020,50906,21331,29575
53437,139,136,2020,4543,1505,3038
53438,139,172,2020,344,82,262
53439,139,137,2020,16396,7311,9085
53440,139,137,2020,8949,3431,5518
53441,139,151,2020,52460,21605,30855
53442,139,138,2020,87411,36917,50494
53443,139,68,2020,16146,5843,10303
53444,139,69,2020,86,30,56
53445,139,156,2020,6392,783,5609
53446,139,157,2020,4999,1086,3913
53447,139,17,2020,14,3,11
53448,139,177,2020,29,10,19
53449,139,176,2020,158,52,106
53450,139,20,2020,2511,636,1875
53451,139,160,2020,55434,16576,38858
53452,139,144,2020,717,302,415
53453,139,162,2020,24029,5495,18534
53454,139,126,2020,209,85,124
53455,139,140,2020,6539,2894,3645
53456,139,164,2020,30652,5198,25454
53457,139,115,2020,11,0,11
53458,139,25,2020,27,9,18
53459,139,166,2020,23129,9699,13430
53460,139,146,2020,223,82,141
53461,139,152,2020,7024,2328,4696
53462,155,157,2020,45215,19051,26164
53463,155,159,2020,1082,510,572
53464,155,160,2020,10360,3807,6553
53465,155,161,2020,3646,539,3107
53466,155,158,2020,13808,7128,6680
53467,155,164,2020,132678,67137,65541
53468,155,165,2020,2608,1221,1387
53469,15,2,2020,40,17,23
53470,15,51,2020,9,5,4
53471,15,141,2020,16,9,7
53472,15,12,2020,6023,3944,2079
53473,15,103,2020,14,6,8
53474,15,66,2020,24,10,14
53475,15,11,2020,12789,5764,7025
53476,15,67,2020,21,12,9
53477,15,30,2020,231,125,106
53478,15,29,2020,1101,888,213
53479,15,172,2020,74,37,37
53480,15,81,2020,11,4,7
53481,15,31,2020,33,19,14
53482,15,40,2020,121,82,39
53483,15,42,2020,10,7,3
53484,15,68,2020,39,25,14
53485,15,69,2020,629,344,285
53486,15,56,2020,163,76,87
53487,15,32,2020,48,26,22
53488,15,5,2020,30,11,19
53489,15,6,2020,121,52,69
53490,15,17,2020,30,10,20
53491,15,57,2020,16,5,11
53492,15,167,2020,1718,743,975
53493,15,168,2020,249,166,83
53494,15,20,2020,8,4,4
53495,15,46,2020,205,134,71
53496,15,47,2020,210,160,50
53497,15,8,2020,16,0,16
53498,15,73,2020,10,6,4
53499,15,9,2020,86,5,81
53500,15,112,2020,19,17,2
53501,15,33,2020,180,128,52
53502,15,35,2020,220,164,56
53503,15,36,2020,37267,21312,15955
53504,15,65,2020,17,8,9
53505,15,74,2020,13,6,7
53506,15,169,2020,148,92,56
53507,15,26,2020,472,142,330
53508,15,170,2020,203,131,72
53509,15,38,2020,12203,6936,5267
53510,15,50,2020,33,8,25
53511,15,171,2020,765,491,274
53512,69,2,2020,250444,96625,153819
53513,69,51,2020,61063,28278,32785
53514,69,141,2020,25819,7135,18684
53515,69,134,2020,1338,668,670
53516,69,103,2020,20566,10821,9745
53517,69,11,2020,25512,13400,12112
53518,69,66,2020,285790,144926,140864
53519,69,12,2020,26690,13162,13528
53520,69,3,2020,13612,3889,9723
53521,69,29,2020,28325,19910,8415
53522,69,67,2020,38772,19266,19506
53523,69,151,2020,3061,866,2195
53524,69,53,2020,221720,110125,111595
53525,69,105,2020,70888,48201,22687
53526,69,30,2020,314911,155971,158940
53527,69,152,2020,2396,637,1759
53528,69,116,2020,776,358,418
53529,69,135,2020,22074,9653,12421
53530,69,136,2020,909,213,696
53531,69,106,2020,17686,9224,8462
53532,69,172,2020,142891,77572,65319
53533,69,107,2020,24535,15437,9098
53534,69,137,2020,4662,2376,2286
53535,69,96,2020,2097,1121,976
53536,69,54,2020,385778,195963,189815
53537,69,81,2020,16116,9486,6630
53538,69,14,2020,2748,1294,1454
53539,69,31,2020,603049,349964,253085
53540,69,176,2020,3316,2049,1267
53541,69,137,2020,9681,4762,4919
53542,69,39,2020,28815,15881,12934
53543,69,83,2020,12304,8486,3818
53544,69,108,2020,9414,5689,3725
53545,69,142,2020,25905,7712,18193
53546,69,97,2020,1475,841,634
53547,69,119,2020,63326,25583,37743
53548,69,40,2020,13007,8238,4769
53549,69,120,2020,23086,11141,11945
53550,69,42,2020,18072,12847,5225
53551,69,68,2020,161772,86563,75209
53552,69,139,2020,577,237,340
53553,69,155,2020,17200,2885,14315
53554,69,15,2020,25387,15242,10145
53555,69,156,2020,33440,16509,16931
53556,69,56,2020,391502,181275,210227
53557,69,98,2020,2322,1208,1114
53558,69,157,2020,11172,2760,8412
53559,69,85,2020,1754,982,772
53560,69,99,2020,1596,999,597
53561,69,32,2020,220774,99537,121237
53562,69,43,2020,2164,1024,1140
53563,69,5,2020,107628,39955,67673
53564,69,6,2020,152590,63287,89303
53565,69,16,2020,226480,88605,137875
53566,69,44,2020,15529,6864,8665
53567,69,17,2020,16529,6222,10307
53568,69,57,2020,694514,277487,417027
53569,69,86,2020,2530,1392,1138
53570,69,177,2020,37382,22790,14592
53571,69,18,2020,14047,5377,8670
53572,69,167,2020,1128201,606000,522201
53573,69,121,2020,16678,12107,4571
53574,69,168,2020,92834,53580,39254
53575,69,46,2020,38760,21507,17253
53576,69,20,2020,88243,35533,52710
53577,69,159,2020,2183,613,1570
53578,69,143,2020,13788,5017,8771
53579,69,70,2020,338,191,147
53580,69,47,2020,55291,34178,21113
53581,69,71,2020,23232,11423,11809
53582,69,122,2020,1765,1312,453
53583,69,160,2020,4101,1028,3073
53584,69,58,2020,831,432,399
53585,69,100,2020,20266,11698,8568
53586,69,59,2020,17407,8284,9123
53587,69,144,2020,127095,58261,68834
53588,69,8,2020,6844,3111,3733
53589,69,73,2020,165391,77168,88223
53590,69,101,2020,1685,917,768
53591,69,162,2020,52810,19284,33526
53592,69,60,2020,108634,53219,55415
53593,69,48,2020,9804,5397,4407
53594,69,9,2020,79227,25234,53993
53595,69,102,2020,811,472,339
53596,69,111,2020,5642,3574,2068
53597,69,112,2020,20599,13734,6865
53598,69,33,2020,2141722,1085458,1056264
53599,69,61,2020,152869,70955,81914
53600,69,35,2020,654822,318916,335906
53601,69,36,2020,1198831,715525,483306
53602,69,126,2020,1368,667,701
53603,69,23,2020,5347,2151,3196
53604,69,164,2020,6583,1801,4782
53605,69,63,2020,199691,100842,98849
53606,69,165,2020,3611,989,2622
53607,69,37,2020,60815,33927,26888
53608,69,64,2020,44089,22324,21765
53609,69,128,2020,35587,12754,22833
53610,69,115,2020,20378,10979,9399
53611,69,65,2020,186074,94170,91904
53612,69,10,2020,51830,25394,26436
53613,69,145,2020,4429,2211,2218
53614,69,49,2020,22178,12335,9843
53615,69,74,2020,93524,51673,41851
53616,69,25,2020,707457,268302,439155
53617,69,169,2020,32157,14689,17468
53618,69,166,2020,15809,6840,8969
53619,69,93,2020,1015,592,423
53620,69,146,2020,45857,15336,30521
53621,69,26,2020,1837282,901486,935796
53622,69,170,2020,7347,4142,3205
53623,69,130,2020,2874,1589,1285
53624,69,38,2020,289743,181542,108201
53625,69,50,2020,118246,45853,72393
53626,69,131,2020,1771,890,881
53627,69,114,2020,3782,2006,1776
53628,69,171,2020,46898,26218,20680
53629,69,1,2020,125327,68872,56455
53630,69,28,2020,4918,1511,3407
53631,69,132,2020,1115,677,438
53632,156,141,2020,13,2,11
53633,156,105,2020,13,5,8
53634,156,135,2020,132,43,89
53635,156,10,2020,21,9,12
53636,156,136,2020,15,2,13
53637,156,172,2020,266,42,224
53638,156,137,2020,33,14,19
53639,156,151,2020,19736,8813,10923
53640,156,120,2020,33,14,19
53641,156,68,2020,254,108,146
53642,156,155,2020,1888,878,1010
53643,156,157,2020,159,57,102
53644,156,5,2020,999,386,613
53645,156,17,2020,51,20,31
53646,156,57,2020,270,103,167
53647,156,177,2020,63,20,43
53648,156,121,2020,15,2,13
53649,156,20,2020,1155,448,707
53650,156,159,2020,34940,16281,18659
53651,156,160,2020,5900,1730,4170
53652,156,161,2020,13,3,10
53653,156,73,2020,213,93,120
53654,156,162,2020,80652,34200,46452
53655,156,9,2020,76,35,41
53656,156,33,2020,52,27,25
53657,156,36,2020,76,42,34
53658,156,126,2020,437,282,155
53659,156,164,2020,85,30,55
53660,156,165,2020,2740,1371,1369
53661,156,145,2020,27,5,22
53662,156,74,2020,169,73,96
53663,156,25,2020,58,25,33
53664,156,166,2020,103799,48385,55414
53665,156,142,2020,43,18,25
53666,156,50,2020,1595,815,780
53667,156,131,2020,8,3,5
53668,156,152,2020,67431,31420,36011
53669,55,144,2020,1006,373,633
53670,55,65,2020,2095,1318,777
53671,55,50,2020,5741,2697,3044
53672,56,2,2020,45293,22458,22835
53673,56,51,2020,446614,204531,242083
53674,56,141,2020,407,202,205
53675,56,52,2020,1,0,1
53676,56,134,2020,11,4,7
53677,56,75,2020,8,3,5
53678,56,76,2020,29,11,18
53679,56,103,2020,652,405,247
53680,56,11,2020,14571,7939,6632
53681,56,77,2020,0,0,0
53682,56,66,2020,2295,1513,782
53683,56,12,2020,515,305,210
53684,56,78,2020,20,9,11
53685,56,13,2020,21,6,15
53686,56,3,2020,2851,1410,1441
53687,56,79,2020,8,0,8
53688,56,29,2020,1485,1076,409
53689,56,67,2020,5225,2967,2258
53690,56,95,2020,2,2,0
53691,56,151,2020,5,0,5
53692,56,4,2020,0,0,0
53693,56,53,2020,446,296,150
53694,56,147,2020,5,2,3
53695,56,105,2020,2258,1500,758
53696,56,30,2020,74359,45889,28470
53697,56,152,2020,35,17,18
53698,56,116,2020,133,60,73
53699,56,153,2020,12,5,7
53700,56,135,2020,1545,762,783
53701,56,80,2020,0,0,0
53702,56,136,2020,16,8,8
53703,56,106,2020,372,231,141
53704,56,172,2020,3462,1588,1874
53705,56,173,2020,0,0,0
53706,56,107,2020,404,300,104
53707,56,117,2020,74,15,59
53708,56,137,2020,1441,768,673
53709,56,96,2020,37,30,7
53710,56,54,2020,435,295,140
53711,56,81,2020,357,246,111
53712,56,14,2020,22039,11986,10053
53713,56,31,2020,4516,2681,1835
53714,56,176,2020,33,15,18
53715,56,137,2020,4772,2360,2412
53716,56,39,2020,917,588,329
53717,56,118,2020,38,20,18
53718,56,82,2020,16,16,0
53719,56,83,2020,575,459,116
53720,56,108,2020,85,63,22
53721,56,142,2020,28834,12266,16568
53722,56,97,2020,49,37,12
53723,56,138,2020,7,3,4
53724,56,119,2020,1333,659,674
53725,56,40,2020,130,97,33
53726,56,148,2020,19,3,16
53727,56,120,2020,2466,1634,832
53728,56,41,2020,0,0,0
53729,56,42,2020,784,642,142
53730,56,68,2020,6826,4046,2780
53731,56,109,2020,0,0,0
53732,56,139,2020,5,3,2
53733,56,155,2020,49,23,26
53734,56,15,2020,85065,48516,36549
53735,56,69,2020,116644,61383,55261
53736,56,156,2020,608,160,448
53737,56,55,2020,2,0,2
53738,56,84,2020,0,0,0
53739,56,98,2020,30,22,8
53740,56,157,2020,176,86,90
53741,56,158,2020,0,0,0
53742,56,110,2020,8,5,3
53743,56,85,2020,37,20,17
53744,56,99,2020,49,37,12
53745,56,32,2020,1761,1140,621
53746,56,43,2020,53,30,23
53747,56,5,2020,10353,1942,8411
53748,56,6,2020,4684,2320,2364
53749,56,16,2020,16897,8379,8518
53750,56,44,2020,600,393,207
53751,56,45,2020,2,0,2
53752,56,17,2020,725,316,409
53753,56,57,2020,6426,3614,2812
53754,56,86,2020,10,5,5
53755,56,177,2020,518,385,133
53756,56,18,2020,827,202,625
53757,56,167,2020,27523,14417,13106
53758,56,121,2020,460,264,196
53759,56,19,2020,263,131,132
53760,56,168,2020,557,300,257
53761,56,46,2020,357,281,76
53762,56,20,2020,2092,860,1232
53763,56,149,2020,0,0,0
53764,56,159,2020,30,11,19
53765,56,143,2020,652,253,399
53766,56,70,2020,7,4,3
53767,56,47,2020,554,459,95
53768,56,71,2020,139,73,66
53769,56,122,2020,130,75,55
53770,56,7,2020,0,0,0
53771,56,160,2020,105,51,54
53772,56,58,2020,89,62,27
53773,56,161,2020,60,29,31
53774,56,124,2020,37,30,7
53775,56,100,2020,402,309,93
53776,56,72,2020,43,20,23
53777,56,87,2020,78,41,37
53778,56,144,2020,2114,575,1539
53779,56,125,2020,63,36,27
53780,56,150,2020,5,0,5
53781,56,8,2020,66,32,34
53782,56,73,2020,3819,2414,1405
53783,56,101,2020,161,81,80
53784,56,162,2020,2914,999,1915
53785,56,60,2020,2210,1222,988
53786,56,48,2020,525,335,190
53787,56,21,2020,2,0,2
53788,56,9,2020,8823,4388,4435
53789,56,102,2020,158,81,77
53790,56,111,2020,79,62,17
53791,56,112,2020,296,204,92
53792,56,33,2020,15975,9949,6026
53793,56,61,2020,328,208,120
53794,56,88,2020,0,0,0
53795,56,22,2020,1123,585,538
53796,56,35,2020,47120,26050,21070
53797,56,36,2020,55281,34462,20819
53798,56,126,2020,97,19,78
53799,56,90,2020,0,0,0
53800,56,92,2020,4,3,1
53801,56,62,2020,0,0,0
53802,56,140,2020,4,0,4
53803,56,23,2020,432,204,228
53804,56,164,2020,651,51,600
53805,56,63,2020,4467,2838,1629
53806,56,127,2020,23,20,3
53807,56,165,2020,176,57,119
53808,56,37,2020,876,695,181
53809,56,64,2020,130,97,33
53810,56,128,2020,3788,1868,1920
53811,56,115,2020,7045,3869,3176
53812,56,65,2020,1202,778,424
53813,56,10,2020,904,540,364
53814,56,145,2020,1889,733,1156
53815,56,113,2020,6,4,2
53816,56,49,2020,5526,3181,2345
53817,56,74,2020,3769,2141,1628
53818,56,25,2020,42861,21252,21609
53819,56,169,2020,97,63,34
53820,56,166,2020,21,9,12
53821,56,93,2020,15,11,4
53822,56,146,2020,647,136,511
53823,56,26,2020,34081,18503,15578
53824,56,170,2020,116,67,49
53825,56,130,2020,140,83,57
53826,56,38,2020,19846,14968,4878
53827,56,27,2020,87,36,51
53828,56,50,2020,18033,10437,7596
53829,56,131,2020,401,177,224
53830,56,114,2020,112,66,46
53831,56,171,2020,8459,4724,3735
53832,56,1,2020,212,107,105
53833,56,28,2020,279,138,141
53834,56,132,2020,241,132,109
53835,56,133,2020,425,231,194
53836,84,76,2020,39,21,18
53837,84,78,2020,30,16,14
53838,84,79,2020,180,97,83
53839,84,82,2020,74,40,34
53840,84,110,2020,365,315,50
53841,84,86,2020,117,63,54
53842,84,87,2020,10,5,5
53843,84,90,2020,15,8,7
53844,84,91,2020,165,89,76
53845,84,92,2020,398,316,82
53846,84,93,2020,2291,1610,681
53847,98,103,2020,595,224,371
53848,98,105,2020,257,105,152
53849,98,95,2020,984,476,508
53850,98,106,2020,322,127,195
53851,98,172,2020,705,320,385
53852,98,107,2020,1242,571,671
53853,98,96,2020,1248,602,646
53854,98,81,2020,708,283,425
53855,98,83,2020,115,45,70
53856,98,108,2020,178,75,103
53857,98,97,2020,20683,16018,4665
53858,98,68,2020,275,81,194
53859,98,109,2020,20,8,12
53860,98,69,2020,687,246,441
53861,98,85,2020,13,4,9
53862,98,99,2020,9023,4900,4123
53863,98,6,2020,18,5,13
53864,98,17,2020,140,48,92
53865,98,57,2020,394,113,281
53866,98,177,2020,157,57,100
53867,98,20,2020,25,2,23
53868,98,100,2020,18872,7764,11108
53869,98,73,2020,149,73,76
53870,98,101,2020,9211,4275,4936
53871,98,9,2020,26,13,13
53872,98,102,2020,321,152,169
53873,98,111,2020,62,28,34
53874,98,112,2020,491,207,284
53875,98,61,2020,29,1,28
53876,98,88,2020,107,44,63
53877,98,23,2020,32,2,30
53878,98,65,2020,1418,525,893
53879,98,49,2020,49,13,36
53880,98,74,2020,165,53,112
53881,98,25,2020,83,25,58
53882,98,26,2020,25,14,11
53883,98,142,2020,32,31,1
53884,98,50,2020,238,83,155
53885,98,114,2020,149,52,97
53886,157,2,2020,1,0,1
53887,157,51,2020,9,2,7
53888,157,141,2020,6766,2619,4147
53889,157,52,2020,4,0,4
53890,157,134,2020,109,38,71
53891,157,76,2020,4276,1823,2453
53892,157,12,2020,3,0,3
53893,157,103,2020,105,43,62
53894,157,66,2020,0,0,0
53895,157,78,2020,11,5,6
53896,157,13,2020,1,0,1
53897,157,3,2020,0,0,0
53898,157,11,2020,7,0,7
53899,157,79,2020,9,0,9
53900,157,67,2020,37,12,25
53901,157,4,2020,1,0,1
53902,157,53,2020,0,0,0
53903,157,147,2020,46,18,28
53904,157,105,2020,12,2,10
53905,157,95,2020,0,0,0
53906,157,30,2020,1,0,1
53907,157,116,2020,36,11,25
53908,157,135,2020,187,51,136
53909,157,153,2020,31,11,20
53910,157,10,2020,0,0,0
53911,157,136,2020,372,107,265
53912,157,106,2020,9,1,8
53913,157,172,2020,161,32,129
53914,157,107,2020,2519,1056,1463
53915,157,117,2020,730,271,459
53916,157,137,2020,116,40,76
53917,157,137,2020,73,25,48
53918,157,96,2020,112,41,71
53919,157,54,2020,17,5,12
53920,157,81,2020,1714,690,1024
53921,157,151,2020,391,121,270
53922,157,39,2020,63,25,38
53923,157,82,2020,11,7,4
53924,157,83,2020,0,0,0
53925,157,108,2020,0,0,0
53926,157,97,2020,2,0,2
53927,157,138,2020,10274,4262,6012
53928,157,120,2020,10,3,7
53929,157,119,2020,20,6,14
53930,157,42,2020,4,0,4
53931,157,68,2020,237,70,167
53932,157,118,2020,16,2,14
53933,157,139,2020,70,24,46
53934,157,155,2020,268,105,163
53935,157,69,2020,24,7,17
53936,157,156,2020,564,104,460
53937,157,85,2020,22,10,12
53938,157,99,2020,285,124,161
53939,157,5,2020,45,1,44
53940,157,17,2020,9,2,7
53941,157,57,2020,78,32,46
53942,157,177,2020,50,19,31
53943,157,18,2020,0,0,0
53944,157,121,2020,1920,796,1124
53945,157,176,2020,1183,490,693
53946,157,20,2020,148,27,121
53947,157,149,2020,29,8,21
53948,157,46,2020,20,9,11
53949,157,159,2020,2655,1174,1481
53950,157,143,2020,41,13,28
53951,157,70,2020,2,1,1
53952,157,122,2020,8,3,5
53953,157,123,2020,15,3,12
53954,157,160,2020,45192,19841,25351
53955,157,161,2020,1107,360,747
53956,157,124,2020,13,2,11
53957,157,144,2020,318,121,197
53958,157,125,2020,17,4,13
53959,157,150,2020,1,0,1
53960,157,8,2020,22,4,18
53961,157,73,2020,35,10,25
53962,157,101,2020,3,0,3
53963,157,162,2020,364,62,302
53964,157,48,2020,0,0,0
53965,157,9,2020,17,2,15
53966,157,33,2020,0,0,0
53967,157,61,2020,12,0,12
53968,157,158,2020,4361,1862,2499
53969,157,35,2020,3,0,3
53970,157,36,2020,36,6,30
53971,157,126,2020,36,14,22
53972,157,92,2020,27,9,18
53973,157,140,2020,30,11,19
53974,157,23,2020,28,9,19
53975,157,164,2020,2053,805,1248
53976,157,63,2020,0,0,0
53977,157,127,2020,1,0,1
53978,157,165,2020,8342,3456,4886
53979,157,1,2020,3,0,3
53980,157,64,2020,25,9,16
53981,157,128,2020,4,0,4
53982,157,115,2020,1201,466,735
53983,157,133,2020,2,0,2
53984,157,65,2020,1139,464,675
53985,157,129,2020,1,0,1
53986,157,145,2020,5,0,5
53987,157,148,2020,3,0,3
53988,157,49,2020,1,0,1
53989,157,74,2020,15,4,11
53990,157,25,2020,6,0,6
53991,157,169,2020,0,0,0
53992,157,166,2020,510,138,372
53993,157,146,2020,510,224,286
53994,157,26,2020,32,9,23
53995,157,130,2020,0,0,0
53996,157,38,2020,7,1,6
53997,157,142,2020,24,4,20
53998,157,50,2020,6,1,5
53999,157,131,2020,0,0,0
54000,157,152,2020,564,65,499
54001,157,114,2020,0,0,0
54002,157,171,2020,0,0,0
54003,158,153,2020,403,240,163
54004,158,68,2020,79,23,56
54005,158,155,2020,1092,534,558
54006,158,157,2020,3612,1745,1867
54007,158,159,2020,634,225,409
54008,158,161,2020,408,198,210
54009,158,61,2020,601,303,298
54010,158,164,2020,9093,4765,4328
54011,158,165,2020,585,282,303
54012,110,76,2020,9,5,4
54013,110,78,2020,8,4,4
54014,110,79,2020,157,70,87
54015,110,105,2020,1260,469,791
54016,110,172,2020,676,260,416
54017,110,82,2020,25,9,16
54018,110,84,2020,112,48,64
54019,110,86,2020,174,75,99
54020,110,91,2020,128,50,78
54021,110,92,2020,216,92,124
54022,110,113,2020,2714,1300,1414
54023,110,93,2020,519,220,299
54024,110,50,2020,337,144,193
54025,85,103,2020,456,193,263
54026,85,66,2020,164,23,141
54027,85,106,2020,326,115,211
54028,85,172,2020,341,142,199
54029,85,107,2020,815,398,417
54030,85,96,2020,267,163,104
54031,85,81,2020,1185,520,665
54032,85,83,2020,2377,1045,1332
54033,85,68,2020,434,167,267
54034,85,69,2020,883,354,529
54035,85,57,2020,1210,352,858
54036,85,177,2020,215,96,119
54037,85,100,2020,299,169,130
54038,85,112,2020,345,138,207
54039,85,88,2020,1526,830,696
54040,85,65,2020,1280,464,816
54041,85,74,2020,369,132,237
54042,85,114,2020,279,168,111
54043,99,103,2020,194,83,111
54044,99,67,2020,25,8,17
54045,99,105,2020,240,142,98
54046,99,95,2020,372,173,199
54047,99,80,2020,91,43,48
54048,99,106,2020,314,154,160
54049,99,172,2020,608,220,388
54050,99,107,2020,886,385,501
54051,99,96,2020,879,407,472
54052,99,81,2020,624,198,426
54053,99,83,2020,137,50,87
54054,99,108,2020,470,151,319
54055,99,97,2020,9071,4871,4200
54056,99,68,2020,146,61,85
54057,99,69,2020,297,101,196
54058,99,98,2020,4711,2310,2401
54059,99,85,2020,43,5,38
54060,99,17,2020,91,30,61
54061,99,57,2020,265,65,200
54062,99,86,2020,27,4,23
54063,99,177,2020,141,64,77
54064,99,18,2020,40,19,21
54065,99,176,2020,62,19,43
54066,99,100,2020,1602,805,797
54067,99,73,2020,92,27,65
54068,99,101,2020,7943,3923,4020
54069,99,102,2020,406,172,234
54070,99,111,2020,35,13,22
54071,99,112,2020,392,165,227
54072,99,88,2020,131,49,82
54073,99,36,2020,25,10,15
54074,99,65,2020,536,229,307
54075,99,49,2020,31,13,18
54076,99,74,2020,61,17,44
54077,99,50,2020,103,30,73
54078,99,114,2020,67,24,43
54079,173,3,2020,462,187,275
54080,173,172,2020,2408447,1422241,986206
54081,173,174,2020,74414,43819,30595
54082,173,68,2020,2289,866,1423
54083,173,69,2020,2058,610,1448
54084,173,5,2020,18788,10606,8182
54085,173,44,2020,724,336,388
54086,173,57,2020,669,277,392
54087,173,177,2020,14803,7883,6920
54088,173,8,2020,9741,5468,4273
54089,173,73,2020,1063,412,651
54090,173,9,2020,7882,3504,4378
54091,173,61,2020,113,69,44
54092,173,36,2020,90,83,7
54093,173,65,2020,418,227,191
54094,173,10,2020,815,578,237
54095,173,74,2020,757,252,505
54096,173,50,2020,18436,7673,10763
54097,173,1,2020,11406,7721,3685
54098,32,2,2020,1816,553,1263
54099,32,51,2020,503,145,358
54100,32,141,2020,929,236,693
54101,32,52,2020,0,0,0
54102,32,134,2020,116,48,68
54103,32,76,2020,0,0,0
54104,32,103,2020,432,188,244
54105,32,11,2020,225,114,111
54106,32,77,2020,2,0,2
54107,32,66,2020,11188,5104,6084
54108,32,12,2020,617,203,414
54109,32,78,2020,7,2,5
54110,32,13,2020,37,18,19
54111,32,3,2020,244,48,196
54112,32,79,2020,3,3,0
54113,32,29,2020,266,174,92
54114,32,67,2020,2574,1183,1391
54115,32,95,2020,2,1,1
54116,32,151,2020,33,9,24
54117,32,4,2020,12,7,5
54118,32,53,2020,438,145,293
54119,32,147,2020,12,4,8
54120,32,105,2020,1321,629,692
54121,32,30,2020,1421,722,699
54122,32,152,2020,12,5,7
54123,32,116,2020,12,5,7
54124,32,153,2020,19,8,11
54125,32,135,2020,322,85,237
54126,32,80,2020,2,2,0
54127,32,136,2020,5,0,5
54128,32,106,2020,214,102,112
54129,32,172,2020,17648,8737,8911
54130,32,107,2020,335,171,164
54131,32,117,2020,2,0,2
54132,32,137,2020,76,14,62
54133,32,96,2020,98,45,53
54134,32,54,2020,2282,1120,1162
54135,32,81,2020,618,323,295
54136,32,14,2020,307,138,169
54137,32,31,2020,1487,825,662
54138,32,176,2020,17,13,4
54139,32,137,2020,70,30,40
54140,32,39,2020,643,266,377
54141,32,118,2020,3,1,2
54142,32,82,2020,2,0,2
54143,32,83,2020,59,32,27
54144,32,108,2020,219,94,125
54145,32,142,2020,2220,758,1462
54146,32,97,2020,21,11,10
54147,32,138,2020,5,1,4
54148,32,119,2020,40,15,25
54149,32,40,2020,160,116,44
54150,32,148,2020,2,2,0
54151,32,120,2020,199,65,134
54152,32,41,2020,0,0,0
54153,32,42,2020,922,467,455
54154,32,68,2020,4839,2198,2641
54155,32,139,2020,7,4,3
54156,32,155,2020,13,5,8
54157,32,15,2020,361,193,168
54158,32,69,2020,35636,16820,18816
54159,32,156,2020,283,105,178
54160,32,56,2020,1361,648,713
54161,32,84,2020,3,2,1
54162,32,98,2020,32,14,18
54163,32,157,2020,60,9,51
54164,32,158,2020,10,2,8
54165,32,110,2020,9,4,5
54166,32,85,2020,8,6,2
54167,32,99,2020,9,6,3
54168,32,43,2020,148,82,66
54169,32,5,2020,3217,1047,2170
54170,32,6,2020,4125,1800,2325
54171,32,16,2020,1465,466,999
54172,32,44,2020,2046,969,1077
54173,32,17,2020,1898,759,1139
54174,32,57,2020,6187,2261,3926
54175,32,86,2020,32,16,16
54176,32,177,2020,2069,906,1163
54177,32,18,2020,868,227,641
54178,32,167,2020,837,535,302
54179,32,121,2020,254,110,144
54180,32,19,2020,380,133,247
54181,32,168,2020,247,159,88
54182,32,46,2020,194,124,70
54183,32,20,2020,521,158,363
54184,32,149,2020,1,0,1
54185,32,159,2020,21,2,19
54186,32,143,2020,395,131,264
54187,32,70,2020,3,1,2
54188,32,47,2020,264,167,97
54189,32,71,2020,285,131,154
54190,32,122,2020,44,20,24
54191,32,123,2020,3,0,3
54192,32,160,2020,26,5,21
54193,32,58,2020,159,81,78
54194,32,161,2020,5,0,5
54195,32,124,2020,74,36,38
54196,32,100,2020,708,318,390
54197,32,72,2020,7,4,3
54198,32,59,2020,91,34,57
54199,32,144,2020,441,149,292
54200,32,125,2020,29,13,16
54201,32,150,2020,25,15,10
54202,32,8,2020,113,39,74
54203,32,73,2020,4264,1806,2458
54204,32,101,2020,26,12,14
54205,32,162,2020,1769,607,1162
54206,32,60,2020,301,108,193
54207,32,48,2020,1479,900,579
54208,32,21,2020,36,18,18
54209,32,9,2020,1055,275,780
54210,32,102,2020,29,14,15
54211,32,111,2020,19,10,9
54212,32,112,2020,267,126,141
54213,32,33,2020,3383,2138,1245
54214,32,61,2020,630,251,379
54215,32,22,2020,119,49,70
54216,32,35,2020,214514,108116,106398
54217,32,36,2020,4583,2796,1787
54218,32,126,2020,23,13,10
54219,32,90,2020,0,0,0
54220,32,91,2020,2,0,2
54221,32,92,2020,1,1,0
54222,32,62,2020,3,1,2
54223,32,23,2020,451,153,298
54224,32,164,2020,51,16,35
54225,32,63,2020,48194,20673,27521
54226,32,127,2020,8,5,3
54227,32,165,2020,30,6,24
54228,32,37,2020,20980,12669,8311
54229,32,64,2020,454,208,246
54230,32,128,2020,472,57,415
54231,32,115,2020,604,281,323
54232,32,65,2020,2599,1230,1369
54233,32,10,2020,74,25,49
54234,32,145,2020,225,45,180
54235,32,113,2020,12,5,7
54236,32,49,2020,1858,831,1027
54237,32,74,2020,3692,1667,2025
54238,32,25,2020,2693,797,1896
54239,32,169,2020,17,5,12
54240,32,166,2020,27,8,19
54241,32,93,2020,16,6,10
54242,32,146,2020,573,182,391
54243,32,26,2020,3391,977,2414
54244,32,170,2020,44,19,25
54245,32,130,2020,97,37,60
54246,32,38,2020,70944,33869,37075
54247,32,27,2020,618,248,370
54248,32,50,2020,15065,6887,8178
54249,32,131,2020,78,19,59
54250,32,114,2020,56,32,24
54251,32,171,2020,170,90,80
54252,32,1,2020,5272,2506,2766
54253,32,28,2020,370,115,255
54254,32,132,2020,30,15,15
54255,32,133,2020,97,44,53
54256,43,2,2020,108,42,66
54257,43,51,2020,220,75,145
54258,43,141,2020,68,17,51
54259,43,52,2020,2,2,0
54260,43,134,2020,50,14,36
54261,43,76,2020,0,0,0
54262,43,103,2020,83,32,51
54263,43,11,2020,10,6,4
54264,43,77,2020,0,0,0
54265,43,66,2020,163,94,69
54266,43,12,2020,19,10,9
54267,43,78,2020,5,3,2
54268,43,13,2020,0,0,0
54269,43,3,2020,12,5,7
54270,43,79,2020,0,0,0
54271,43,29,2020,68,45,23
54272,43,67,2020,206,98,108
54273,43,95,2020,0,0,0
54274,43,151,2020,1,1,0
54275,43,53,2020,273,103,170
54276,43,105,2020,217,146,71
54277,43,30,2020,515,222,293
54278,43,152,2020,0,0,0
54279,43,153,2020,54,28,26
54280,43,135,2020,5,2,3
54281,43,136,2020,1,1,0
54282,43,106,2020,87,40,47
54283,43,172,2020,747,478,269
54284,43,107,2020,257,150,107
54285,43,137,2020,1,0,1
54286,43,96,2020,18,7,11
54287,43,54,2020,716,212,504
54288,43,81,2020,64,34,30
54289,43,14,2020,11,4,7
54290,43,31,2020,810,375,435
54291,43,176,2020,0,0,0
54292,43,137,2020,2,0,2
54293,43,39,2020,3918,1939,1979
54294,43,118,2020,0,0,0
54295,43,82,2020,2,2,0
54296,43,83,2020,58,40,18
54297,43,108,2020,55,31,24
54298,43,142,2020,45,12,33
54299,43,97,2020,27,17,10
54300,43,138,2020,24,16,8
54301,43,119,2020,9,4,5
54302,43,40,2020,178,106,72
54303,43,120,2020,88,47,41
54304,43,41,2020,327,181,146
54305,43,42,2020,236,155,81
54306,43,68,2020,910,434,476
54307,43,139,2020,0,0,0
54308,43,155,2020,19,4,15
54309,43,15,2020,52,24,28
54310,43,69,2020,2148,1308,840
54311,43,156,2020,133,60,73
54312,43,55,2020,0,0,0
54313,43,56,2020,181,62,119
54314,43,98,2020,36,15,21
54315,43,157,2020,23,10,13
54316,43,158,2020,2,0,2
54317,43,110,2020,23,14,9
54318,43,85,2020,13,9,4
54319,43,99,2020,60,37,23
54320,43,32,2020,505,230,275
54321,43,5,2020,389,207,182
54322,43,6,2020,166,61,105
54323,43,16,2020,236,89,147
54324,43,44,2020,150,61,89
54325,43,17,2020,45,12,33
54326,43,57,2020,525,201,324
54327,43,86,2020,21,15,6
54328,43,177,2020,118,84,34
54329,43,18,2020,27,16,11
54330,43,167,2020,35,26,9
54331,43,121,2020,103,77,26
54332,43,19,2020,3,2,1
54333,43,168,2020,6,3,3
54334,43,46,2020,1922,632,1290
54335,43,20,2020,50,16,34
54336,43,159,2020,6,2,4
54337,43,143,2020,7,3,4
54338,43,70,2020,0,0,0
54339,43,47,2020,3171,1183,1988
54340,43,71,2020,180,91,89
54341,43,122,2020,2,0,2
54342,43,123,2020,1,1,0
54343,43,160,2020,4,0,4
54344,43,58,2020,9,3,6
54345,43,161,2020,2,0,2
54346,43,124,2020,6,5,1
54347,43,100,2020,159,86,73
54348,43,72,2020,0,0,0
54349,43,59,2020,12,6,6
54350,43,144,2020,262,91,171
54351,43,125,2020,30,17,13
54352,43,150,2020,43,28,15
54353,43,8,2020,129,56,73
54354,43,73,2020,408,187,221
54355,43,101,2020,6,6,0
54356,43,162,2020,155,67,88
54357,43,60,2020,84,41,43
54358,43,48,2020,1390,719,671
54359,43,21,2020,2,2,0
54360,43,9,2020,94,25,69
54361,43,102,2020,7,3,4
54362,43,111,2020,2,2,0
54363,43,112,2020,105,66,39
54364,43,33,2020,21102,8384,12718
54365,43,61,2020,1082,358,724
54366,43,88,2020,0,0,0
54367,43,22,2020,3,2,1
54368,43,35,2020,1675,530,1145
54369,43,36,2020,492,307,185
54370,43,126,2020,0,0,0
54371,43,92,2020,0,0,0
54372,43,62,2020,2,2,0
54373,43,23,2020,18,6,12
54374,43,164,2020,29,9,20
54375,43,63,2020,752,348,404
54376,43,165,2020,19,6,13
54377,43,37,2020,517,181,336
54378,43,64,2020,70,37,33
54379,43,128,2020,32,9,23
54380,43,115,2020,104,60,44
54381,43,65,2020,991,419,572
54382,43,10,2020,190,113,77
54383,43,145,2020,6,0,6
54384,43,49,2020,2357,1166,1191
54385,43,74,2020,226,121,105
54386,43,25,2020,280,106,174
54387,43,169,2020,2,2,0
54388,43,166,2020,11,4,7
54389,43,93,2020,6,5,1
54390,43,146,2020,41,13,28
54391,43,26,2020,104,35,69
54392,43,170,2020,1,1,0
54393,43,130,2020,60,40,20
54394,43,38,2020,437,263,174
54395,43,27,2020,11,2,9
54396,43,50,2020,1857,732,1125
54397,43,131,2020,24,16,8
54398,43,114,2020,11,3,8
54399,43,171,2020,13,9,4
54400,43,1,2020,916,513,403
54401,43,28,2020,1,0,1
54402,43,132,2020,12,10,2
54403,43,133,2020,13,9,4
54404,5,2,2020,16094,8121,7973
54405,5,3,2020,2488471,1247149,1241322
54406,5,4,2020,9438,4887,4551
54407,5,172,2020,108008,52351,55657
54408,5,68,2020,1735,943,792
54409,5,69,2020,2382,1270,1112
54410,5,6,2020,2194,1193,1001
54411,5,16,2020,670,287,383
54412,5,177,2020,1797,1053,744
54413,5,167,2020,433,259,174
54414,5,121,2020,7733,4198,3535
54415,5,19,2020,11781,6175,5606
54416,5,7,2020,864,434,430
54417,5,124,2020,346,222,124
54418,5,8,2020,733734,492259,241475
54419,5,162,2020,903,376,527
54420,5,9,2020,833314,413832,419482
54421,5,61,2020,332,186,146
54422,5,23,2020,14448,7078,7370
54423,5,10,2020,184780,95934,88846
54424,5,26,2020,130,64,66
54425,5,36,2020,1248,711,537
54426,5,130,2020,45309,30674,14635
54427,5,27,2020,38470,19115,19355
54428,5,50,2020,10999,5816,5183
54429,5,1,2020,1324,838,486
54430,5,132,2020,1451,942,509
54431,6,2,2020,2710601,1239126,1471475
54432,6,11,2020,989,503,486
54433,6,12,2020,4788,2441,2347
54434,6,16,2020,54445,24221,30224
54435,6,9,2020,12575,5269,7306
54436,6,26,2020,384,153,231
54437,6,170,2020,1954,792,1162
54438,16,2,2020,314,144,170
54439,16,119,2020,812,257,555
54440,16,5,2020,234,90,144
54441,16,6,2020,14540,6676,7864
54442,16,18,2020,10432,3069,7363
54443,16,19,2020,403,128,275
54444,16,20,2020,1536,632,904
54445,16,161,2020,201,52,149
54446,16,144,2020,591,219,372
54447,16,9,2020,688,180,508
54448,16,36,2020,274,83,191
54449,16,23,2020,680,191,489
54450,16,128,2020,417,115,302
54451,16,129,2020,297,38,259
54452,16,145,2020,3826,501,3325
54453,16,25,2020,254441,121410,133031
54454,16,27,2020,289,66,223
54455,16,146,2020,314,45,269
54456,16,26,2020,20677,9782,10895
54457,16,142,2020,14498,2729,11769
54458,16,28,2020,2020,412,1608
54459,44,2,2020,168,31,137
54460,44,51,2020,340,140,200
54461,44,141,2020,673,196,477
54462,44,52,2020,1,1,0
54463,44,134,2020,548,274,274
54464,44,75,2020,0,0,0
54465,44,76,2020,1,1,0
54466,44,103,2020,374,199,175
54467,44,11,2020,59,28,31
54468,44,77,2020,6,4,2
54469,44,66,2020,898,602,296
54470,44,12,2020,55,26,29
54471,44,78,2020,28,13,15
54472,44,13,2020,93,49,44
54473,44,3,2020,3706,1088,2618
54474,44,79,2020,18,10,8
54475,44,29,2020,698,398,300
54476,44,67,2020,1877,1034,843
54477,44,95,2020,1,1,0
54478,44,151,2020,37,24,13
54479,44,4,2020,6,2,4
54480,44,53,2020,732,389,343
54481,44,147,2020,89,41,48
54482,44,105,2020,11800,4913,6887
54483,44,30,2020,2263,1221,1042
54484,44,152,2020,8,3,5
54485,44,116,2020,53,26,27
54486,44,153,2020,3,1,2
54487,44,135,2020,395,230,165
54488,44,80,2020,26,15,11
54489,44,136,2020,9,3,6
54490,44,106,2020,160,95,65
54491,44,172,2020,14542,7456,7086
54492,44,173,2020,2162,1294,868
54493,44,137,2020,2886,1478,1408
54494,44,96,2020,11,7,4
54495,44,54,2020,578,282,296
54496,44,81,2020,94,52,42
54497,44,14,2020,330,165,165
54498,44,31,2020,6972,3213,3759
54499,44,176,2020,148,90,58
54500,44,137,2020,58,30,28
54501,44,39,2020,1122,657,465
54502,44,118,2020,0,0,0
54503,44,82,2020,0,0,0
54504,44,83,2020,9,4,5
54505,44,108,2020,42,29,13
54506,44,142,2020,609,196,413
54507,44,97,2020,28,17,11
54508,44,119,2020,41,15,26
54509,44,40,2020,3145,1846,1299
54510,44,148,2020,22,13,9
54511,44,120,2020,175,98,77
54512,44,41,2020,2,2,0
54513,44,42,2020,1107,853,254
54514,44,68,2020,12780,7429,5351
54515,44,139,2020,3,2,1
54516,44,155,2020,63,29,34
54517,44,15,2020,290,132,158
54518,44,69,2020,16475,10179,6296
54519,44,156,2020,576,319,257
54520,44,55,2020,42,22,20
54521,44,56,2020,728,322,406
54522,44,84,2020,14,7,7
54523,44,98,2020,142,75,67
54524,44,157,2020,55,25,30
54525,44,158,2020,0,0,0
54526,44,110,2020,30,19,11
54527,44,85,2020,3,3,0
54528,44,99,2020,12,8,4
54529,44,32,2020,9409,4324,5085
54530,44,43,2020,41,22,19
54531,44,5,2020,22662,11647,11015
54532,44,6,2020,508,174,334
54533,44,16,2020,518,202,316
54534,44,17,2020,250,115,135
54535,44,57,2020,9070,4514,4556
54536,44,86,2020,135,94,41
54537,44,177,2020,604,408,196
54538,44,18,2020,124,56,68
54539,44,167,2020,296,162,134
54540,44,121,2020,551,320,231
54541,44,19,2020,228,94,134
54542,44,168,2020,35,19,16
54543,44,46,2020,25371,13671,11700
54544,44,20,2020,151,65,86
54545,44,149,2020,42,24,18
54546,44,159,2020,120,54,66
54547,44,143,2020,501,216,285
54548,44,70,2020,1,1,0
54549,44,47,2020,44229,22774,21455
54550,44,71,2020,177,85,92
54551,44,122,2020,12,8,4
54552,44,123,2020,85,40,45
54553,44,7,2020,1,1,0
54554,44,160,2020,30,17,13
54555,44,58,2020,426,236,190
54556,44,161,2020,7,3,4
54557,44,124,2020,3705,1624,2081
54558,44,100,2020,347,244,103
54559,44,72,2020,6,2,4
54560,44,87,2020,0,0,0
54561,44,144,2020,312,97,215
54562,44,125,2020,42,21,21
54563,44,150,2020,41,26,15
54564,44,8,2020,154,50,104
54565,44,73,2020,5708,3060,2648
54566,44,101,2020,16,9,7
54567,44,162,2020,25104,14417,10687
54568,44,60,2020,751,320,431
54569,44,48,2020,347,186,161
54570,44,21,2020,54,27,27
54571,44,9,2020,10570,3903,6667
54572,44,102,2020,16,10,6
54573,44,111,2020,28,20,8
54574,44,112,2020,144,97,47
54575,44,33,2020,146211,65610,80601
54576,44,61,2020,2848,1244,1604
54577,44,22,2020,38,19,19
54578,44,35,2020,22839,12139,10700
54579,44,36,2020,7532,4113,3419
54580,44,126,2020,89,55,34
54581,44,90,2020,1,1,0
54582,44,91,2020,6,2,4
54583,44,92,2020,1,1,0
54584,44,23,2020,490,243,247
54585,44,164,2020,23,13,10
54586,44,127,2020,11,7,4
54587,44,165,2020,223,92,131
54588,44,37,2020,13573,5711,7862
54589,44,64,2020,239,116,123
54590,44,128,2020,606,289,317
54591,44,115,2020,10299,5460,4839
54592,44,65,2020,8886,5938,2948
54593,44,10,2020,271,114,157
54594,44,145,2020,673,245,428
54595,44,113,2020,12,8,4
54596,44,49,2020,2140,1494,646
54597,44,74,2020,633,387,246
54598,44,25,2020,2937,1161,1776
54599,44,169,2020,22,13,9
54600,44,166,2020,128,53,75
54601,44,93,2020,124,81,43
54602,44,146,2020,113,22,91
54603,44,26,2020,559,135,424
54604,44,170,2020,3,3,0
54605,44,94,2020,0,0,0
54606,44,130,2020,169,95,74
54607,44,38,2020,5232,2496,2736
54608,44,27,2020,228,112,116
54609,44,50,2020,305197,149632,155565
54610,44,131,2020,142,80,62
54611,44,114,2020,61,35,26
54612,44,171,2020,105,62,43
54613,44,1,2020,727,460,267
54614,44,28,2020,34,14,20
54615,44,132,2020,388,209,179
54616,44,133,2020,3551,1925,1626
54617,45,44,2020,1567,907,660
54618,45,115,2020,821,416,405
54619,45,50,2020,34195,17228,16967
54620,17,2,2020,2464,1291,1173
54621,17,141,2020,44358,24066,20292
54622,17,12,2020,13136,6996,6140
54623,17,103,2020,38204,20273,17931
54624,17,66,2020,4916,2729,2187
54625,17,67,2020,5818,3238,2580
54626,17,105,2020,8673,4921,3752
54627,17,30,2020,16151,9044,7107
54628,17,29,2020,22449,12700,9749
54629,17,106,2020,3286,1779,1507
54630,17,172,2020,581,323,258
54631,17,107,2020,2680,1580,1100
54632,17,39,2020,1859,1261,598
54633,17,120,2020,78146,39535,38611
54634,17,42,2020,297,220,77
54635,17,68,2020,40636,22322,18314
54636,17,15,2020,9046,4854,4192
54637,17,69,2020,22971,13073,9898
54638,17,56,2020,2994,1647,1347
54639,17,32,2020,12133,6776,5357
54640,17,5,2020,18415,9655,8760
54641,17,6,2020,50808,26246,24562
54642,17,16,2020,65830,34790,31040
54643,17,57,2020,5073,2837,2236
54644,17,167,2020,13237,7255,5982
54645,17,168,2020,2444,1376,1068
54646,17,20,2020,6051,3446,2605
54647,17,46,2020,3815,2155,1660
54648,17,143,2020,16773,9233,7540
54649,17,47,2020,3756,2185,1571
54650,17,100,2020,2525,1310,1215
54651,17,144,2020,158396,83825,74571
54652,17,73,2020,4961,2924,2037
54653,17,112,2020,2368,1291,1077
54654,17,33,2020,57570,32482,25088
54655,17,35,2020,100679,56487,44192
54656,17,36,2020,111316,63816,47500
54657,17,115,2020,11381,6162,5219
54658,17,65,2020,1833,1035,798
54659,17,49,2020,667,402,265
54660,17,74,2020,3740,2201,1539
54661,17,25,2020,9207,5058,4149
54662,17,169,2020,1830,986,844
54663,17,146,2020,22860,12231,10629
54664,17,26,2020,27150,14334,12816
54665,17,170,2020,2233,1184,1049
54666,17,38,2020,131205,73340,57865
54667,17,142,2020,20489,10880,9609
54668,17,50,2020,21235,11551,9684
54669,17,114,2020,6193,3339,2854
54670,17,171,2020,21669,11608,10061
54671,17,28,2020,29975,16722,13253
54672,57,2,2020,18689,1502,17187
54673,57,51,2020,486187,241274,244913
54674,57,141,2020,22363,8387,13976
54675,57,52,2020,44,30,14
54676,57,134,2020,1917,1025,892
54677,57,76,2020,22,15,7
54678,57,103,2020,72321,38596,33725
54679,57,11,2020,1847,1157,690
54680,57,66,2020,15672,10785,4887
54681,57,12,2020,930,634,296
54682,57,78,2020,88,49,39
54683,57,13,2020,72,35,37
54684,57,3,2020,135468,33403,102065
54685,57,79,2020,52,30,22
54686,57,29,2020,13321,10479,2842
54687,57,67,2020,45918,26100,19818
54688,57,95,2020,38,13,25
54689,57,151,2020,3254,1146,2108
54690,57,4,2020,30,12,18
54691,57,53,2020,29487,14367,15120
54692,57,147,2020,54,22,32
54693,57,105,2020,133398,83348,50050
54694,57,30,2020,61805,40582,21223
54695,57,152,2020,13683,3967,9716
54696,57,116,2020,1216,684,532
54697,57,153,2020,6366,4763,1603
54698,57,135,2020,15613,7292,8321
54699,57,136,2020,578,141,437
54700,57,106,2020,12721,7388,5333
54701,57,172,2020,233338,118210,115128
54702,57,107,2020,41466,26787,14679
54703,57,117,2020,24,13,11
54704,57,137,2020,3163,1527,1636
54705,57,96,2020,1658,1016,642
54706,57,54,2020,22130,12972,9158
54707,57,81,2020,38532,29203,9329
54708,57,14,2020,440,259,181
54709,57,31,2020,9536,7796,1740
54710,57,176,2020,82,29,53
54711,57,137,2020,6874,3499,3375
54712,57,39,2020,3186,2061,1125
54713,57,118,2020,77,47,30
54714,57,82,2020,198,146,52
54715,57,83,2020,48083,32933,15150
54716,57,108,2020,83168,50943,32225
54717,57,142,2020,128857,40136,88721
54718,57,97,2020,16672,10508,6164
54719,57,138,2020,176,94,82
54720,57,119,2020,16375,8423,7952
54721,57,40,2020,1535,1288,247
54722,57,148,2020,49,30,19
54723,57,120,2020,28171,16282,11889
54724,57,42,2020,2819,2194,625
54725,57,68,2020,128283,77385,50898
54726,57,139,2020,529,265,264
54727,57,155,2020,23086,616,22470
54728,57,15,2020,15813,13170,2643
54729,57,69,2020,211223,119575,91648
54730,57,156,2020,54680,18083,36597
54731,57,56,2020,17196,8904,8292
54732,57,84,2020,12,9,3
54733,57,98,2020,2330,1445,885
54734,57,157,2020,13677,1587,12090
54735,57,158,2020,2721,309,2412
54736,57,110,2020,72,58,14
54737,57,85,2020,871,506,365
54738,57,99,2020,3225,2300,925
54739,57,32,2020,13413,10055,3358
54740,57,43,2020,204,135,69
54741,57,5,2020,167272,68187,99085
54742,57,6,2020,18529,8708,9821
54743,57,16,2020,7928,1885,6043
54744,57,44,2020,3796,2169,1627
54745,57,17,2020,4107,1733,2374
54746,57,86,2020,397,243,154
54747,57,177,2020,8967,6360,2607
54748,57,18,2020,3058,958,2100
54749,57,167,2020,4810,4038,772
54750,57,121,2020,4275,2644,1631
54751,57,19,2020,632,258,374
54752,57,168,2020,1944,1600,344
54753,57,46,2020,3688,2889,799
54754,57,20,2020,7685,2865,4820
54755,57,149,2020,30,15,15
54756,57,159,2020,1725,313,1412
54757,57,143,2020,34542,17764,16778
54758,57,70,2020,110,60,50
54759,57,47,2020,6317,4875,1442
54760,57,71,2020,4648,2552,2096
54761,57,122,2020,2700,1914,786
54762,57,123,2020,194,114,80
54763,57,7,2020,35,9,26
54764,57,160,2020,21057,821,20236
54765,57,58,2020,1984,1412,572
54766,57,161,2020,849,181,668
54767,57,124,2020,8680,4973,3707
54768,57,100,2020,9884,6849,3035
54769,57,72,2020,1589,853,736
54770,57,59,2020,2240,1287,953
54771,57,144,2020,451960,207832,244128
54772,57,125,2020,922,590,332
54773,57,150,2020,89,46,43
54774,57,8,2020,2437,1021,1416
54775,57,73,2020,13214,8119,5095
54776,57,101,2020,1381,937,444
54777,57,162,2020,103462,42160,61302
54778,57,60,2020,68840,31364,37476
54779,57,48,2020,1825,1127,698
54780,57,21,2020,68,38,30
54781,57,9,2020,124800,35243,89557
54782,57,102,2020,1102,797,305
54783,57,111,2020,2886,2023,863
54784,57,112,2020,116408,72081,44327
54785,57,33,2020,113874,87788,26086
54786,57,61,2020,6735,4314,2421
54787,57,22,2020,147,75,72
54788,57,35,2020,1048862,629543,419319
54789,57,36,2020,82890,63663,19227
54790,57,126,2020,862,478,384
54791,57,90,2020,4,3,1
54792,57,91,2020,23,13,10
54793,57,92,2020,14,10,4
54794,57,62,2020,1932,1153,779
54795,57,140,2020,81,57,24
54796,57,23,2020,1237,576,661
54797,57,164,2020,113444,25819,87625
54798,57,63,2020,86911,43697,43214
54799,57,127,2020,940,741,199
54800,57,165,2020,2451,640,1811
54801,57,37,2020,10611,8207,2404
54802,57,64,2020,4693,2878,1815
54803,57,128,2020,14473,5525,8948
54804,57,115,2020,5834,3342,2492
54805,57,129,2020,41,12,29
54806,57,65,2020,35124,23816,11308
54807,57,10,2020,95811,44006,51805
54808,57,145,2020,3039,728,2311
54809,57,113,2020,40,26,14
54810,57,49,2020,6228,4184,2044
54811,57,74,2020,193568,104023,89545
54812,57,25,2020,8276,3239,5037
54813,57,169,2020,264,210,54
54814,57,166,2020,6547,2122,4425
54815,57,93,2020,172,127,45
54816,57,146,2020,108129,41406,66723
54817,57,26,2020,20513,8974,11539
54818,57,170,2020,283,236,47
54819,57,130,2020,1137,653,484
54820,57,38,2020,248460,194023,54437
54821,57,27,2020,665,311,354
54822,57,50,2020,66500,38374,28126
54823,57,131,2020,1845,1062,783
54824,57,114,2020,7383,4183,3200
54825,57,171,2020,2726,2237,489
54826,57,1,2020,6077,3535,2542
54827,57,28,2020,395,170,225
54828,57,132,2020,895,478,417
54829,57,133,2020,922,495,427
54830,86,76,2020,154,77,77
54831,86,78,2020,674,341,333
54832,86,79,2020,541,273,268
54833,86,95,2020,7,4,3
54834,86,96,2020,100,55,45
54835,86,81,2020,1825,914,911
54836,86,82,2020,138,69,69
54837,86,97,2020,133,74,59
54838,86,84,2020,207,106,101
54839,86,98,2020,307,171,136
54840,86,99,2020,162,92,70
54841,86,5,2020,1148,428,720
54842,86,101,2020,124,69,55
54843,86,102,2020,74,41,33
54844,86,90,2020,97,49,48
54845,86,91,2020,334,167,167
54846,86,92,2020,226,115,111
54847,86,93,2020,2343,1182,1161
54848,86,50,2020,4832,2466,2366
54849,177,103,2020,3629,2010,1619
54850,177,66,2020,680,375,305
54851,177,3,2020,15702,8696,7006
54852,177,67,2020,850,469,381
54853,177,105,2020,204814,102190,102624
54854,177,172,2020,775893,409099,366794
54855,177,39,2020,712,393,319
54856,177,142,2020,1959,1084,875
54857,177,42,2020,841,465,376
54858,177,68,2020,13550,7505,6045
54859,177,69,2020,7477,4142,3335
54860,177,156,2020,2375,1314,1061
54861,177,5,2020,35936,19906,16030
54862,177,6,2020,5411,2997,2414
54863,177,44,2020,1415,783,632
54864,177,57,2020,4494,2488,2006
54865,177,100,2020,2735,1513,1222
54866,177,73,2020,1298,717,581
54867,177,162,2020,3069,1698,1371
54868,177,48,2020,566,312,254
54869,177,9,2020,16434,9102,7332
54870,177,112,2020,49068,27182,21886
54871,177,33,2020,1649,912,737
54872,177,61,2020,579,319,260
54873,177,36,2020,9118,5050,4068
54874,177,65,2020,3417,1892,1525
54875,177,10,2020,25781,14278,11503
54876,177,49,2020,1782,987,795
54877,177,74,2020,1315,728,587
54878,177,50,2020,18205,10083,8122
54879,177,1,2020,335668,175042,160626
54880,18,2,2020,61,24,37
54881,18,141,2020,345,206,139
54882,18,66,2020,116,49,67
54883,18,13,2020,427,168,259
54884,18,3,2020,11693,3335,8358
54885,18,11,2020,25,18,7
54886,18,67,2020,71,36,35
54887,18,53,2020,59,32,27
54888,18,105,2020,105,55,50
54889,18,30,2020,49,28,21
54890,18,10,2020,12559,11423,1136
54891,18,136,2020,25,5,20
54892,18,172,2020,20896,15340,5556
54893,18,107,2020,24,15,9
54894,18,54,2020,25,19,6
54895,18,14,2020,131,69,62
54896,18,31,2020,23,15,8
54897,18,39,2020,49,23,26
54898,18,120,2020,75,70,5
54899,18,119,2020,73,32,41
54900,18,68,2020,396,194,202
54901,18,69,2020,719,341,378
54902,18,156,2020,26,8,18
54903,18,56,2020,60,39,21
54904,18,173,2020,37,15,22
54905,18,32,2020,589,336,253
54906,18,5,2020,5945,765,5180
54907,18,6,2020,93,46,47
54908,18,16,2020,206047,97841,108206
54909,18,44,2020,51,29,22
54910,18,17,2020,1578,528,1050
54911,18,57,2020,309,164,145
54912,18,177,2020,103,35,68
54913,18,167,2020,19,13,6
54914,18,176,2020,83,24,59
54915,18,19,2020,755,219,536
54916,18,20,2020,1849,1034,815
54917,18,143,2020,19564,6773,12791
54918,18,161,2020,69,15,54
54919,18,144,2020,601,471,130
54920,18,21,2020,639,333,306
54921,18,8,2020,182,76,106
54922,18,73,2020,199,101,98
54923,18,162,2020,25,8,17
54924,18,48,2020,43,23,20
54925,18,9,2020,3273,1349,1924
54926,18,33,2020,80,49,31
54927,18,22,2020,224,58,166
54928,18,35,2020,270,216,54
54929,18,36,2020,599,446,153
54930,18,23,2020,5064,1667,3397
54931,18,63,2020,57,48,9
54932,18,37,2020,22,15,7
54933,18,128,2020,764,340,424
54934,18,115,2020,57,19,38
54935,18,65,2020,306,181,125
54936,18,129,2020,277,98,179
54937,18,145,2020,6010,2679,3331
54938,18,49,2020,89,50,39
54939,18,74,2020,199,99,100
54940,18,25,2020,698701,345606,353095
54941,18,27,2020,211,87,124
54942,18,146,2020,259,128,131
54943,18,26,2020,1031,260,771
54944,18,38,2020,397,342,55
54945,18,60,2020,87,62,25
54946,18,142,2020,101340,35087,66253
54947,18,50,2020,813,351,462
54948,18,28,2020,29708,11756,17952
54949,167,12,2020,50912,22334,28578
54950,167,11,2020,9622,3936,5686
54951,167,29,2020,72761,36239,36522
54952,167,172,2020,2274,983,1291
54953,167,40,2020,1170,614,556
54954,167,15,2020,3445,1290,2155
54955,167,176,2020,64829,31440,33389
54956,167,168,2020,7085,3690,3395
54957,167,46,2020,1170,551,619
54958,167,47,2020,4615,2091,2524
54959,167,36,2020,2476018,1271361,1204657
54960,167,169,2020,16644,7505,9139
54961,167,26,2020,49353,23071,26282
54962,167,170,2020,1104,429,675
54963,167,38,2020,355751,179848,175903
54964,167,171,2020,296511,139344,157167
54965,121,116,2020,15098,7469,7629
54966,121,137,2020,43577,21565,22012
54967,121,120,2020,32115,14525,17590
54968,121,119,2020,1851,922,929
54969,121,125,2020,523,260,263
54970,121,150,2020,58,29,29
54971,121,126,2020,5510,2745,2765
54972,121,128,2020,425284,205263,220021
54973,121,115,2020,96,49,47
54974,121,129,2020,121553,60151,61402
54975,121,145,2020,9926,4910,5016
54976,121,130,2020,290597,151658,138939
54977,121,131,2020,34767,17330,17437
54978,19,2,2020,2896,1146,1750
54979,19,13,2020,1407,1020,387
54980,19,3,2020,380046,63188,316858
54981,19,10,2020,39667,22448,17219
54982,19,136,2020,1414,560,854
54983,19,120,2020,3899,1544,2355
54984,19,119,2020,5127,2031,3096
54985,19,68,2020,5218,2447,2771
54986,19,5,2020,1152175,340004,812171
54987,19,18,2020,54688,24184,30504
54988,19,20,2020,12512,4959,7553
54989,19,144,2020,3032,1201,1831
54990,19,8,2020,24607,9763,14844
54991,19,73,2020,1062,519,543
54992,19,162,2020,4817,1909,2908
54993,19,9,2020,339033,95905,243128
54994,19,22,2020,674,543,131
54995,19,23,2020,2252,867,1385
54996,19,128,2020,3436,1360,2076
54997,19,129,2020,1871,831,1040
54998,19,145,2020,49399,21935,27464
54999,19,25,2020,23156,9182,13974
55000,19,27,2020,26760,15594,11166
55001,19,146,2020,1935,766,1169
55002,19,26,2020,13342,5288,8054
55003,19,142,2020,421025,177593,243432
55004,19,50,2020,10191,4404,5787
55005,19,28,2020,70672,28025,42647
55006,168,12,2020,4554,2261,2293
55007,168,11,2020,2315,1133,1182
55008,168,29,2020,9684,6101,3583
55009,168,172,2020,262,130,132
55010,168,40,2020,557,328,229
55011,168,42,2020,111,47,64
55012,168,15,2020,3183,1656,1527
55013,168,69,2020,1771,1035,736
55014,168,167,2020,12599,7739,4860
55015,168,176,2020,1729,966,763
55016,168,46,2020,877,511,366
55017,168,47,2020,2578,1516,1062
55018,168,33,2020,3126,1946,1180
55019,168,35,2020,468,256,212
55020,168,36,2020,108854,65756,43098
55021,168,1,2020,102,37,65
55022,168,169,2020,2146,1109,1037
55023,168,26,2020,1021,537,484
55024,168,170,2020,973,563,410
55025,168,38,2020,26066,15908,10158
55026,168,171,2020,8940,5030,3910
55027,46,2,2020,46,20,26
55028,46,51,2020,12,6,6
55029,46,141,2020,18,4,14
55030,46,52,2020,0,0,0
55031,46,134,2020,0,0,0
55032,46,75,2020,0,0,0
55033,46,76,2020,0,0,0
55034,46,103,2020,22,8,14
55035,46,11,2020,708,294,414
55036,46,77,2020,0,0,0
55037,46,66,2020,101,39,62
55038,46,12,2020,1953,789,1164
55039,46,13,2020,0,0,0
55040,46,3,2020,15,4,11
55041,46,79,2020,2,2,0
55042,46,29,2020,42251,27803,14448
55043,46,67,2020,123,57,66
55044,46,151,2020,1,0,1
55045,46,53,2020,9,0,9
55046,46,147,2020,0,0,0
55047,46,105,2020,46,13,33
55048,46,30,2020,112,30,82
55049,46,116,2020,0,0,0
55050,46,153,2020,0,0,0
55051,46,135,2020,4,0,4
55052,46,106,2020,7,0,7
55053,46,172,2020,369,161,208
55054,46,107,2020,13,7,6
55055,46,137,2020,0,0,0
55056,46,96,2020,0,0,0
55057,46,54,2020,8,2,6
55058,46,81,2020,46,17,29
55059,46,14,2020,59,26,33
55060,46,31,2020,159,102,57
55061,46,176,2020,10,5,5
55062,46,137,2020,4,0,4
55063,46,39,2020,238,51,187
55064,46,83,2020,0,0,0
55065,46,108,2020,3,3,0
55066,46,142,2020,80,16,64
55067,46,119,2020,5,0,5
55068,46,40,2020,2847,1539,1308
55069,46,41,2020,1,0,1
55070,46,42,2020,151,63,88
55071,46,68,2020,279,113,166
55072,46,139,2020,0,0,0
55073,46,155,2020,1,0,1
55074,46,15,2020,1285,566,719
55075,46,69,2020,2163,1114,1049
55076,46,156,2020,7,0,7
55077,46,56,2020,51,18,33
55078,46,98,2020,1,0,1
55079,46,32,2020,183,99,84
55080,46,43,2020,53,20,33
55081,46,5,2020,1290,165,1125
55082,46,6,2020,46,14,32
55083,46,16,2020,52,21,31
55084,46,44,2020,936,392,544
55085,46,17,2020,108,43,65
55086,46,57,2020,328,88,240
55087,46,86,2020,2,0,2
55088,46,177,2020,27,14,13
55089,46,18,2020,4,0,4
55090,46,167,2020,5651,3090,2561
55091,46,121,2020,4,0,4
55092,46,19,2020,5,0,5
55093,46,168,2020,757,426,331
55094,46,20,2020,39,5,34
55095,46,143,2020,4,2,2
55096,46,70,2020,0,0,0
55097,46,47,2020,14209,8779,5430
55098,46,71,2020,10,5,5
55099,46,122,2020,0,0,0
55100,46,123,2020,0,0,0
55101,46,160,2020,0,0,0
55102,46,58,2020,23,10,13
55103,46,161,2020,0,0,0
55104,46,124,2020,4,2,2
55105,46,100,2020,26,7,19
55106,46,72,2020,0,0,0
55107,46,59,2020,1,0,1
55108,46,144,2020,24,4,20
55109,46,125,2020,0,0,0
55110,46,150,2020,0,0,0
55111,46,8,2020,45,10,35
55112,46,73,2020,161,49,112
55113,46,101,2020,0,0,0
55114,46,162,2020,22,5,17
55115,46,60,2020,17,5,12
55116,46,48,2020,443,176,267
55117,46,9,2020,228,24,204
55118,46,111,2020,0,0,0
55119,46,112,2020,9,3,6
55120,46,33,2020,767,425,342
55121,46,61,2020,42,11,31
55122,46,22,2020,5,3,2
55123,46,35,2020,71,32,39
55124,46,36,2020,116771,73684,43087
55125,46,126,2020,1,0,1
55126,46,23,2020,13,3,10
55127,46,63,2020,22,6,16
55128,46,165,2020,0,0,0
55129,46,37,2020,36,14,22
55130,46,64,2020,12,6,6
55131,46,128,2020,3,0,3
55132,46,115,2020,23,9,14
55133,46,129,2020,0,0,0
55134,46,65,2020,220,78,142
55135,46,10,2020,173,48,125
55136,46,145,2020,5,0,5
55137,46,49,2020,272,90,182
55138,46,74,2020,97,30,67
55139,46,25,2020,63,15,48
55140,46,169,2020,565,275,290
55141,46,166,2020,0,0,0
55142,46,93,2020,0,0,0
55143,46,146,2020,4,0,4
55144,46,26,2020,229,48,181
55145,46,170,2020,552,299,253
55146,46,130,2020,1,1,0
55147,46,38,2020,32262,16917,15345
55148,46,27,2020,33,9,24
55149,46,50,2020,3712,1550,2162
55150,46,131,2020,2,0,2
55151,46,114,2020,3,2,1
55152,46,171,2020,2569,1160,1409
55153,46,1,2020,83,46,37
55154,46,28,2020,0,0,0
55155,46,132,2020,0,0,0
55156,46,133,2020,2,0,2
55157,20,13,2020,93,46,47
55158,20,3,2020,2582,1320,1262
55159,20,10,2020,2771,1418,1353
55160,20,172,2020,2058,1052,1006
55161,20,68,2020,87,44,43
55162,20,69,2020,159,81,78
55163,20,32,2020,129,66,63
55164,20,5,2020,1311,670,641
55165,20,16,2020,102319,52349,49970
55166,20,17,2020,348,177,171
55167,20,18,2020,408,208,200
55168,20,19,2020,166,84,82
55169,20,143,2020,214,110,104
55170,20,144,2020,132,67,65
55171,20,21,2020,140,72,68
55172,20,9,2020,721,369,352
55173,20,36,2020,132,67,65
55174,20,23,2020,1116,571,545
55175,20,129,2020,61,30,31
55176,20,145,2020,2201,1117,1084
55177,20,25,2020,1042785,530258,512527
55178,20,26,2020,226,115,111
55179,20,38,2020,87,44,43
55180,20,142,2020,70643,36143,34500
55181,20,50,2020,179,90,89
55182,20,28,2020,528,269,259
55183,149,147,2020,198,110,88
55184,149,172,2020,221,95,126
55185,149,156,2020,163,53,110
55186,149,5,2020,419,185,234
55187,149,123,2020,67,25,42
55188,149,125,2020,42,12,30
55189,149,150,2020,6,1,5
55190,149,9,2020,419,185,234
55191,149,115,2020,4782,2317,2465
55192,149,133,2020,127,59,68
55193,149,148,2020,67,34,33
55194,149,130,2020,251,111,140
55195,149,131,2020,155,76,79
55196,149,132,2020,127,59,68
55197,159,151,2020,20,2,18
55198,159,68,2020,51,27,24
55199,159,155,2020,630,276,354
55200,159,69,2020,162,90,72
55201,159,156,2020,7524,3392,4132
55202,159,157,2020,26978,12025,14953
55203,159,5,2020,631,94,537
55204,159,57,2020,43,18,25
55205,159,20,2020,771,217,554
55206,159,160,2020,1122,466,656
55207,159,73,2020,52,27,25
55208,159,162,2020,4366,963,3403
55209,159,158,2020,401,252,149
55210,159,164,2020,302,91,211
55211,159,165,2020,16853,7641,9212
55212,159,65,2020,49,25,24
55213,159,49,2020,199,107,92
55214,159,74,2020,25,12,13
55215,159,166,2020,321,111,210
55216,159,50,2020,202,108,94
55217,159,152,2020,195,50,145
55218,143,2,2020,340,92,248
55219,143,51,2020,320,96,224
55220,143,141,2020,3830,1599,2231
55221,143,66,2020,801,364,437
55222,143,13,2020,1032,241,791
55223,143,3,2020,1334,59,1275
55224,143,11,2020,270,96,174
55225,143,67,2020,720,280,440
55226,143,53,2020,351,104,247
55227,143,105,2020,270,104,166
55228,143,29,2020,811,313,498
55229,143,10,2020,391,146,245
55230,143,136,2020,918,227,691
55231,143,172,2020,3280,898,2382
55232,143,117,2020,4584,616,3968
55233,143,137,2020,429,104,325
55234,143,137,2020,463,100,363
55235,143,39,2020,821,254,567
55236,143,97,2020,754,259,495
55237,143,120,2020,1952,690,1262
55238,143,119,2020,5501,1703,3798
55239,143,42,2020,885,316,569
55240,143,68,2020,5364,1820,3544
55241,143,118,2020,1519,394,1125
55242,143,69,2020,7503,2975,4528
55243,143,156,2020,655,125,530
55244,143,56,2020,2792,1106,1686
55245,143,32,2020,360,160,200
55246,143,5,2020,5167,1138,4029
55247,143,6,2020,439,108,331
55248,143,16,2020,73093,22833,50260
55249,143,57,2020,7141,2628,4513
55250,143,177,2020,1072,374,698
55251,143,167,2020,855,160,695
55252,143,18,2020,21783,6146,15637
55253,143,121,2020,357,116,241
55254,143,19,2020,11527,2383,9144
55255,143,20,2020,11812,4318,7494
55256,143,160,2020,360,79,281
55257,143,161,2020,380,77,303
55258,143,72,2020,293,91,202
55259,143,144,2020,5229,2521,2708
55260,143,21,2020,1806,360,1446
55261,143,73,2020,1890,789,1101
55262,143,162,2020,3041,678,2363
55263,143,48,2020,357,130,227
55264,143,9,2020,2625,643,1982
55265,143,33,2020,723,373,350
55266,143,158,2020,329,0,329
55267,143,22,2020,1508,328,1180
55268,143,35,2020,636,321,315
55269,143,36,2020,7734,2705,5029
55270,143,23,2020,37866,8721,29145
55271,143,164,2020,1195,151,1044
55272,143,165,2020,251,77,174
55273,143,128,2020,111588,30003,81585
55274,143,115,2020,690,195,495
55275,143,65,2020,774,287,487
55276,143,129,2020,1896,531,1365
55277,143,145,2020,15400,4333,11067
55278,143,49,2020,797,251,546
55279,143,74,2020,993,408,585
55280,143,25,2020,44450,12563,31887
55281,143,169,2020,723,151,572
55282,143,27,2020,2961,874,2087
55283,143,146,2020,3292,1210,2082
55284,143,26,2020,2704,661,2043
55285,143,170,2020,251,52,199
55286,143,38,2020,933,429,504
55287,143,142,2020,22420,6344,16076
55288,143,50,2020,7719,2682,5037
55289,143,131,2020,281,70,211
55290,143,171,2020,2122,844,1278
55291,143,28,2020,6323,2493,3830
55292,70,2,2020,6,3,3
55293,70,51,2020,2,2,0
55294,70,141,2020,6,4,2
55295,70,52,2020,0,0,0
55296,70,134,2020,7,2,5
55297,70,103,2020,24,14,10
55298,70,11,2020,9,5,4
55299,70,66,2020,3983,2270,1713
55300,70,12,2020,0,0,0
55301,70,78,2020,2,1,1
55302,70,3,2020,6,2,4
55303,70,29,2020,3,3,0
55304,70,67,2020,43,25,18
55305,70,53,2020,299,177,122
55306,70,105,2020,201,141,60
55307,70,30,2020,20,15,5
55308,70,152,2020,1,1,0
55309,70,135,2020,3,1,2
55310,70,106,2020,6,6,0
55311,70,172,2020,113,66,47
55312,70,107,2020,43,33,10
55313,70,96,2020,4,3,1
55314,70,54,2020,115,59,56
55315,70,81,2020,10,6,4
55316,70,31,2020,63,46,17
55317,70,137,2020,4,1,3
55318,70,39,2020,15,7,8
55319,70,83,2020,92,68,24
55320,70,108,2020,12,9,3
55321,70,142,2020,19,6,13
55322,70,97,2020,1,1,0
55323,70,119,2020,16,9,7
55324,70,40,2020,1,1,0
55325,70,120,2020,9,4,5
55326,70,42,2020,8,5,3
55327,70,68,2020,129,63,66
55328,70,155,2020,0,0,0
55329,70,15,2020,2,2,0
55330,70,69,2020,1911,978,933
55331,70,56,2020,47,20,27
55332,70,98,2020,0,0,0
55333,70,157,2020,0,0,0
55334,70,85,2020,0,0,0
55335,70,99,2020,0,0,0
55336,70,32,2020,80,56,24
55337,70,43,2020,0,0,0
55338,70,5,2020,27,10,17
55339,70,6,2020,13,6,7
55340,70,16,2020,10,4,6
55341,70,44,2020,18,9,9
55342,70,17,2020,3,3,0
55343,70,57,2020,861,313,548
55344,70,86,2020,1,1,0
55345,70,177,2020,18,8,10
55346,70,18,2020,5,3,2
55347,70,167,2020,9,5,4
55348,70,121,2020,8,5,3
55349,70,19,2020,0,0,0
55350,70,168,2020,3,3,0
55351,70,46,2020,7,6,1
55352,70,143,2020,0,0,0
55353,70,47,2020,3,3,0
55354,70,71,2020,2,2,0
55355,70,122,2020,1,0,1
55356,70,7,2020,1,0,1
55357,70,58,2020,3,2,1
55358,70,124,2020,1,1,0
55359,70,100,2020,32,22,10
55360,70,72,2020,0,0,0
55361,70,59,2020,5,2,3
55362,70,144,2020,15,10,5
55363,70,125,2020,2,1,1
55364,70,8,2020,1,0,1
55365,70,73,2020,80,46,34
55366,70,101,2020,3,3,0
55367,70,162,2020,6,2,4
55368,70,60,2020,95,52,43
55369,70,48,2020,7,5,2
55370,70,9,2020,7,2,5
55371,70,102,2020,6,4,2
55372,70,111,2020,2,2,0
55373,70,112,2020,14,8,6
55374,70,33,2020,76,53,23
55375,70,61,2020,424,202,222
55376,70,35,2020,37,29,8
55377,70,36,2020,69,51,18
55378,70,91,2020,0,0,0
55379,70,164,2020,2,1,1
55380,70,63,2020,428,212,216
55381,70,127,2020,0,0,0
55382,70,37,2020,55,43,12
55383,70,64,2020,107,81,26
55384,70,128,2020,24,10,14
55385,70,115,2020,30,19,11
55386,70,65,2020,267,123,144
55387,70,10,2020,8,3,5
55388,70,49,2020,25,16,9
55389,70,74,2020,14437,7021,7416
55390,70,25,2020,32,15,17
55391,70,93,2020,1,1,0
55392,70,146,2020,22,11,11
55393,70,26,2020,581,284,297
55394,70,130,2020,0,0,0
55395,70,38,2020,61,44,17
55396,70,27,2020,2,0,2
55397,70,50,2020,65,28,37
55398,70,131,2020,2,1,1
55399,70,114,2020,0,0,0
55400,70,171,2020,3,1,2
55401,70,1,2020,13,9,4
55402,70,132,2020,0,0,0
55403,70,133,2020,4,3,1
55404,47,2,2020,41,19,22
55405,47,51,2020,28,14,14
55406,47,141,2020,11,3,8
55407,47,134,2020,2,0,2
55408,47,103,2020,65,28,37
55409,47,11,2020,427,155,272
55410,47,77,2020,1,0,1
55411,47,66,2020,80,32,48
55412,47,12,2020,690,262,428
55413,47,78,2020,0,0,0
55414,47,13,2020,5,4,1
55415,47,3,2020,44,3,41
55416,47,29,2020,33813,18444,15369
55417,47,67,2020,272,92,180
55418,47,95,2020,0,0,0
55419,47,151,2020,0,0,0
55420,47,53,2020,2,0,2
55421,47,105,2020,77,41,36
55422,47,30,2020,140,39,101
55423,47,135,2020,30,8,22
55424,47,106,2020,4,2,2
55425,47,172,2020,191,143,48
55426,47,107,2020,19,12,7
55427,47,137,2020,6,2,4
55428,47,54,2020,35,8,27
55429,47,81,2020,14,9,5
55430,47,14,2020,51,21,30
55431,47,31,2020,120,58,62
55432,47,176,2020,6,5,1
55433,47,137,2020,3,2,1
55434,47,39,2020,605,229,376
55435,47,82,2020,0,0,0
55436,47,108,2020,5,2,3
55437,47,142,2020,86,19,67
55438,47,119,2020,30,9,21
55439,47,40,2020,822,441,381
55440,47,120,2020,2,0,2
55441,47,42,2020,164,64,100
55442,47,68,2020,519,185,334
55443,47,155,2020,0,0,0
55444,47,15,2020,488,241,247
55445,47,69,2020,2090,928,1162
55446,47,156,2020,8,0,8
55447,47,56,2020,103,30,73
55448,47,157,2020,1,0,1
55449,47,110,2020,1,0,1
55450,47,99,2020,1,0,1
55451,47,32,2020,140,63,77
55452,47,43,2020,57,32,25
55453,47,5,2020,567,133,434
55454,47,6,2020,60,22,38
55455,47,16,2020,55,20,35
55456,47,44,2020,1790,842,948
55457,47,17,2020,146,74,72
55458,47,57,2020,643,170,473
55459,47,86,2020,0,0,0
55460,47,177,2020,23,13,10
55461,47,18,2020,8,5,3
55462,47,167,2020,4248,2267,1981
55463,47,121,2020,8,3,5
55464,47,19,2020,5,2,3
55465,47,168,2020,347,181,166
55466,47,46,2020,5722,3129,2593
55467,47,20,2020,14,9,5
55468,47,159,2020,5,3,2
55469,47,143,2020,5,0,5
55470,47,71,2020,24,6,18
55471,47,122,2020,6,5,1
55472,47,123,2020,0,0,0
55473,47,7,2020,1,0,1
55474,47,160,2020,1,0,1
55475,47,58,2020,19,8,11
55476,47,161,2020,0,0,0
55477,47,124,2020,2,0,2
55478,47,100,2020,33,0,33
55479,47,72,2020,0,0,0
55480,47,144,2020,14,5,9
55481,47,125,2020,1,0,1
55482,47,150,2020,1,0,1
55483,47,8,2020,15,2,13
55484,47,73,2020,310,93,217
55485,47,101,2020,1,0,1
55486,47,162,2020,5,2,3
55487,47,60,2020,7,6,1
55488,47,48,2020,2763,1248,1515
55489,47,21,2020,5,2,3
55490,47,9,2020,7,4,3
55491,47,111,2020,0,0,0
55492,47,112,2020,11,6,5
55493,47,33,2020,1900,1054,846
55494,47,61,2020,128,31,97
55495,47,22,2020,8,7,1
55496,47,35,2020,360,49,311
55497,47,36,2020,51718,29433,22285
55498,47,126,2020,1,0,1
55499,47,23,2020,14,11,3
55500,47,63,2020,13,0,13
55501,47,37,2020,71,34,37
55502,47,64,2020,10,2,8
55503,47,128,2020,1,0,1
55504,47,115,2020,25,10,15
55505,47,65,2020,833,345,488
55506,47,10,2020,61,56,5
55507,47,145,2020,2,0,2
55508,47,113,2020,0,0,0
55509,47,49,2020,555,237,318
55510,47,74,2020,100,37,63
55511,47,25,2020,431,196,235
55512,47,169,2020,361,184,177
55513,47,166,2020,0,0,0
55514,47,146,2020,8,2,6
55515,47,26,2020,233,72,161
55516,47,170,2020,207,118,89
55517,47,130,2020,0,0,0
55518,47,38,2020,20566,6012,14554
55519,47,27,2020,61,24,37
55520,47,50,2020,6620,3127,3493
55521,47,131,2020,1,1,0
55522,47,114,2020,17,11,6
55523,47,171,2020,809,420,389
55524,47,1,2020,40,17,23
55525,47,132,2020,0,0,0
55526,47,133,2020,5,2,3
55527,71,2,2020,433,138,295
55528,71,51,2020,1058,541,517
55529,71,141,2020,1113,506,607
55530,71,52,2020,38,18,20
55531,71,134,2020,1061,522,539
55532,71,76,2020,2,0,2
55533,71,103,2020,407,225,182
55534,71,11,2020,120,74,46
55535,71,77,2020,1,1,0
55536,71,66,2020,1026,572,454
55537,71,12,2020,192,90,102
55538,71,78,2020,8,3,5
55539,71,13,2020,9,6,3
55540,71,3,2020,142,50,92
55541,71,79,2020,6,3,3
55542,71,29,2020,324,252,72
55543,71,67,2020,21583,9878,11705
55544,71,151,2020,131,35,96
55545,71,4,2020,1,0,1
55546,71,53,2020,2732,1355,1377
55547,71,147,2020,1,1,0
55548,71,105,2020,3722,2283,1439
55549,71,30,2020,1710,1048,662
55550,71,152,2020,69,32,37
55551,71,116,2020,98,57,41
55552,71,153,2020,7108,3740,3368
55553,71,135,2020,1234,636,598
55554,71,136,2020,12,5,7
55555,71,106,2020,217,116,101
55556,71,172,2020,4295,2364,1931
55557,71,107,2020,515,295,220
55558,71,117,2020,16,10,6
55559,71,137,2020,299,144,155
55560,71,96,2020,29,16,13
55561,71,54,2020,874,446,428
55562,71,81,2020,180,120,60
55563,71,14,2020,144,71,73
55564,71,31,2020,1061,648,413
55565,71,176,2020,15,9,6
55566,71,137,2020,923,464,459
55567,71,39,2020,1598,771,827
55568,71,118,2020,10,6,4
55569,71,82,2020,2,2,0
55570,71,83,2020,514,364,150
55571,71,108,2020,202,126,76
55572,71,142,2020,347,145,202
55573,71,97,2020,47,27,20
55574,71,138,2020,8,7,1
55575,71,119,2020,701,252,449
55576,71,40,2020,597,413,184
55577,71,148,2020,1,1,0
55578,71,120,2020,244,121,123
55579,71,42,2020,1154,649,505
55580,71,68,2020,42979,20197,22782
55581,71,139,2020,81,49,32
55582,71,155,2020,76,26,50
55583,71,15,2020,97,61,36
55584,71,69,2020,17080,9043,8037
55585,71,156,2020,67,34,33
55586,71,55,2020,1,1,0
55587,71,56,2020,3163,1568,1595
55588,71,84,2020,2,2,0
55589,71,98,2020,120,71,49
55590,71,157,2020,419,136,283
55591,71,158,2020,1516,567,949
55592,71,110,2020,11,8,3
55593,71,85,2020,77,32,45
55594,71,99,2020,24,20,4
55595,71,32,2020,1818,1048,770
55596,71,43,2020,413,208,205
55597,71,5,2020,2791,1275,1516
55598,71,6,2020,1074,497,577
55599,71,16,2020,1028,383,645
55600,71,44,2020,1429,676,753
55601,71,17,2020,236,109,127
55602,71,57,2020,18878,7876,11002
55603,71,86,2020,30,15,15
55604,71,177,2020,588,358,230
55605,71,18,2020,47,18,29
55606,71,167,2020,207,151,56
55607,71,121,2020,111,58,53
55608,71,19,2020,47,18,29
55609,71,168,2020,47,32,15
55610,71,46,2020,657,456,201
55611,71,20,2020,341,124,217
55612,71,159,2020,39,9,30
55613,71,143,2020,80,35,45
55614,71,70,2020,8,4,4
55615,71,47,2020,888,588,300
55616,71,122,2020,195,127,68
55617,71,123,2020,11,7,4
55618,71,160,2020,79,30,49
55619,71,58,2020,244,120,124
55620,71,161,2020,11,1,10
55621,71,124,2020,434,236,198
55622,71,100,2020,424,245,179
55623,71,72,2020,50,16,34
55624,71,59,2020,2715,1320,1395
55625,71,144,2020,2499,1255,1244
55626,71,125,2020,339,183,156
55627,71,150,2020,14,9,5
55628,71,8,2020,362,164,198
55629,71,73,2020,3986,1841,2145
55630,71,101,2020,17,10,7
55631,71,162,2020,327,115,212
55632,71,60,2020,605,308,297
55633,71,48,2020,262,126,136
55634,71,21,2020,5,3,2
55635,71,9,2020,279,110,169
55636,71,102,2020,24,17,7
55637,71,111,2020,33,26,7
55638,71,112,2020,528,312,216
55639,71,33,2020,5051,2939,2112
55640,71,61,2020,75221,35737,39484
55641,71,22,2020,9,3,6
55642,71,35,2020,5225,3112,2113
55643,71,36,2020,2780,1847,933
55644,71,126,2020,188,107,81
55645,71,92,2020,1,1,0
55646,71,62,2020,3,2,1
55647,71,140,2020,166,81,85
55648,71,23,2020,59,16,43
55649,71,164,2020,703,325,378
55650,71,63,2020,3682,1816,1866
55651,71,127,2020,9,7,2
55652,71,165,2020,20,6,14
55653,71,37,2020,869,534,335
55654,71,64,2020,599,344,255
55655,71,128,2020,77,34,43
55656,71,115,2020,659,308,351
55657,71,65,2020,5651,2778,2873
55658,71,10,2020,85,39,46
55659,71,145,2020,102,13,89
55660,71,113,2020,21,12,9
55661,71,49,2020,1460,703,757
55662,71,74,2020,1375,658,717
55663,71,25,2020,1839,787,1052
55664,71,169,2020,22,17,5
55665,71,166,2020,460,189,271
55666,71,93,2020,22,14,8
55667,71,146,2020,1212,429,783
55668,71,26,2020,1435,656,779
55669,71,170,2020,19,11,8
55670,71,130,2020,35,19,16
55671,71,38,2020,1471,1029,442
55672,71,27,2020,77,35,42
55673,71,50,2020,5633,2429,3204
55674,71,131,2020,24,16,8
55675,71,114,2020,91,48,43
55676,71,171,2020,119,76,43
55677,71,1,2020,570,346,224
55678,71,28,2020,19,6,13
55679,71,132,2020,21,13,8
55680,71,133,2020,71,38,33
55681,174,172,2020,300567,159222,141345
55682,174,173,2020,22512,9056,13456
55683,174,61,2020,2101,981,1120
55684,122,172,2020,2193,959,1234
55685,122,117,2020,12153,5236,6917
55686,122,68,2020,9922,4264,5658
55687,122,5,2020,1751,753,998
55688,123,116,2020,10079,4210,5869
55689,123,137,2020,1033,471,562
55690,123,137,2020,27773,12845,14928
55691,123,5,2020,1770,816,954
55692,123,125,2020,40131,19234,20897
55693,123,126,2020,6280,3049,3231
55694,123,128,2020,102,44,58
55695,123,115,2020,6054,3351,2703
55696,123,50,2020,1081,523,558
55697,123,131,2020,7041,3918,3123
55698,123,132,2020,31375,18602,12773
55699,123,133,2020,27221,15356,11865
55700,7,66,2020,23,2,21
55701,7,3,2020,40390,519,39871
55702,7,10,2020,7383,1027,6356
55703,7,68,2020,124,14,110
55704,7,69,2020,271,32,239
55705,7,5,2020,14596,3898,10698
55706,7,57,2020,177,78,99
55707,7,177,2020,118,89,29
55708,7,20,2020,9,0,9
55709,7,9,2020,329,63,266
55710,7,49,2020,37,3,34
55711,7,74,2020,128,15,113
55712,7,142,2020,38,3,35
55713,7,50,2020,110,39,71
55714,160,2,2020,553,121,432
55715,160,51,2020,1482,816,666
55716,160,141,2020,553,198,355
55717,160,52,2020,1204,569,635
55718,160,134,2020,1807,955,852
55719,160,135,2020,2084,1019,1065
55720,160,136,2020,694,353,341
55721,160,106,2020,1792,816,976
55722,160,172,2020,4035,1792,2243
55723,160,137,2020,12288,5872,6416
55724,160,137,2020,2611,1328,1283
55725,160,54,2020,1142,415,727
55726,160,151,2020,1869,787,1082
55727,160,138,2020,941,475,466
55728,160,68,2020,6291,2949,3342
55729,160,139,2020,13867,6864,7003
55730,160,155,2020,1451,738,713
55731,160,156,2020,5857,2580,3277
55732,160,84,2020,431,244,187
55733,160,157,2020,41960,20298,21662
55734,160,17,2020,1559,724,835
55735,160,177,2020,738,368,370
55736,160,167,2020,2146,911,1235
55737,160,176,2020,2069,1141,928
55738,160,159,2020,1312,738,574
55739,160,143,2020,1266,475,791
55740,160,161,2020,24197,10951,13246
55741,160,144,2020,910,540,370
55742,160,162,2020,4265,2070,2195
55743,160,158,2020,414,276,138
55744,160,36,2020,445,229,216
55745,160,126,2020,553,229,324
55746,160,23,2020,1698,955,743
55747,160,164,2020,24257,12152,12105
55748,160,165,2020,2471,1328,1143
55749,160,115,2020,646,215,431
55750,160,145,2020,709,291,418
55751,160,166,2020,4498,1978,2520
55752,160,27,2020,3555,1698,1857
55753,160,94,2020,771,431,340
55754,160,142,2020,848,445,403
55755,160,131,2020,1033,632,401
55756,160,152,2020,62291,28618,33673
55757,160,114,2020,585,307,278
55758,160,132,2020,678,398,280
55759,58,51,2020,229,107,122
55760,58,141,2020,155,36,119
55761,58,103,2020,28,1,27
55762,58,11,2020,81,40,41
55763,58,66,2020,331,139,192
55764,58,3,2020,22,9,13
55765,58,29,2020,18,7,11
55766,58,67,2020,500,177,323
55767,58,53,2020,494,139,355
55768,58,105,2020,287,131,156
55769,58,30,2020,2729,1213,1516
55770,58,172,2020,1076,531,545
55771,58,54,2020,217,75,142
55772,58,14,2020,131,45,86
55773,58,31,2020,242,139,103
55774,58,39,2020,393,139,254
55775,58,142,2020,1410,375,1035
55776,58,119,2020,2023,912,1111
55777,58,120,2020,1034,426,608
55778,58,42,2020,234,131,103
55779,58,68,2020,1296,566,730
55780,58,15,2020,116,53,63
55781,58,69,2020,2969,1343,1626
55782,58,156,2020,201,20,181
55783,58,56,2020,229,58,171
55784,58,32,2020,431,240,191
55785,58,5,2020,791,226,565
55786,58,6,2020,87,36,51
55787,58,16,2020,246,71,175
55788,58,44,2020,819,383,436
55789,58,17,2020,31,4,27
55790,58,57,2020,4720,1274,3446
55791,58,177,2020,134,90,44
55792,58,18,2020,115,13,102
55793,58,121,2020,96,53,43
55794,58,19,2020,170,47,123
55795,58,46,2020,229,100,129
55796,58,20,2020,191,47,144
55797,58,143,2020,3801,1718,2083
55798,58,47,2020,131,80,51
55799,58,144,2020,671,424,247
55800,58,73,2020,1282,498,784
55801,58,162,2020,1025,265,760
55802,58,60,2020,87,21,66
55803,58,48,2020,196,45,151
55804,58,9,2020,549,249,300
55805,58,112,2020,81,45,36
55806,58,33,2020,749,424,325
55807,58,61,2020,170,63,107
55808,58,35,2020,2046,985,1061
55809,58,36,2020,2865,1718,1147
55810,58,23,2020,77,31,46
55811,58,63,2020,1663,526,1137
55812,58,37,2020,305,181,124
55813,58,64,2020,61,23,38
55814,58,128,2020,4101,1853,2248
55815,58,115,2020,523,219,304
55816,58,65,2020,453,193,260
55817,58,10,2020,49,15,34
55818,58,145,2020,404,181,223
55819,58,49,2020,1403,496,907
55820,58,74,2020,309,124,185
55821,58,25,2020,3242,1463,1779
55822,58,93,2020,35,15,20
55823,58,146,2020,969,353,616
55824,58,26,2020,692,187,505
55825,58,38,2020,868,550,318
55826,58,27,2020,75,20,55
55827,58,50,2020,31494,13611,17883
55828,58,171,2020,56,36,20
55829,58,133,2020,106,31,75
55830,161,141,2020,1788,597,1191
55831,161,103,2020,71,25,46
55832,161,67,2020,64,25,39
55833,161,105,2020,173,61,112
55834,161,135,2020,428,148,280
55835,161,136,2020,54,17,37
55836,161,172,2020,172,110,62
55837,161,137,2020,97,37,60
55838,161,151,2020,602,238,364
55839,161,139,2020,90,35,55
55840,161,156,2020,223,121,102
55841,161,157,2020,3396,1774,1622
55842,161,16,2020,122,47,75
55843,161,57,2020,58,22,36
55844,161,19,2020,33,14,19
55845,161,20,2020,128,57,71
55846,161,143,2020,150,61,89
55847,161,160,2020,114379,48824,65555
55848,161,144,2020,373,150,223
55849,161,158,2020,1316,712,604
55850,161,36,2020,64,11,53
55851,161,23,2020,332,128,204
55852,161,164,2020,19294,7849,11445
55853,161,65,2020,90,32,58
55854,161,25,2020,606,250,356
55855,161,166,2020,156,80,76
55856,161,27,2020,73,32,41
55857,161,146,2020,270,116,154
55858,161,142,2020,245,102,143
55859,124,3,2020,8415,5297,3118
55860,124,67,2020,118,24,94
55861,124,10,2020,1137,834,303
55862,124,172,2020,2981,1782,1199
55863,124,68,2020,1519,601,918
55864,124,69,2020,136,64,72
55865,124,173,2020,22,6,16
55866,124,5,2020,8778,1444,7334
55867,124,44,2020,49,21,28
55868,124,57,2020,146,59,87
55869,124,177,2020,8,4,4
55870,124,122,2020,2301,1040,1261
55871,124,9,2020,187,105,82
55872,124,36,2020,48,26,22
55873,124,127,2020,124,77,47
55874,124,115,2020,627,339,288
55875,124,65,2020,26,8,18
55876,124,74,2020,104,27,77
55877,124,50,2020,458,226,232
55878,100,141,2020,110,29,81
55879,100,134,2020,57,29,28
55880,100,103,2020,16688,8050,8638
55881,100,66,2020,573,281,292
55882,100,3,2020,54,12,42
55883,100,11,2020,108,53,55
55884,100,67,2020,969,435,534
55885,100,105,2020,6964,3682,3282
55886,100,95,2020,2127,1113,1014
55887,100,30,2020,282,158,124
55888,100,135,2020,44,8,36
55889,100,106,2020,6714,3352,3362
55890,100,172,2020,9706,3489,6217
55891,100,107,2020,20253,11555,8698
55892,100,137,2020,88,27,61
55893,100,96,2020,3430,1712,1718
55894,100,54,2020,58,29,29
55895,100,81,2020,13546,6241,7305
55896,100,31,2020,376,237,139
55897,100,39,2020,288,118,170
55898,100,83,2020,3107,1837,1270
55899,100,108,2020,3497,1986,1511
55900,100,97,2020,16807,8344,8463
55901,100,42,2020,167,101,66
55902,100,68,2020,10569,4772,5797
55903,100,69,2020,7272,3422,3850
55904,100,56,2020,286,90,196
55905,100,98,2020,46318,24481,21837
55906,100,85,2020,5787,2777,3010
55907,100,99,2020,38764,21491,17273
55908,100,32,2020,422,258,164
55909,100,5,2020,2154,574,1580
55910,100,6,2020,312,104,208
55911,100,16,2020,52,10,42
55912,100,44,2020,308,104,204
55913,100,17,2020,2118,842,1276
55914,100,57,2020,6368,1700,4668
55915,100,86,2020,143,57,86
55916,100,177,2020,4116,1631,2485
55917,100,18,2020,46,10,36
55918,100,121,2020,73,29,44
55919,100,176,2020,1885,663,1222
55920,100,20,2020,576,228,348
55921,100,46,2020,38,23,15
55922,100,47,2020,65,46,19
55923,100,144,2020,265,99,166
55924,100,73,2020,1435,453,982
55925,100,101,2020,4303,2294,2009
55926,100,162,2020,157,32,125
55927,100,48,2020,201,70,131
55928,100,9,2020,163,36,127
55929,100,102,2020,1767,730,1037
55930,100,111,2020,579,331,248
55931,100,112,2020,5187,1744,3443
55932,100,33,2020,747,386,361
55933,100,61,2020,624,183,441
55934,100,88,2020,1227,507,720
55935,100,35,2020,455,286,169
55936,100,36,2020,1824,1149,675
55937,100,23,2020,119,30,89
55938,100,164,2020,36,13,23
55939,100,63,2020,65,37,28
55940,100,37,2020,117,79,38
55941,100,1,2020,91,43,48
55942,100,64,2020,57,30,27
55943,100,115,2020,220,93,127
55944,100,65,2020,24731,10834,13897
55945,100,49,2020,709,302,407
55946,100,74,2020,1675,746,929
55947,100,25,2020,218,72,146
55948,100,93,2020,29,13,16
55949,100,26,2020,308,106,202
55950,100,38,2020,376,244,132
55951,100,142,2020,221,46,175
55952,100,50,2020,3877,1919,1958
55953,100,114,2020,3469,2069,1400
55954,72,68,2020,7790,4428,3362
55955,72,57,2020,5978,2686,3292
55956,59,51,2020,2763,1609,1154
55957,59,66,2020,256,175,81
55958,59,53,2020,32126,19221,12905
55959,59,30,2020,77,12,65
55960,59,54,2020,15523,9699,5824
55961,59,31,2020,119,49,70
55962,59,39,2020,96,76,20
55963,59,68,2020,446,307,139
55964,59,69,2020,1882,1275,607
55965,59,56,2020,55,9,46
55966,59,32,2020,46,13,33
55967,59,57,2020,208,146,62
55968,59,71,2020,99,60,39
55969,59,73,2020,154,121,33
55970,59,33,2020,97,25,72
55971,59,35,2020,104,55,49
55972,59,36,2020,927,532,395
55973,59,63,2020,8831,5263,3568
55974,59,37,2020,55,3,52
55975,59,64,2020,1622,1045,577
55976,59,49,2020,150,91,59
55977,59,74,2020,211,177,34
55978,59,26,2020,86,81,5
55979,59,38,2020,140,48,92
55980,59,60,2020,3329,1942,1387
55981,59,50,2020,102,84,18
55982,87,76,2020,116,60,56
55983,87,82,2020,306,175,131
55984,87,83,2020,23,5,18
55985,87,110,2020,244,101,143
55986,87,90,2020,119,67,52
55987,87,92,2020,28,8,20
55988,87,93,2020,42,15,27
55989,87,50,2020,104,50,54
55990,144,141,2020,14497,7031,7466
55991,144,67,2020,1512,732,780
55992,144,137,2020,2028,983,1045
55993,144,68,2020,38063,18488,19575
55994,144,69,2020,1553,754,799
55995,144,157,2020,1061,514,547
55996,144,16,2020,1849,895,954
55997,144,57,2020,2045,991,1054
55998,144,20,2020,1455,704,751
55999,144,143,2020,1268,614,654
56000,144,161,2020,1717,833,884
56001,144,164,2020,1947,943,1004
56002,144,65,2020,4421,2142,2279
56003,144,25,2020,3676,1778,1898
56004,144,146,2020,2781,1348,1433
56005,144,142,2020,2005,971,1034
56006,144,50,2020,1307,632,675
56007,125,134,2020,39092,20005,19087
56008,125,116,2020,8388,4289,4099
56009,125,153,2020,6819,3308,3511
56010,125,137,2020,11458,5861,5597
56011,125,5,2020,2455,926,1529
56012,125,121,2020,24779,12909,11870
56013,125,149,2020,7842,4417,3425
56014,125,123,2020,62643,31390,31253
56015,125,162,2020,5356,2816,2540
56016,125,9,2020,1412,533,879
56017,125,61,2020,4549,1614,2935
56018,125,127,2020,16940,9227,7713
56019,125,115,2020,20171,10103,10068
56020,125,133,2020,97379,51002,46377
56021,125,131,2020,7423,3580,3843
56022,125,132,2020,5315,2774,2541
56023,150,2,2020,44,25,19
56024,150,141,2020,505,264,241
56025,150,134,2020,40105,16459,23646
56026,150,76,2020,490,291,199
56027,150,103,2020,50,31,19
56028,150,66,2020,636,291,345
56029,150,78,2020,50,38,12
56030,150,13,2020,49,35,14
56031,150,3,2020,32,11,21
56032,150,11,2020,64,0,64
56033,150,67,2020,192,94,98
56034,150,147,2020,689,348,341
56035,150,105,2020,558,322,236
56036,150,30,2020,30,24,6
56037,150,116,2020,406,157,249
56038,150,135,2020,122,21,101
56039,150,106,2020,32,8,24
56040,150,172,2020,3252,913,2339
56041,150,137,2020,1168,485,683
56042,150,137,2020,4334,2210,2124
56043,150,81,2020,710,419,291
56044,150,31,2020,78,51,27
56045,150,151,2020,161,89,72
56046,150,39,2020,117,38,79
56047,150,120,2020,220,149,71
56048,150,42,2020,81,57,24
56049,150,68,2020,560,306,254
56050,150,155,2020,88,48,40
56051,150,69,2020,9494,5443,4051
56052,150,156,2020,148,60,88
56053,150,157,2020,53,21,32
56054,150,5,2020,704,241,463
56055,150,6,2020,30,11,19
56056,150,44,2020,61,31,30
56057,150,17,2020,112,48,64
56058,150,57,2020,863,472,391
56059,150,177,2020,117,73,44
56060,150,121,2020,1161,572,589
56061,150,176,2020,104,0,104
56062,150,20,2020,47,17,30
56063,150,149,2020,131,66,65
56064,150,143,2020,35,17,18
56065,150,71,2020,44,24,20
56066,150,123,2020,386,176,210
56067,150,124,2020,110,64,46
56068,150,125,2020,142,60,82
56069,150,73,2020,539,274,265
56070,150,162,2020,1029,395,634
56071,150,48,2020,53,35,18
56072,150,9,2020,173,17,156
56073,150,33,2020,175,114,61
56074,150,61,2020,451,183,268
56075,150,35,2020,30,13,17
56076,150,36,2020,474,194,280
56077,150,126,2020,374,163,211
56078,150,164,2020,30,11,19
56079,150,127,2020,57,35,22
56080,150,165,2020,170,89,81
56081,150,128,2020,97,28,69
56082,150,115,2020,8883,4428,4455
56083,150,133,2020,15135,7426,7709
56084,150,65,2020,358,146,212
56085,150,145,2020,207,114,93
56086,150,148,2020,204,111,93
56087,150,49,2020,104,55,49
56088,150,74,2020,446,257,189
56089,150,26,2020,35,13,22
56090,150,130,2020,502,244,258
56091,150,38,2020,267,35,232
56092,150,142,2020,180,69,111
56093,150,50,2020,1798,1033,765
56094,150,131,2020,1148,579,569
56095,150,152,2020,73,38,35
56096,150,132,2020,3167,1107,2060
56097,8,3,2020,222,109,113
56098,8,4,2020,27502,13484,14018
56099,8,10,2020,42,23,19
56100,8,172,2020,19428,13848,5580
56101,8,5,2020,426941,307369,119572
56102,8,9,2020,1212,436,776
56103,73,2,2020,36418,16905,19513
56104,73,51,2020,2402,1176,1226
56105,73,141,2020,4219,1676,2543
56106,73,52,2020,27,12,15
56107,73,134,2020,4957,2135,2822
56108,73,75,2020,18,15,3
56109,73,76,2020,35,21,14
56110,73,103,2020,4371,2360,2011
56111,73,11,2020,952,485,467
56112,73,77,2020,5554,2733,2821
56113,73,66,2020,7242,4146,3096
56114,73,12,2020,918,440,478
56115,73,78,2020,62,27,35
56116,73,13,2020,215,104,111
56117,73,3,2020,1843,983,860
56118,73,79,2020,101,49,52
56119,73,29,2020,529,308,221
56120,73,67,2020,61744,33400,28344
56121,73,95,2020,25,12,13
56122,73,151,2020,310,119,191
56123,73,4,2020,300,144,156
56124,73,53,2020,1059,542,517
56125,73,147,2020,260,136,124
56126,73,105,2020,22974,14269,8705
56127,73,30,2020,30691,15596,15095
56128,73,152,2020,413,152,261
56129,73,116,2020,2185,1121,1064
56130,73,153,2020,12091,6541,5550
56131,73,135,2020,1992,1040,952
56132,73,80,2020,19,11,8
56133,73,136,2020,99,38,61
56134,73,106,2020,3897,2050,1847
56135,73,172,2020,72803,41013,31790
56136,73,107,2020,16127,9505,6622
56137,73,117,2020,10,3,7
56138,73,137,2020,922,466,456
56139,73,96,2020,978,528,450
56140,73,54,2020,819,435,384
56141,73,81,2020,1501,878,623
56142,73,14,2020,1095,484,611
56143,73,31,2020,1345,714,631
56144,73,176,2020,93,40,53
56145,73,137,2020,5120,2576,2544
56146,73,39,2020,4133,2362,1771
56147,73,118,2020,124,84,40
56148,73,82,2020,89,50,39
56149,73,83,2020,9541,6472,3069
56150,73,108,2020,2792,1719,1073
56151,73,142,2020,15893,5290,10603
56152,73,97,2020,498,290,208
56153,73,138,2020,49,36,13
56154,73,119,2020,16279,6866,9413
56155,73,40,2020,1352,900,452
56156,73,148,2020,95,56,39
56157,73,120,2020,18588,8537,10051
56158,73,41,2020,7,3,4
56159,73,42,2020,3982,2717,1265
56160,73,68,2020,30917,16599,14318
56161,73,139,2020,94,51,43
56162,73,155,2020,1072,409,663
56163,73,15,2020,490,269,221
56164,73,69,2020,123702,71842,51860
56165,73,156,2020,14923,7720,7203
56166,73,55,2020,34,12,22
56167,73,56,2020,19776,8383,11393
56168,73,84,2020,48,30,18
56169,73,98,2020,905,465,440
56170,73,157,2020,2519,1065,1454
56171,73,158,2020,258,109,149
56172,73,110,2020,2307,1517,790
56173,73,85,2020,1522,740,782
56174,73,99,2020,574,365,209
56175,73,32,2020,16746,9060,7686
56176,73,43,2020,563,292,271
56177,73,5,2020,42285,18604,23681
56178,73,6,2020,34809,16036,18773
56179,73,16,2020,45919,20131,25788
56180,73,44,2020,6650,3214,3436
56181,73,45,2020,9,5,4
56182,73,17,2020,6270,2749,3521
56183,73,57,2020,35908,14380,21528
56184,73,86,2020,1136,587,549
56185,73,177,2020,7038,4077,2961
56186,73,18,2020,1559,699,860
56187,73,167,2020,480,267,213
56188,73,121,2020,3582,2075,1507
56189,73,19,2020,1745,757,988
56190,73,168,2020,112,67,45
56191,73,46,2020,5021,2727,2294
56192,73,20,2020,4593,2101,2492
56193,73,149,2020,157,68,89
56194,73,159,2020,1751,713,1038
56195,73,143,2020,1864,753,1111
56196,73,70,2020,2,2,0
56197,73,47,2020,7326,4176,3150
56198,73,71,2020,1705,891,814
56199,73,122,2020,215,131,84
56200,73,123,2020,351,183,168
56201,73,7,2020,19,8,11
56202,73,160,2020,188,92,96
56203,73,58,2020,461,262,199
56204,73,161,2020,311,40,271
56205,73,124,2020,416,251,165
56206,73,100,2020,5721,3372,2349
56207,73,72,2020,112,63,49
56208,73,59,2020,10,4,6
56209,73,87,2020,6,3,3
56210,73,144,2020,174914,85517,89397
56211,73,125,2020,676,349,327
56212,73,150,2020,358,198,160
56213,73,8,2020,1973,954,1019
56214,73,101,2020,613,344,269
56215,73,162,2020,7830,3543,4287
56216,73,60,2020,478,249,229
56217,73,48,2020,3099,1740,1359
56218,73,21,2020,779,364,415
56219,73,9,2020,14104,6074,8030
56220,73,102,2020,390,195,195
56221,73,111,2020,229,152,77
56222,73,112,2020,4749,3203,1546
56223,73,33,2020,148991,78841,70150
56224,73,61,2020,19574,9231,10343
56225,73,22,2020,311,162,149
56226,73,35,2020,28691,15390,13301
56227,73,36,2020,5076,2829,2247
56228,73,126,2020,1133,579,554
56229,73,90,2020,74,49,25
56230,73,91,2020,73,37,36
56231,73,92,2020,66,42,24
56232,73,62,2020,4,2,2
56233,73,140,2020,171,91,80
56234,73,23,2020,3340,1532,1808
56235,73,164,2020,1174,440,734
56236,73,63,2020,320,143,177
56237,73,127,2020,89,65,24
56238,73,165,2020,3768,1312,2456
56239,73,37,2020,1671,816,855
56240,73,64,2020,549,328,221
56241,73,128,2020,25871,12832,13039
56242,73,115,2020,17522,9244,8278
56243,73,129,2020,18,9,9
56244,73,65,2020,31415,16116,15299
56245,73,10,2020,10610,5300,5310
56246,73,145,2020,5750,2116,3634
56247,73,113,2020,182922,101651,81271
56248,73,49,2020,5397,3099,2298
56249,73,74,2020,8003,4407,3596
56250,73,25,2020,88993,38836,50157
56251,73,169,2020,80,40,40
56252,73,166,2020,1160,463,697
56253,73,93,2020,683,388,295
56254,73,146,2020,5148,1937,3211
56255,73,26,2020,199280,97646,101634
56256,73,170,2020,36,20,16
56257,73,94,2020,0,0,0
56258,73,130,2020,2301,1258,1043
56259,73,38,2020,3022,1669,1353
56260,73,27,2020,2076,918,1158
56261,73,50,2020,57243,25660,31583
56262,73,131,2020,1482,788,694
56263,73,114,2020,726,375,351
56264,73,171,2020,256,135,121
56265,73,1,2020,14712,8534,6178
56266,73,28,2020,1338,545,793
56267,73,132,2020,1045,548,497
56268,73,133,2020,1691,887,804
56269,101,2,2020,62,27,35
56270,101,141,2020,117,62,55
56271,101,76,2020,123,62,61
56272,101,103,2020,281,134,147
56273,101,66,2020,38,14,24
56274,101,78,2020,86,41,45
56275,101,67,2020,45,9,36
56276,101,105,2020,126,68,58
56277,101,95,2020,24,10,14
56278,101,30,2020,62,39,23
56279,101,106,2020,130,52,78
56280,101,172,2020,144,49,95
56281,101,107,2020,467,211,256
56282,101,137,2020,48,14,34
56283,101,96,2020,11281,5553,5728
56284,101,81,2020,984,374,610
56285,101,39,2020,53,16,37
56286,101,83,2020,71,32,39
56287,101,108,2020,115,45,70
56288,101,97,2020,2557,1164,1393
56289,101,120,2020,83,31,52
56290,101,68,2020,154,60,94
56291,101,69,2020,313,112,201
56292,101,98,2020,1843,866,977
56293,101,85,2020,23,10,13
56294,101,99,2020,13110,6756,6354
56295,101,5,2020,24,10,14
56296,101,44,2020,24,5,19
56297,101,57,2020,198,45,153
56298,101,86,2020,19,5,14
56299,101,177,2020,40,12,28
56300,101,18,2020,26,9,17
56301,101,100,2020,885,486,399
56302,101,73,2020,278,149,129
56303,101,162,2020,24,14,10
56304,101,102,2020,423,184,239
56305,101,112,2020,237,98,139
56306,101,88,2020,59,26,33
56307,101,36,2020,202,120,82
56308,101,164,2020,195,111,84
56309,101,128,2020,38,31,7
56310,101,65,2020,480,208,272
56311,101,49,2020,33,11,22
56312,101,74,2020,86,22,64
56313,101,38,2020,80,46,34
56314,101,50,2020,73,24,49
56315,101,114,2020,38,23,15
56316,101,28,2020,30,20,10
56317,162,135,2020,52489,23858,28631
56318,162,136,2020,31261,14211,17050
56319,162,151,2020,377169,171468,205701
56320,162,156,2020,238284,108326,129958
56321,162,159,2020,22009,10004,12005
56322,162,160,2020,172481,78411,94070
56323,162,165,2020,4363,1983,2380
56324,162,166,2020,158262,71948,86314
56325,176,3,2020,153,92,61
56326,176,105,2020,2841,1412,1429
56327,176,10,2020,154,103,51
56328,176,172,2020,29248,14176,15072
56329,176,173,2020,166,54,112
56330,176,5,2020,370,176,194
56331,176,177,2020,214,95,119
56332,176,9,2020,172,84,88
56333,176,112,2020,533,263,270
56334,176,36,2020,146,68,78
56335,176,1,2020,766,344,422
56336,176,50,2020,309,129,180
56337,60,51,2020,68113,40073,28040
56338,60,53,2020,8750,5111,3639
56339,60,30,2020,1075,627,448
56340,60,54,2020,1438,839,599
56341,60,31,2020,52,29,23
56342,60,69,2020,41,23,18
56343,60,56,2020,232,134,98
56344,60,32,2020,80,45,35
56345,60,57,2020,36,21,15
56346,60,59,2020,9269,5415,3854
56347,60,33,2020,99,57,42
56348,60,35,2020,22,12,10
56349,60,36,2020,214,126,88
56350,60,63,2020,18009,10523,7486
56351,60,37,2020,35,20,15
56352,60,64,2020,255,148,107
56353,60,26,2020,20011,11271,8740
56354,60,38,2020,63,35,28
56355,60,142,2020,1971,1150,821
56356,48,2,2020,17242,6308,10934
56357,48,51,2020,2174,935,1239
56358,48,141,2020,1283,468,815
56359,48,52,2020,12,7,5
56360,48,134,2020,496,267,229
56361,48,76,2020,4,2,2
56362,48,103,2020,1246,599,647
56363,48,11,2020,333,191,142
56364,48,77,2020,16,4,12
56365,48,66,2020,1688,817,871
56366,48,12,2020,557,315,242
56367,48,78,2020,23,12,11
56368,48,13,2020,34,18,16
56369,48,3,2020,1331,616,715
56370,48,79,2020,24,9,15
56371,48,29,2020,1211,846,365
56372,48,67,2020,1890,895,995
56373,48,95,2020,13,4,9
56374,48,151,2020,27,15,12
56375,48,4,2020,373,208,165
56376,48,53,2020,13946,7102,6844
56377,48,147,2020,118,63,55
56378,48,105,2020,6256,4339,1917
56379,48,30,2020,7293,3307,3986
56380,48,152,2020,32,8,24
56381,48,116,2020,1123,591,532
56382,48,153,2020,406,186,220
56383,48,135,2020,814,365,449
56384,48,80,2020,3,2,1
56385,48,136,2020,31,10,21
56386,48,106,2020,6698,3258,3440
56387,48,172,2020,13579,8771,4808
56388,48,173,2020,0,0,0
56389,48,174,2020,0,0,0
56390,48,107,2020,6186,2976,3210
56391,48,117,2020,4,4,0
56392,48,137,2020,254,136,118
56393,48,96,2020,320,164,156
56394,48,54,2020,4897,2231,2666
56395,48,81,2020,1103,692,411
56396,48,14,2020,210,80,130
56397,48,31,2020,2225,1117,1108
56398,48,176,2020,36,17,19
56399,48,137,2020,2798,1441,1357
56400,48,39,2020,24842,11911,12931
56401,48,118,2020,61,40,21
56402,48,82,2020,22,11,11
56403,48,83,2020,963,581,382
56404,48,108,2020,833,425,408
56405,48,142,2020,1355,439,916
56406,48,97,2020,225,108,117
56407,48,138,2020,13,9,4
56408,48,119,2020,22974,9610,13364
56409,48,40,2020,4742,2175,2567
56410,48,148,2020,19,7,12
56411,48,120,2020,9493,4688,4805
56412,48,41,2020,796,396,400
56413,48,42,2020,7182,4358,2824
56414,48,68,2020,6676,2980,3696
56415,48,139,2020,11,8,3
56416,48,155,2020,1252,531,721
56417,48,15,2020,338,181,157
56418,48,69,2020,28327,13674,14653
56419,48,156,2020,2094,977,1117
56420,48,55,2020,7,3,4
56421,48,56,2020,3352,1408,1944
56422,48,84,2020,16,9,7
56423,48,98,2020,472,237,235
56424,48,157,2020,298,147,151
56425,48,158,2020,68,21,47
56426,48,110,2020,91,61,30
56427,48,85,2020,51,24,27
56428,48,99,2020,133,78,55
56429,48,32,2020,4306,2081,2225
56430,48,43,2020,7786,3819,3967
56431,48,5,2020,14726,7016,7710
56432,48,6,2020,18379,8634,9745
56433,48,16,2020,23557,10427,13130
56434,48,44,2020,1159,457,702
56435,48,45,2020,0,0,0
56436,48,17,2020,889,392,497
56437,48,57,2020,5040,1902,3138
56438,48,86,2020,183,102,81
56439,48,177,2020,1540,1039,501
56440,48,18,2020,611,292,319
56441,48,167,2020,973,631,342
56442,48,121,2020,2309,1380,929
56443,48,19,2020,491,199,292
56444,48,168,2020,236,169,67
56445,48,46,2020,10589,4567,6022
56446,48,20,2020,2784,1305,1479
56447,48,149,2020,9,6,3
56448,48,159,2020,955,490,465
56449,48,143,2020,760,300,460
56450,48,70,2020,20,8,12
56451,48,47,2020,39856,16946,22910
56452,48,71,2020,149,56,93
56453,48,122,2020,492,266,226
56454,48,123,2020,112,60,52
56455,48,7,2020,4,1,3
56456,48,160,2020,57,22,35
56457,48,58,2020,105,54,51
56458,48,161,2020,69,7,62
56459,48,124,2020,196,117,79
56460,48,100,2020,1530,867,663
56461,48,72,2020,13,8,5
56462,48,59,2020,486,253,233
56463,48,87,2020,4,1,3
56464,48,144,2020,6199,2884,3315
56465,48,125,2020,193,104,89
56466,48,150,2020,99,61,38
56467,48,8,2020,2233,1021,1212
56468,48,73,2020,9088,4103,4985
56469,48,101,2020,223,124,99
56470,48,162,2020,1977,852,1125
56471,48,60,2020,2932,1389,1543
56472,48,21,2020,45,17,28
56473,48,9,2020,21140,10287,10853
56474,48,102,2020,85,55,30
56475,48,111,2020,174,108,66
56476,48,112,2020,1669,1035,634
56477,48,33,2020,100479,37013,63466
56478,48,61,2020,3536,1456,2080
56479,48,88,2020,0,0,0
56480,48,22,2020,91,44,47
56481,48,35,2020,14872,6748,8124
56482,48,36,2020,18486,12391,6095
56483,48,126,2020,662,370,292
56484,48,90,2020,2,2,0
56485,48,91,2020,13,8,5
56486,48,92,2020,4,1,3
56487,48,62,2020,4,2,2
56488,48,140,2020,5,2,3
56489,48,23,2020,964,454,510
56490,48,164,2020,310,109,201
56491,48,63,2020,6778,3418,3360
56492,48,127,2020,13,7,6
56493,48,165,2020,518,253,265
56494,48,37,2020,3779,1500,2279
56495,48,64,2020,438,211,227
56496,48,128,2020,29034,13844,15190
56497,48,115,2020,1741,794,947
56498,48,129,2020,178,76,102
56499,48,65,2020,7350,3387,3963
56500,48,10,2020,9531,4655,4876
56501,48,145,2020,4794,1940,2854
56502,48,113,2020,37,24,13
56503,48,49,2020,48283,23843,24440
56504,48,74,2020,2427,1234,1193
56505,48,25,2020,31197,12666,18531
56506,48,169,2020,121,70,51
56507,48,166,2020,113,53,60
56508,48,93,2020,356,208,148
56509,48,146,2020,1133,395,738
56510,48,26,2020,12238,5424,6814
56511,48,170,2020,87,51,36
56512,48,94,2020,2,1,1
56513,48,130,2020,1586,849,737
56514,48,38,2020,5693,4081,1612
56515,48,27,2020,616,283,333
56516,48,50,2020,19940,7771,12169
56517,48,131,2020,935,489,446
56518,48,114,2020,248,120,128
56519,48,171,2020,660,354,306
56520,48,1,2020,14596,8238,6358
56521,48,28,2020,611,264,347
56522,48,132,2020,558,296,262
56523,48,133,2020,319,155,164
56524,21,13,2020,1140,426,714
56525,21,3,2020,316467,19994,296473
56526,21,10,2020,30063,13231,16832
56527,21,68,2020,3377,850,2527
56528,21,5,2020,1375667,170995,1204672
56529,21,16,2020,12283,4095,8188
56530,21,18,2020,21868,6783,15085
56531,21,19,2020,852,141,711
56532,21,73,2020,1614,354,1260
56533,21,9,2020,250092,23666,226426
56534,21,22,2020,492,82,410
56535,21,23,2020,2137,514,1623
56536,21,129,2020,405,132,273
56537,21,145,2020,19879,6507,13372
56538,21,27,2020,18978,6911,12067
56539,21,142,2020,88261,25945,62316
56540,21,50,2020,11975,3277,8698
56541,9,2,2020,1598223,792861,805362
56542,9,10,2020,539,256,283
56543,9,172,2020,311,123,188
56544,9,5,2020,1597134,634727,962407
56545,9,6,2020,2148,906,1242
56546,9,16,2020,233,110,123
56547,102,103,2020,3062,1333,1729
56548,102,66,2020,129,56,73
56549,102,3,2020,51,10,41
56550,102,79,2020,38,18,20
56551,102,67,2020,324,98,226
56552,102,105,2020,2406,1227,1179
56553,102,95,2020,103,34,69
56554,102,30,2020,87,32,55
56555,102,106,2020,2178,980,1198
56556,102,172,2020,22427,10212,12215
56557,102,107,2020,50702,28003,22699
56558,102,96,2020,9320,4713,4607
56559,102,54,2020,121,26,95
56560,102,81,2020,2194,862,1332
56561,102,31,2020,45,26,19
56562,102,39,2020,176,34,142
56563,102,82,2020,68,42,26
56564,102,83,2020,9711,6325,3386
56565,102,108,2020,3201,1428,1773
56566,102,97,2020,4147,1990,2157
56567,102,42,2020,55,26,29
56568,102,68,2020,1163,450,713
56569,102,15,2020,68,5,63
56570,102,69,2020,1279,509,770
56571,102,56,2020,389,65,324
56572,102,84,2020,31,11,20
56573,102,98,2020,1925,809,1116
56574,102,110,2020,57,28,29
56575,102,85,2020,651,340,311
56576,102,99,2020,1797,908,889
56577,102,173,2020,337,164,173
56578,102,32,2020,69,25,44
56579,102,5,2020,5383,1948,3435
56580,102,6,2020,99,23,76
56581,102,44,2020,109,28,81
56582,102,17,2020,1338,404,934
56583,102,57,2020,1587,470,1117
56584,102,86,2020,830,413,417
56585,102,177,2020,446,194,252
56586,102,18,2020,141,40,101
56587,102,20,2020,632,250,382
56588,102,143,2020,45,10,35
56589,102,47,2020,54,10,44
56590,102,100,2020,5801,2542,3259
56591,102,144,2020,94,28,66
56592,102,73,2020,579,179,400
56593,102,101,2020,15517,8759,6758
56594,102,162,2020,43,9,34
56595,102,48,2020,91,32,59
56596,102,9,2020,99,39,60
56597,102,111,2020,145,85,60
56598,102,112,2020,5155,2180,2975
56599,102,33,2020,235,81,154
56600,102,61,2020,305,98,207
56601,102,88,2020,865,298,567
56602,102,35,2020,215,54,161
56603,102,36,2020,1192,415,777
56604,102,23,2020,59,18,41
56605,102,63,2020,31,5,26
56606,102,37,2020,43,25,18
56607,102,1,2020,69,26,43
56608,102,115,2020,55,26,29
56609,102,65,2020,4447,1618,2829
56610,102,49,2020,254,65,189
56611,102,74,2020,439,138,301
56612,102,25,2020,329,127,202
56613,102,93,2020,141,61,80
56614,102,26,2020,134,26,108
56615,102,38,2020,603,98,505
56616,102,142,2020,87,32,55
56617,102,50,2020,2422,820,1602
56618,102,114,2020,914,366,548
56619,111,103,2020,61833,30671,31162
56620,111,105,2020,79897,38004,41893
56621,111,106,2020,2283,939,1344
56622,111,172,2020,844,370,474
56623,111,68,2020,663,262,401
56624,111,69,2020,1797,756,1041
56625,111,57,2020,947,362,585
56626,111,177,2020,2148,1023,1125
56627,111,100,2020,1738,862,876
56628,111,33,2020,943,441,502
56629,111,65,2020,955,401,554
56630,111,50,2020,187,85,102
56631,111,114,2020,3168,1361,1807
56632,112,141,2020,33,9,24
56633,112,134,2020,26,16,10
56634,112,103,2020,26854,12085,14769
56635,112,66,2020,371,162,209
56636,112,67,2020,1166,538,628
56637,112,105,2020,16458,6819,9639
56638,112,30,2020,126,46,80
56639,112,106,2020,17615,8276,9339
56640,112,172,2020,31931,7148,24783
56641,112,107,2020,14182,6783,7399
56642,112,96,2020,638,320,318
56643,112,54,2020,169,35,134
56644,112,81,2020,3170,1240,1930
56645,112,31,2020,168,72,96
56646,112,39,2020,458,199,259
56647,112,83,2020,342,170,172
56648,112,108,2020,12795,5893,6902
56649,112,97,2020,203,99,104
56650,112,40,2020,29,12,17
56651,112,42,2020,132,64,68
56652,112,68,2020,7375,3247,4128
56653,112,109,2020,61,33,28
56654,112,69,2020,9733,4223,5510
56655,112,56,2020,111,30,81
56656,112,98,2020,308,151,157
56657,112,85,2020,89,54,35
56658,112,99,2020,311,186,125
56659,112,32,2020,118,59,59
56660,112,43,2020,26,4,22
56661,112,5,2020,2673,381,2292
56662,112,6,2020,107,32,75
56663,112,16,2020,33,6,27
56664,112,44,2020,401,191,210
56665,112,17,2020,961,365,596
56666,112,57,2020,7748,3075,4673
56667,112,177,2020,6376,2882,3494
56668,112,18,2020,69,16,53
56669,112,176,2020,161,69,92
56670,112,20,2020,131,48,83
56671,112,71,2020,26,9,17
56672,112,58,2020,37,0,37
56673,112,100,2020,6148,2578,3570
56674,112,144,2020,69,20,49
56675,112,73,2020,1288,563,725
56676,112,101,2020,303,175,128
56677,112,48,2020,197,88,109
56678,112,9,2020,134,30,104
56679,112,102,2020,644,321,323
56680,112,111,2020,1034,550,484
56681,112,33,2020,371,176,195
56682,112,61,2020,242,83,159
56683,112,88,2020,257,135,122
56684,112,35,2020,340,178,162
56685,112,36,2020,1194,738,456
56686,112,92,2020,40,27,13
56687,112,23,2020,58,25,33
56688,112,64,2020,52,20,32
56689,112,115,2020,217,83,134
56690,112,65,2020,12094,5393,6701
56691,112,49,2020,535,242,293
56692,112,74,2020,1479,661,818
56693,112,26,2020,94,33,61
56694,112,38,2020,455,291,164
56695,112,142,2020,35,6,29
56696,112,50,2020,5326,2270,3056
56697,112,114,2020,1384,567,817
56698,33,2,2020,184,16,168
56699,33,51,2020,165,21,144
56700,33,141,2020,766,121,645
56701,33,134,2020,72,7,65
56702,33,103,2020,357,123,234
56703,33,11,2020,2775,939,1836
56704,33,66,2020,4997,2267,2730
56705,33,12,2020,348,141,207
56706,33,3,2020,128,16,112
56707,33,29,2020,100175,56125,44050
56708,33,67,2020,6884,2976,3908
56709,33,53,2020,4584,2464,2120
56710,33,105,2020,340,130,210
56711,33,30,2020,2280,870,1410
56712,33,135,2020,47,5,42
56713,33,106,2020,75,28,47
56714,33,172,2020,1550,763,787
56715,33,107,2020,161,75,86
56716,33,137,2020,138,51,87
56717,33,96,2020,45,0,45
56718,33,54,2020,1034,404,630
56719,33,81,2020,294,87,207
56720,33,14,2020,273,88,185
56721,33,31,2020,5952,2877,3075
56722,33,39,2020,1173,496,677
56723,33,83,2020,25,16,9
56724,33,108,2020,57,0,57
56725,33,142,2020,594,139,455
56726,33,119,2020,39,30,9
56727,33,40,2020,259,149,110
56728,33,120,2020,55,15,40
56729,33,42,2020,327,167,160
56730,33,68,2020,34461,17718,16743
56731,33,15,2020,428,213,215
56732,33,69,2020,100688,49509,51179
56733,33,156,2020,45,14,31
56734,33,56,2020,4085,1641,2444
56735,33,157,2020,71,10,61
56736,33,110,2020,33,12,21
56737,33,32,2020,1770,837,933
56738,33,43,2020,647,297,350
56739,33,5,2020,1128,339,789
56740,33,6,2020,301,82,219
56741,33,16,2020,559,122,437
56742,33,44,2020,10014,4362,5652
56743,33,17,2020,454,155,299
56744,33,57,2020,13105,5320,7785
56745,33,177,2020,670,371,299
56746,33,18,2020,178,18,160
56747,33,167,2020,6071,2946,3125
56748,33,121,2020,77,32,45
56749,33,19,2020,250,60,190
56750,33,168,2020,163,45,118
56751,33,46,2020,2043,1119,924
56752,33,20,2020,501,86,415
56753,33,143,2020,315,88,227
56754,33,47,2020,66555,37815,28740
56755,33,71,2020,301,171,130
56756,33,160,2020,36,3,33
56757,33,100,2020,278,97,181
56758,33,72,2020,30,9,21
56759,33,59,2020,75,18,57
56760,33,144,2020,416,61,355
56761,33,125,2020,33,0,33
56762,33,8,2020,71,16,55
56763,33,73,2020,3413,1200,2213
56764,33,162,2020,500,7,493
56765,33,60,2020,346,122,224
56766,33,48,2020,2014,932,1082
56767,33,9,2020,278,21,257
56768,33,102,2020,40,20,20
56769,33,112,2020,144,23,121
56770,33,61,2020,178,51,127
56771,33,22,2020,31,16,15
56772,33,35,2020,3270,1701,1569
56773,33,36,2020,50329,29589,20740
56774,33,23,2020,227,96,131
56775,33,164,2020,113,21,92
56776,33,63,2020,1363,456,907
56777,33,37,2020,1707,851,856
56778,33,64,2020,198,65,133
56779,33,115,2020,500,192,308
56780,33,65,2020,6357,2745,3612
56781,33,10,2020,111,50,61
56782,33,145,2020,146,24,122
56783,33,49,2020,1722,632,1090
56784,33,74,2020,1337,549,788
56785,33,25,2020,773,107,666
56786,33,169,2020,198,107,91
56787,33,146,2020,538,57,481
56788,33,26,2020,1149,239,910
56789,33,170,2020,68,57,11
56790,33,130,2020,80,43,37
56791,33,38,2020,272594,154202,118392
56792,33,27,2020,163,70,93
56793,33,50,2020,45577,19233,26344
56794,33,131,2020,90,29,61
56795,33,114,2020,120,54,66
56796,33,171,2020,652,384,268
56797,33,1,2020,3681,1322,2359
56798,33,28,2020,147,51,96
56799,33,132,2020,54,5,49
56800,33,133,2020,134,65,69
56801,61,51,2020,55,27,28
56802,61,141,2020,261,63,198
56803,61,52,2020,425,226,199
56804,61,134,2020,179524,97065,82459
56805,61,103,2020,1512,802,710
56806,61,11,2020,112,40,72
56807,61,66,2020,576,298,278
56808,61,12,2020,73,30,43
56809,61,3,2020,1684,440,1244
56810,61,29,2020,1084,557,527
56811,61,67,2020,3924,2020,1904
56812,61,151,2020,36,1,35
56813,61,53,2020,46,38,8
56814,61,105,2020,154017,88899,65118
56815,61,30,2020,5940,2909,3031
56816,61,153,2020,68299,36332,31967
56817,61,135,2020,82,27,55
56818,61,106,2020,221,117,104
56819,61,172,2020,12000,5798,6202
56820,61,173,2020,149,89,60
56821,61,174,2020,2285,1280,1005
56822,61,107,2020,736,487,249
56823,61,137,2020,542,477,65
56824,61,54,2020,91,54,37
56825,61,81,2020,1858,1449,409
56826,61,14,2020,31,15,16
56827,61,31,2020,282,194,88
56828,61,176,2020,82,49,33
56829,61,137,2020,2080,702,1378
56830,61,39,2020,451,221,230
56831,61,83,2020,153,102,51
56832,61,108,2020,511,263,248
56833,61,142,2020,480,63,417
56834,61,97,2020,96,88,8
56835,61,138,2020,251,234,17
56836,61,40,2020,145,104,41
56837,61,148,2020,660,272,388
56838,61,120,2020,32,12,20
56839,61,42,2020,381,234,147
56840,61,68,2020,104164,56263,47901
56841,61,139,2020,647,18,629
56842,61,155,2020,128,21,107
56843,61,15,2020,1226,308,918
56844,61,69,2020,30866,15893,14973
56845,61,156,2020,218,57,161
56846,61,56,2020,212,98,114
56847,61,98,2020,32,18,14
56848,61,157,2020,5160,2442,2718
56849,61,158,2020,32607,14337,18270
56850,61,32,2020,454,308,146
56851,61,43,2020,30,17,13
56852,61,5,2020,8957,3826,5131
56853,61,6,2020,740,319,421
56854,61,16,2020,257,109,148
56855,61,44,2020,1789,914,875
56856,61,17,2020,387,38,349
56857,61,57,2020,3125,1312,1813
56858,61,86,2020,28,12,16
56859,61,177,2020,352,208,144
56860,61,18,2020,213,85,128
56861,61,167,2020,998,472,526
56862,61,121,2020,113,58,55
56863,61,46,2020,234,177,57
56864,61,20,2020,246,95,151
56865,61,159,2020,30,1,29
56866,61,143,2020,106,46,60
56867,61,70,2020,230,1,229
56868,61,47,2020,416,269,147
56869,61,71,2020,4502,2304,2198
56870,61,122,2020,28,12,16
56871,61,123,2020,521,322,199
56872,61,160,2020,127,9,118
56873,61,58,2020,47,30,17
56874,61,161,2020,44,8,36
56875,61,100,2020,301,168,133
56876,61,59,2020,87,83,4
56877,61,144,2020,2256,740,1516
56878,61,125,2020,80570,43136,37434
56879,61,8,2020,6637,2175,4462
56880,61,73,2020,4542,2227,2315
56881,61,162,2020,302,105,197
56882,61,60,2020,310,155,155
56883,61,48,2020,378,195,183
56884,61,9,2020,2217,748,1469
56885,61,102,2020,38,21,17
56886,61,111,2020,58,38,20
56887,61,112,2020,324,194,130
56888,61,33,2020,1116,808,308
56889,61,35,2020,26113,12720,13393
56890,61,36,2020,6508,3927,2581
56891,61,140,2020,20552,11448,9104
56892,61,164,2020,2383,490,1893
56893,61,63,2020,200,119,81
56894,61,165,2020,58,9,49
56895,61,37,2020,103,83,20
56896,61,64,2020,61,40,21
56897,61,115,2020,12651,6748,5903
56898,61,65,2020,18175,10394,7781
56899,61,10,2020,86,28,58
56900,61,49,2020,920,508,412
56901,61,74,2020,18566,9276,9290
56902,61,25,2020,531,232,299
56903,61,166,2020,83,24,59
56904,61,146,2020,155,32,123
56905,61,26,2020,789,385,404
56906,61,130,2020,29,18,11
56907,61,38,2020,53384,22622,30762
56908,61,50,2020,21089,10557,10532
56909,61,131,2020,77,38,39
56910,61,114,2020,256,80,176
56911,61,171,2020,1006,309,697
56912,61,1,2020,58,30,28
56913,61,133,2020,1312,129,1183
56914,88,103,2020,828,442,386
56915,88,105,2020,40,21,19
56916,88,106,2020,452,242,210
56917,88,172,2020,1212,648,564
56918,88,107,2020,4039,2162,1877
56919,88,96,2020,924,494,430
56920,88,81,2020,12637,6766,5871
56921,88,82,2020,513,274,239
56922,88,83,2020,46905,25116,21789
56923,88,108,2020,348,186,162
56924,88,142,2020,14,7,7
56925,88,97,2020,130,69,61
56926,88,68,2020,61,32,29
56927,88,69,2020,217,115,102
56928,88,98,2020,331,176,155
56929,88,110,2020,21,11,10
56930,88,85,2020,129,69,60
56931,88,99,2020,531,284,247
56932,88,5,2020,21,11,10
56933,88,17,2020,19,10,9
56934,88,57,2020,82,43,39
56935,88,86,2020,18,9,9
56936,88,177,2020,35,18,17
56937,88,18,2020,38,19,19
56938,88,20,2020,7,3,4
56939,88,100,2020,1831,980,851
56940,88,73,2020,11,5,6
56941,88,101,2020,101,53,48
56942,88,102,2020,589,315,274
56943,88,112,2020,2094,1118,976
56944,88,33,2020,7,3,4
56945,88,61,2020,14,7,7
56946,88,65,2020,2604,1394,1210
56947,88,93,2020,75,40,35
56948,88,26,2020,8,4,4
56949,88,50,2020,74,39,35
56950,88,1,2020,27,14,13
56951,22,2,2020,1599,316,1283
56952,22,13,2020,777,280,497
56953,22,3,2020,261672,19818,241854
56954,22,10,2020,154078,43699,110379
56955,22,136,2020,520,101,419
56956,22,120,2020,1697,335,1362
56957,22,119,2020,5881,1164,4717
56958,22,68,2020,1079,252,827
56959,22,5,2020,702013,97819,604194
56960,22,18,2020,32808,7270,25538
56961,22,19,2020,6612,1323,5289
56962,22,20,2020,8425,1673,6752
56963,22,144,2020,1462,289,1173
56964,22,8,2020,253940,48540,205400
56965,22,73,2020,456,110,346
56966,22,162,2020,4145,823,3322
56967,22,9,2020,235505,32248,203257
56968,22,23,2020,911,175,736
56969,22,128,2020,1264,250,1014
56970,22,129,2020,2069,459,1610
56971,22,145,2020,23415,5211,18204
56972,22,25,2020,24749,4913,19836
56973,22,27,2020,9558,2791,6767
56974,22,146,2020,994,195,799
56975,22,26,2020,5137,1018,4119
56976,22,142,2020,183544,37824,145720
56977,22,50,2020,6868,1486,5382
56978,22,28,2020,35517,7055,28462
56979,35,2,2020,44,16,28
56980,35,51,2020,823,211,612
56981,35,141,2020,554,224,330
56982,35,52,2020,17,7,10
56983,35,134,2020,98,28,70
56984,35,75,2020,3,2,1
56985,35,76,2020,0,0,0
56986,35,103,2020,337,166,171
56987,35,11,2020,163,93,70
56988,35,66,2020,3282,1535,1747
56989,35,12,2020,134,51,83
56990,35,78,2020,3,0,3
56991,35,13,2020,19,8,11
56992,35,3,2020,161,8,153
56993,35,79,2020,2,0,2
56994,35,29,2020,243,122,121
56995,35,67,2020,4593,2146,2447
56996,35,95,2020,3,0,3
56997,35,151,2020,41,14,27
56998,35,4,2020,6,3,3
56999,35,53,2020,160,53,107
57000,35,147,2020,7,3,4
57001,35,105,2020,690,407,283
57002,35,30,2020,11846,7005,4841
57003,35,152,2020,64,8,56
57004,35,116,2020,9,2,7
57005,35,153,2020,82,47,35
57006,35,135,2020,367,119,248
57007,35,80,2020,2,2,0
57008,35,136,2020,29,3,26
57009,35,106,2020,157,88,69
57010,35,172,2020,6544,2962,3582
57011,35,107,2020,163,84,79
57012,35,117,2020,12,5,7
57013,35,137,2020,119,44,75
57014,35,96,2020,76,31,45
57015,35,54,2020,373,90,283
57016,35,81,2020,275,76,199
57017,35,14,2020,1528,726,802
57018,35,31,2020,841,390,451
57019,35,176,2020,20,10,10
57020,35,137,2020,76,44,32
57021,35,39,2020,2001,911,1090
57022,35,118,2020,9,0,9
57023,35,82,2020,11,8,3
57024,35,83,2020,203,98,105
57025,35,108,2020,254,177,77
57026,35,142,2020,592,171,421
57027,35,97,2020,67,33,34
57028,35,138,2020,181,119,62
57029,35,119,2020,52,0,52
57030,35,40,2020,122,65,57
57031,35,148,2020,7,4,3
57032,35,120,2020,78,45,33
57033,35,41,2020,3,2,1
57034,35,42,2020,420,204,216
57035,35,68,2020,21756,9926,11830
57036,35,139,2020,49,24,25
57037,35,155,2020,150,16,134
57038,35,15,2020,254,102,152
57039,35,69,2020,30498,14234,16264
57040,35,156,2020,303,72,231
57041,35,55,2020,8,3,5
57042,35,56,2020,8458,3527,4931
57043,35,84,2020,5,0,5
57044,35,98,2020,86,35,51
57045,35,157,2020,284,62,222
57046,35,158,2020,156,46,110
57047,35,110,2020,5,0,5
57048,35,85,2020,23,15,8
57049,35,99,2020,109,75,34
57050,35,32,2020,10491,5588,4903
57051,35,43,2020,102,51,51
57052,35,5,2020,544,170,374
57053,35,6,2020,1516,367,1149
57054,35,16,2020,1558,467,1091
57055,35,44,2020,3769,1799,1970
57056,35,45,2020,3,2,1
57057,35,17,2020,4901,1490,3411
57058,35,57,2020,79752,35744,44008
57059,35,86,2020,19,9,10
57060,35,177,2020,342,150,192
57061,35,18,2020,435,93,342
57062,35,167,2020,412,202,210
57063,35,121,2020,55,32,23
57064,35,19,2020,132,45,87
57065,35,168,2020,74,41,33
57066,35,46,2020,326,161,165
57067,35,20,2020,662,169,493
57068,35,159,2020,15,4,11
57069,35,143,2020,138,51,87
57070,35,70,2020,5,3,2
57071,35,47,2020,354,174,180
57072,35,71,2020,303,149,154
57073,35,122,2020,23,16,7
57074,35,123,2020,7,3,4
57075,35,7,2020,15,7,8
57076,35,160,2020,467,32,435
57077,35,58,2020,104,46,58
57078,35,161,2020,207,47,160
57079,35,124,2020,17,10,7
57080,35,100,2020,462,245,217
57081,35,72,2020,23,9,14
57082,35,59,2020,44,22,22
57083,35,144,2020,1265,468,797
57084,35,125,2020,19,8,11
57085,35,150,2020,6,4,2
57086,35,8,2020,677,129,548
57087,35,73,2020,1803,702,1101
57088,35,101,2020,235,212,23
57089,35,162,2020,468,257,211
57090,35,60,2020,242,136,106
57091,35,48,2020,1378,667,711
57092,35,21,2020,30,14,16
57093,35,9,2020,625,187,438
57094,35,102,2020,44,20,24
57095,35,111,2020,160,114,46
57096,35,112,2020,224,119,105
57097,35,33,2020,1379,655,724
57098,35,61,2020,2430,1062,1368
57099,35,22,2020,87,38,49
57100,35,36,2020,9608,5735,3873
57101,35,126,2020,19,3,16
57102,35,91,2020,1,0,1
57103,35,92,2020,0,0,0
57104,35,62,2020,8,7,1
57105,35,140,2020,3,2,1
57106,35,23,2020,297,84,213
57107,35,164,2020,171,57,114
57108,35,63,2020,2926,1262,1664
57109,35,165,2020,46,20,26
57110,35,37,2020,579,307,272
57111,35,64,2020,123,54,69
57112,35,128,2020,89,25,64
57113,35,115,2020,89,26,63
57114,35,65,2020,61861,29489,32372
57115,35,10,2020,747,166,581
57116,35,145,2020,17,9,8
57117,35,113,2020,9,0,9
57118,35,49,2020,1323,611,712
57119,35,74,2020,1080,449,631
57120,35,25,2020,3138,742,2396
57121,35,169,2020,35,17,18
57122,35,166,2020,18,9,9
57123,35,93,2020,32,17,15
57124,35,146,2020,1924,605,1319
57125,35,26,2020,9206,2273,6933
57126,35,170,2020,154,42,112
57127,35,130,2020,23,15,8
57128,35,38,2020,43363,17487,25876
57129,35,27,2020,514,226,288
57130,35,50,2020,31593,14918,16675
57131,35,131,2020,25,15,10
57132,35,114,2020,207,90,117
57133,35,171,2020,129,45,84
57134,35,1,2020,2383,273,2110
57135,35,28,2020,87,20,67
57136,35,132,2020,105,52,53
57137,35,133,2020,18,11,7
57138,36,2,2020,5090,1194,3896
57139,36,51,2020,232,95,137
57140,36,141,2020,776,230,546
57141,36,134,2020,509,99,410
57142,36,12,2020,766918,342067,424851
57143,36,103,2020,250,95,155
57144,36,66,2020,2950,1550,1400
57145,36,3,2020,469,62,407
57146,36,11,2020,526997,231284,295713
57147,36,67,2020,469,206,263
57148,36,53,2020,513,61,452
57149,36,147,2020,26,17,9
57150,36,105,2020,431,196,235
57151,36,30,2020,5836,1875,3961
57152,36,116,2020,129,19,110
57153,36,29,2020,763879,436567,327312
57154,36,135,2020,332,66,266
57155,36,153,2020,43,17,26
57156,36,10,2020,586,256,330
57157,36,136,2020,150,24,126
57158,36,106,2020,105,39,66
57159,36,172,2020,56138,24693,31445
57160,36,107,2020,204,62,142
57161,36,117,2020,86,42,44
57162,36,137,2020,578,144,434
57163,36,96,2020,30,13,17
57164,36,54,2020,319,85,234
57165,36,81,2020,2224,856,1368
57166,36,14,2020,714,352,362
57167,36,31,2020,11249,5641,5608
57168,36,151,2020,92,21,71
57169,36,39,2020,229,103,126
57170,36,108,2020,239,73,166
57171,36,138,2020,102,35,67
57172,36,120,2020,270,65,205
57173,36,40,2020,58718,31559,27159
57174,36,42,2020,2207,1196,1011
57175,36,68,2020,2564,1137,1427
57176,36,15,2020,449973,208998,240975
57177,36,69,2020,141947,71946,70001
57178,36,156,2020,314,63,251
57179,36,56,2020,1950,837,1113
57180,36,157,2020,202,43,159
57181,36,173,2020,58,22,36
57182,36,32,2020,16831,8453,8378
57183,36,43,2020,42,21,21
57184,36,5,2020,5696,1445,4251
57185,36,6,2020,2010,695,1315
57186,36,16,2020,984,184,800
57187,36,44,2020,173,84,89
57188,36,17,2020,3646,1642,2004
57189,36,57,2020,1894,724,1170
57190,36,177,2020,1023,508,515
57191,36,167,2020,2558907,1381584,1177323
57192,36,18,2020,814,142,672
57193,36,121,2020,449,152,297
57194,36,176,2020,10617,2418,8199
57195,36,19,2020,83,27,56
57196,36,168,2020,591025,303936,287089
57197,36,20,2020,966,159,807
57198,36,46,2020,89338,47771,41567
57199,36,143,2020,268,98,170
57200,36,47,2020,71038,37856,33182
57201,36,71,2020,34,13,21
57202,36,122,2020,82,24,58
57203,36,123,2020,27,10,17
57204,36,7,2020,43,25,18
57205,36,160,2020,71,5,66
57206,36,58,2020,52,23,29
57207,36,124,2020,62,16,46
57208,36,100,2020,202,105,97
57209,36,72,2020,43,28,15
57210,36,59,2020,261,52,209
57211,36,144,2020,1099,338,761
57212,36,125,2020,109,32,77
57213,36,21,2020,50,18,32
57214,36,150,2020,119,47,72
57215,36,8,2020,173,19,154
57216,36,73,2020,546,230,316
57217,36,101,2020,58,14,44
57218,36,162,2020,794,151,643
57219,36,48,2020,699,381,318
57220,36,9,2020,726,147,579
57221,36,102,2020,23,3,20
57222,36,111,2020,34,18,16
57223,36,112,2020,275,76,199
57224,36,33,2020,29190,15333,13857
57225,36,61,2020,230,103,127
57226,36,158,2020,129,36,93
57227,36,22,2020,24,10,14
57228,36,35,2020,3908,2193,1715
57229,36,126,2020,43,16,27
57230,36,75,2020,47,10,37
57231,36,62,2020,44,28,16
57232,36,23,2020,217,62,155
57233,36,164,2020,71,20,51
57234,36,37,2020,1830,871,959
57235,36,1,2020,13662,5113,8549
57236,36,64,2020,348,117,231
57237,36,128,2020,57,6,51
57238,36,115,2020,238,107,131
57239,36,133,2020,71,28,43
57240,36,65,2020,1392,645,747
57241,36,145,2020,256,23,233
57242,36,49,2020,473,226,247
57243,36,74,2020,578,287,291
57244,36,25,2020,3262,509,2753
57245,36,169,2020,466252,191057,275195
57246,36,27,2020,353,148,205
57247,36,146,2020,333,71,262
57248,36,26,2020,10230,2166,8064
57249,36,170,2020,185561,97054,88507
57250,36,130,2020,80,33,47
57251,36,38,2020,3268263,1750294,1517969
57252,36,60,2020,253,45,208
57253,36,142,2020,1058,327,731
57254,36,50,2020,1739,766,973
57255,36,131,2020,215,72,143
57256,36,152,2020,443,248,195
57257,36,114,2020,119,65,54
57258,36,171,2020,1146175,546864,599311
57259,36,28,2020,646,65,581
57260,36,132,2020,469,139,330
57261,126,116,2020,131063,65016,66047
57262,126,137,2020,236657,119532,117125
57263,126,121,2020,2575,1064,1511
57264,126,130,2020,92061,43695,48366
57265,126,131,2020,42713,20958,21755
57266,90,76,2020,417,213,204
57267,90,78,2020,23,8,15
57268,90,79,2020,98,51,47
57269,90,82,2020,206,96,110
57270,90,84,2020,58,25,33
57271,90,110,2020,805,376,429
57272,90,86,2020,144,72,72
57273,90,87,2020,445,220,225
57274,90,91,2020,104,45,59
57275,90,92,2020,173,82,91
57276,90,93,2020,275,117,158
57277,91,76,2020,85,42,43
57278,91,66,2020,8,2,6
57279,91,78,2020,9,0,9
57280,91,79,2020,403,204,199
57281,91,67,2020,7,1,6
57282,91,105,2020,6,0,6
57283,91,95,2020,0,0,0
57284,91,80,2020,8,0,8
57285,91,172,2020,49,24,25
57286,91,81,2020,79,44,35
57287,91,82,2020,249,120,129
57288,91,83,2020,35,19,16
57289,91,120,2020,0,0,0
57290,91,68,2020,51,15,36
57291,91,109,2020,135,87,48
57292,91,69,2020,47,28,19
57293,91,156,2020,16,4,12
57294,91,84,2020,160,64,96
57295,91,98,2020,1,0,1
57296,91,110,2020,2111,1181,930
57297,91,85,2020,22,9,13
57298,91,5,2020,214,89,125
57299,91,44,2020,15,5,10
57300,91,57,2020,12,5,7
57301,91,86,2020,373,223,150
57302,91,177,2020,8,6,2
57303,91,20,2020,0,0,0
57304,91,100,2020,16,14,2
57305,91,87,2020,27,13,14
57306,91,73,2020,10,1,9
57307,91,77,2020,27,16,11
57308,91,162,2020,65,46,19
57309,91,9,2020,0,0,0
57310,91,102,2020,5,0,5
57311,91,88,2020,6,0,6
57312,91,90,2020,33,17,16
57313,91,75,2020,3,0,3
57314,91,92,2020,314,190,124
57315,91,115,2020,3,0,3
57316,91,133,2020,0,0,0
57317,91,113,2020,20,10,10
57318,91,74,2020,7,1,6
57319,91,25,2020,130,28,102
57320,91,93,2020,504,267,237
57321,91,50,2020,759,396,363
57322,92,76,2020,56,23,33
57323,92,79,2020,355,148,207
57324,92,82,2020,86,46,40
57325,92,84,2020,450,246,204
57326,92,110,2020,249,132,117
57327,92,86,2020,125,64,61
57328,92,90,2020,37,27,10
57329,92,91,2020,241,135,106
57330,92,93,2020,1011,493,518
57331,92,50,2020,829,377,452
57332,62,57,2020,4749,1965,2784
57333,62,51,2020,39,32,7
57334,62,33,2020,32,30,2
57335,62,35,2020,145,127,18
57336,62,38,2020,68,57,11
57337,62,36,2020,38,38,0
57338,62,68,2020,30,21,9
57339,62,103,2020,90,46,44
57340,62,105,2020,30,29,1
57341,140,134,2020,319,190,129
57342,140,153,2020,1220,636,584
57343,140,138,2020,129,82,47
57344,140,139,2020,210,61,149
57345,140,125,2020,102,18,84
57346,140,61,2020,104,49,55
57347,23,2,2020,481215,150916,330299
57348,23,3,2020,1277624,312535,965089
57349,23,10,2020,529336,167286,362050
57350,23,120,2020,164250,50963,113287
57351,23,5,2020,2502337,761244,1741093
57352,23,16,2020,6075,2675,3400
57353,23,18,2020,240606,75457,165149
57354,23,20,2020,153988,48291,105697
57355,23,8,2020,503404,110512,392892
57356,23,9,2020,1483737,437408,1046329
57357,23,145,2020,481215,150916,330299
57358,23,25,2020,823261,338228,485033
57359,23,142,2020,962432,301837,660595
57360,23,28,2020,769945,255471,514474
57361,164,141,2020,4338,2720,1618
57362,164,105,2020,670,338,332
57363,164,135,2020,1050,633,417
57364,164,137,2020,362,175,187
57365,164,151,2020,3740,1791,1949
57366,164,68,2020,14357,7272,7085
57367,164,155,2020,5622,3076,2546
57368,164,69,2020,904,438,466
57369,164,156,2020,1845,405,1440
57370,164,157,2020,53430,19384,34046
57371,164,20,2020,1140,395,745
57372,164,159,2020,448,217,231
57373,164,160,2020,35360,15586,19774
57374,164,161,2020,46376,21557,24819
57375,164,144,2020,4268,2161,2107
57376,164,162,2020,848,213,635
57377,164,158,2020,30550,16877,13673
57378,164,126,2020,282,137,145
57379,164,23,2020,1476,757,719
57380,164,165,2020,15453,8109,7344
57381,164,166,2020,1739,572,1167
57382,164,26,2020,87,41,46
57383,63,51,2020,475,387,88
57384,63,141,2020,52,19,33
57385,63,103,2020,48,33,15
57386,63,66,2020,7132,3674,3458
57387,63,11,2020,159,126,33
57388,63,67,2020,220,95,125
57389,63,53,2020,342526,191910,150616
57390,63,105,2020,85,52,33
57391,63,30,2020,1155,848,307
57392,63,29,2020,135,118,17
57393,63,172,2020,1796,820,976
57394,63,54,2020,288708,158795,129913
57395,63,81,2020,28,13,15
57396,63,14,2020,174,80,94
57397,63,31,2020,523,366,157
57398,63,39,2020,184,94,90
57399,63,42,2020,33,18,15
57400,63,68,2020,5490,2878,2612
57401,63,15,2020,47,34,13
57402,63,69,2020,16392,8210,8182
57403,63,156,2020,28,9,19
57404,63,56,2020,930,472,458
57405,63,32,2020,1833,1236,597
57406,63,5,2020,299,172,127
57407,63,6,2020,65,5,60
57408,63,16,2020,177,60,117
57409,63,44,2020,51,24,27
57410,63,17,2020,109,52,57
57411,63,57,2020,1958,909,1049
57412,63,177,2020,38,21,17
57413,63,167,2020,97,79,18
57414,63,18,2020,99,21,78
57415,63,19,2020,67,26,41
57416,63,20,2020,44,19,25
57417,63,143,2020,379,160,219
57418,63,47,2020,27,20,7
57419,63,71,2020,90,35,55
57420,63,58,2020,52,25,27
57421,63,100,2020,25,14,11
57422,63,59,2020,72596,40621,31975
57423,63,144,2020,32,20,12
57424,63,73,2020,764,365,399
57425,63,48,2020,139,61,78
57426,63,112,2020,48,31,17
57427,63,33,2020,675,593,82
57428,63,61,2020,38,14,24
57429,63,35,2020,3675,3124,551
57430,63,36,2020,2999,2213,786
57431,63,37,2020,484,354,130
57432,63,64,2020,11139,6298,4841
57433,63,115,2020,142,77,65
57434,63,133,2020,27,15,12
57435,63,65,2020,159,71,88
57436,63,49,2020,1212,604,608
57437,63,74,2020,2910,1412,1498
57438,63,25,2020,123,23,100
57439,63,27,2020,23,11,12
57440,63,146,2020,39,9,30
57441,63,26,2020,394,128,266
57442,63,170,2020,28,22,6
57443,63,38,2020,1297,1114,183
57444,63,60,2020,47637,28947,18690
57445,63,142,2020,77,25,52
57446,63,50,2020,658,311,347
57447,63,171,2020,80,74,6
57448,63,132,2020,56,30,26
57449,127,3,2020,223,43,180
57450,127,67,2020,37,23,14
57451,127,10,2020,609,173,436
57452,127,172,2020,519,60,459
57453,127,81,2020,42,23,19
57454,127,68,2020,242,118,124
57455,127,69,2020,85,46,39
57456,127,5,2020,6628,1807,4821
57457,127,57,2020,123,46,77
57458,127,121,2020,415,258,157
57459,127,122,2020,816,156,660
57460,127,7,2020,37,12,25
57461,127,124,2020,564,146,418
57462,127,8,2020,177,19,158
57463,127,162,2020,137,93,44
57464,127,9,2020,23,4,19
57465,127,36,2020,97,56,41
57466,127,128,2020,63,21,42
57467,127,115,2020,258,101,157
57468,127,65,2020,23,17,6
57469,127,130,2020,27,13,14
57470,127,50,2020,295,135,160
57471,165,153,2020,88,20,68
57472,165,136,2020,0,0,0
57473,165,172,2020,187,145,42
57474,165,137,2020,0,0,0
57475,165,151,2020,101,31,70
57476,165,138,2020,0,0,0
57477,165,119,2020,0,0,0
57478,165,155,2020,524,208,316
57479,165,69,2020,32,12,20
57480,165,156,2020,939,380,559
57481,165,157,2020,36058,15684,20374
57482,165,5,2020,959,489,470
57483,165,16,2020,0,0,0
57484,165,177,2020,0,0,0
57485,165,121,2020,26,9,17
57486,165,176,2020,2,0,2
57487,165,20,2020,586,226,360
57488,165,159,2020,9097,4088,5009
57489,165,160,2020,262,114,148
57490,165,161,2020,89,33,56
57491,165,162,2020,2176,881,1295
57492,165,9,2020,86,33,53
57493,165,158,2020,650,261,389
57494,165,36,2020,68,23,45
57495,165,126,2020,0,0,0
57496,165,164,2020,306,131,175
57497,165,1,2020,0,0,0
57498,165,115,2020,77,30,47
57499,165,145,2020,7,2,5
57500,165,166,2020,22,9,13
57501,165,50,2020,141,52,89
57502,165,152,2020,8,3,5
57503,165,132,2020,17,5,12
57504,37,2,2020,194,28,166
57505,37,51,2020,133,19,114
57506,37,141,2020,125,20,105
57507,37,52,2020,0,0,0
57508,37,134,2020,25,5,20
57509,37,103,2020,90,44,46
57510,37,11,2020,169,79,90
57511,37,77,2020,1,1,0
57512,37,66,2020,4722,1975,2747
57513,37,12,2020,56,29,27
57514,37,13,2020,14,7,7
57515,37,3,2020,21,3,18
57516,37,79,2020,1,0,1
57517,37,29,2020,262,176,86
57518,37,67,2020,1029,366,663
57519,37,95,2020,2,0,2
57520,37,151,2020,10,1,9
57521,37,53,2020,463,124,339
57522,37,147,2020,2,2,0
57523,37,105,2020,171,96,75
57524,37,30,2020,2596,814,1782
57525,37,152,2020,1,0,1
57526,37,116,2020,4,1,3
57527,37,135,2020,15,3,12
57528,37,80,2020,1,1,0
57529,37,136,2020,133,76,57
57530,37,106,2020,32,13,19
57531,37,172,2020,1256,583,673
57532,37,107,2020,69,20,49
57533,37,137,2020,23,9,14
57534,37,96,2020,16,5,11
57535,37,54,2020,1242,376,866
57536,37,81,2020,153,44,109
57537,37,14,2020,171,66,105
57538,37,31,2020,89560,49528,40032
57539,37,176,2020,14,7,7
57540,37,137,2020,8,3,5
57541,37,39,2020,326,112,214
57542,37,82,2020,2,2,0
57543,37,83,2020,26,11,15
57544,37,108,2020,48,20,28
57545,37,142,2020,260,14,246
57546,37,97,2020,1,0,1
57547,37,40,2020,69,46,23
57548,37,148,2020,0,0,0
57549,37,120,2020,39,14,25
57550,37,41,2020,0,0,0
57551,37,42,2020,208,97,111
57552,37,68,2020,3043,1347,1696
57553,37,155,2020,4,0,4
57554,37,15,2020,93,36,57
57555,37,69,2020,6202,2164,4038
57556,37,156,2020,27,7,20
57557,37,56,2020,649,224,425
57558,37,84,2020,1,1,0
57559,37,98,2020,5,1,4
57560,37,157,2020,6,0,6
57561,37,158,2020,1,1,0
57562,37,85,2020,4,0,4
57563,37,99,2020,4,0,4
57564,37,32,2020,16291,7863,8428
57565,37,43,2020,97,53,44
57566,37,5,2020,194,47,147
57567,37,6,2020,168,48,120
57568,37,16,2020,215,82,133
57569,37,44,2020,1494,684,810
57570,37,45,2020,3,0,3
57571,37,17,2020,242,76,166
57572,37,57,2020,3918,1045,2873
57573,37,86,2020,15,5,10
57574,37,177,2020,158,89,69
57575,37,18,2020,68,15,53
57576,37,167,2020,290,156,134
57577,37,121,2020,28,15,13
57578,37,19,2020,91,26,65
57579,37,168,2020,33,15,18
57580,37,46,2020,199,118,81
57581,37,20,2020,157,26,131
57582,37,149,2020,3,3,0
57583,37,159,2020,2,1,1
57584,37,143,2020,87,26,61
57585,37,70,2020,7,3,4
57586,37,47,2020,199,122,77
57587,37,71,2020,90,48,42
57588,37,122,2020,18,9,9
57589,37,123,2020,6,1,5
57590,37,7,2020,1,0,1
57591,37,58,2020,45,19,26
57592,37,124,2020,23,10,13
57593,37,100,2020,158,53,105
57594,37,72,2020,5,2,3
57595,37,59,2020,41,15,26
57596,37,144,2020,73,14,59
57597,37,125,2020,3,0,3
57598,37,150,2020,0,0,0
57599,37,8,2020,12,3,9
57600,37,73,2020,780,234,546
57601,37,101,2020,12,2,10
57602,37,162,2020,143,8,135
57603,37,60,2020,883,269,614
57604,37,48,2020,1097,598,499
57605,37,21,2020,4,4,0
57606,37,9,2020,122,12,110
57607,37,102,2020,14,6,8
57608,37,111,2020,7,5,2
57609,37,112,2020,76,21,55
57610,37,33,2020,7367,3837,3530
57611,37,61,2020,283,85,198
57612,37,22,2020,6,3,3
57613,37,35,2020,9763,3513,6250
57614,37,36,2020,3098,1987,1111
57615,37,126,2020,1,0,1
57616,37,90,2020,0,0,0
57617,37,91,2020,0,0,0
57618,37,62,2020,0,0,0
57619,37,140,2020,1,0,1
57620,37,23,2020,48,8,40
57621,37,164,2020,19,3,16
57622,37,63,2020,2463,893,1570
57623,37,127,2020,6,3,3
57624,37,165,2020,1,0,1
57625,37,64,2020,380,118,262
57626,37,128,2020,17,8,9
57627,37,115,2020,154,44,110
57628,37,65,2020,1304,583,721
57629,37,10,2020,24,12,12
57630,37,145,2020,18,2,16
57631,37,49,2020,342,140,202
57632,37,74,2020,1045,468,577
57633,37,25,2020,289,61,228
57634,37,169,2020,13,7,6
57635,37,166,2020,2,0,2
57636,37,93,2020,8,2,6
57637,37,146,2020,200,16,184
57638,37,26,2020,405,66,339
57639,37,170,2020,13,9,4
57640,37,130,2020,11,7,4
57641,37,38,2020,11582,6815,4767
57642,37,27,2020,127,51,76
57643,37,50,2020,9187,4102,5085
57644,37,131,2020,0,0,0
57645,37,114,2020,18,10,8
57646,37,171,2020,59,28,31
57647,37,1,2020,2373,949,1424
57648,37,28,2020,41,7,34
57649,37,132,2020,11,3,8
57650,37,133,2020,6,4,2
57651,64,2,2020,36,0,36
57652,64,51,2020,146,99,47
57653,64,141,2020,40,10,30
57654,64,134,2020,2,2,0
57655,64,103,2020,435,207,228
57656,64,11,2020,17,10,7
57657,64,77,2020,0,0,0
57658,64,66,2020,2814,1383,1431
57659,64,12,2020,40,19,21
57660,64,78,2020,0,0,0
57661,64,3,2020,20,1,19
57662,64,79,2020,1,1,0
57663,64,29,2020,213,137,76
57664,64,67,2020,331,152,179
57665,64,95,2020,1,1,0
57666,64,151,2020,0,0,0
57667,64,53,2020,122235,45179,77056
57668,64,147,2020,1,0,1
57669,64,105,2020,199,128,71
57670,64,30,2020,1398,537,861
57671,64,152,2020,5,0,5
57672,64,116,2020,3,1,2
57673,64,153,2020,3,1,2
57674,64,135,2020,21,3,18
57675,64,136,2020,0,0,0
57676,64,106,2020,38,14,24
57677,64,172,2020,1113,519,594
57678,64,107,2020,68,45,23
57679,64,117,2020,0,0,0
57680,64,137,2020,3,2,1
57681,64,96,2020,5,2,3
57682,64,54,2020,46599,23372,23227
57683,64,81,2020,95,50,45
57684,64,14,2020,10,5,5
57685,64,31,2020,382,262,120
57686,64,176,2020,0,0,0
57687,64,137,2020,11,4,7
57688,64,39,2020,69,33,36
57689,64,82,2020,0,0,0
57690,64,83,2020,199,162,37
57691,64,108,2020,10,7,3
57692,64,142,2020,142,27,115
57693,64,97,2020,1,1,0
57694,64,119,2020,64,7,57
57695,64,40,2020,24,13,11
57696,64,120,2020,15,7,8
57697,64,42,2020,39,21,18
57698,64,68,2020,1182,577,605
57699,64,139,2020,0,0,0
57700,64,155,2020,19,1,18
57701,64,15,2020,31,13,18
57702,64,69,2020,7682,3651,4031
57703,64,156,2020,59,24,35
57704,64,56,2020,127,55,72
57705,64,98,2020,1,1,0
57706,64,157,2020,6,3,3
57707,64,158,2020,35,12,23
57708,64,110,2020,0,0,0
57709,64,85,2020,1,1,0
57710,64,99,2020,2,1,1
57711,64,32,2020,467,274,193
57712,64,43,2020,4,4,0
57713,64,5,2020,234,61,173
57714,64,6,2020,161,58,103
57715,64,16,2020,113,40,73
57716,64,44,2020,58,24,34
57717,64,17,2020,50,16,34
57718,64,57,2020,4511,1786,2725
57719,64,86,2020,6,1,5
57720,64,177,2020,98,54,44
57721,64,18,2020,67,15,52
57722,64,167,2020,207,120,87
57723,64,121,2020,35,20,15
57724,64,19,2020,12,3,9
57725,64,168,2020,19,14,5
57726,64,46,2020,64,46,18
57727,64,20,2020,26,1,25
57728,64,159,2020,12,4,8
57729,64,143,2020,56,20,36
57730,64,70,2020,6,2,4
57731,64,47,2020,46,40,6
57732,64,71,2020,39,17,22
57733,64,122,2020,22,17,5
57734,64,123,2020,2,0,2
57735,64,7,2020,3,0,3
57736,64,160,2020,6,2,4
57737,64,58,2020,7,3,4
57738,64,161,2020,0,0,0
57739,64,124,2020,5,1,4
57740,64,100,2020,94,51,43
57741,64,59,2020,3541,1591,1950
57742,64,87,2020,0,0,0
57743,64,144,2020,36,12,24
57744,64,125,2020,3,2,1
57745,64,150,2020,2,1,1
57746,64,8,2020,27,10,17
57747,64,73,2020,374,148,226
57748,64,101,2020,5,5,0
57749,64,162,2020,68,16,52
57750,64,60,2020,19133,7719,11414
57751,64,48,2020,30,13,17
57752,64,21,2020,0,0,0
57753,64,9,2020,42,11,31
57754,64,102,2020,1,0,1
57755,64,111,2020,3,0,3
57756,64,112,2020,61,34,27
57757,64,33,2020,399,286,113
57758,64,61,2020,64,25,39
57759,64,22,2020,1,0,1
57760,64,35,2020,442,269,173
57761,64,36,2020,3572,2014,1558
57762,64,126,2020,1,1,0
57763,64,62,2020,0,0,0
57764,64,140,2020,0,0,0
57765,64,23,2020,26,5,21
57766,64,164,2020,3,1,2
57767,64,63,2020,47393,18171,29222
57768,64,165,2020,4,0,4
57769,64,37,2020,577,389,188
57770,64,128,2020,25,7,18
57771,64,115,2020,83,40,43
57772,64,65,2020,204,99,105
57773,64,10,2020,19,10,9
57774,64,145,2020,17,4,13
57775,64,113,2020,0,0,0
57776,64,49,2020,339,160,179
57777,64,74,2020,978,454,524
57778,64,25,2020,247,96,151
57779,64,169,2020,11,7,4
57780,64,166,2020,0,0,0
57781,64,93,2020,5,2,3
57782,64,146,2020,86,15,71
57783,64,26,2020,237,64,173
57784,64,170,2020,11,6,5
57785,64,130,2020,6,4,2
57786,64,38,2020,2806,1806,1000
57787,64,27,2020,21,15,6
57788,64,50,2020,740,299,441
57789,64,131,2020,2,1,1
57790,64,114,2020,13,7,6
57791,64,171,2020,78,46,32
57792,64,1,2020,24,21,3
57793,64,28,2020,14,5,9
57794,64,132,2020,6,3,3
57795,64,133,2020,18,8,10
57796,128,120,2020,21764,10210,11554
57797,128,119,2020,36,15,21
57798,128,28,2020,13285,6202,7083
57799,115,2,2020,111,42,69
57800,115,51,2020,195,103,92
57801,115,141,2020,537,125,412
57802,115,134,2020,47945,21163,26782
57803,115,103,2020,2854,1385,1469
57804,115,66,2020,6495,2611,3884
57805,115,13,2020,197,77,120
57806,115,3,2020,15565,1299,14266
57807,115,79,2020,33,12,21
57808,115,29,2020,286,136,150
57809,115,67,2020,9577,4177,5400
57810,115,151,2020,231,78,153
57811,115,53,2020,243,132,111
57812,115,147,2020,50475,17348,33127
57813,115,105,2020,3535,1742,1793
57814,115,30,2020,4738,2094,2644
57815,115,116,2020,7894,3956,3938
57816,115,135,2020,2974,830,2144
57817,115,106,2020,803,359,444
57818,115,172,2020,6914,2517,4397
57819,115,107,2020,714,422,292
57820,115,117,2020,234,28,206
57821,115,137,2020,23713,9059,14654
57822,115,54,2020,1205,527,678
57823,115,81,2020,1846,718,1128
57824,115,14,2020,5918,2688,3230
57825,115,31,2020,2401,1024,1377
57826,115,176,2020,163,118,45
57827,115,137,2020,63892,29162,34730
57828,115,39,2020,3044,1337,1707
57829,115,142,2020,5564,2381,3183
57830,115,119,2020,688,269,419
57831,115,40,2020,172,28,144
57832,115,120,2020,44181,12722,31459
57833,115,42,2020,780,517,263
57834,115,68,2020,9124,4166,4958
57835,115,139,2020,373,149,224
57836,115,69,2020,16595,8482,8113
57837,115,156,2020,8034,2442,5592
57838,115,55,2020,63,12,51
57839,115,56,2020,10878,4561,6317
57840,115,98,2020,106,28,78
57841,115,157,2020,91,28,63
57842,115,158,2020,33,19,14
57843,115,110,2020,67,32,35
57844,115,173,2020,1943,892,1051
57845,115,43,2020,34,5,29
57846,115,5,2020,29935,12474,17461
57847,115,6,2020,847,379,468
57848,115,16,2020,197,44,153
57849,115,44,2020,14582,7503,7079
57850,115,17,2020,5382,2356,3026
57851,115,57,2020,28122,12076,16046
57852,115,86,2020,231,128,103
57853,115,177,2020,2106,1050,1056
57854,115,18,2020,67,23,44
57855,115,121,2020,19901,10099,9802
57856,115,19,2020,106,27,79
57857,115,168,2020,42,23,19
57858,115,46,2020,503,150,353
57859,115,20,2020,1114,476,638
57860,115,149,2020,192008,106807,85201
57861,115,159,2020,904,520,384
57862,115,143,2020,195,32,163
57863,115,47,2020,482,252,230
57864,115,71,2020,29,19,10
57865,115,122,2020,515,273,242
57866,115,123,2020,94119,24777,69342
57867,115,7,2020,67,19,48
57868,115,160,2020,126,55,71
57869,115,58,2020,408,254,154
57870,115,124,2020,10243,4631,5612
57871,115,100,2020,343,168,175
57872,115,72,2020,29,3,26
57873,115,144,2020,1307,427,880
57874,115,125,2020,350463,116062,234401
57875,115,150,2020,36671,18549,18122
57876,115,8,2020,150,52,98
57877,115,73,2020,10186,5180,5006
57878,115,101,2020,130,74,56
57879,115,162,2020,36210,7899,28311
57880,115,48,2020,1350,738,612
57881,115,21,2020,35,12,23
57882,115,9,2020,13325,2606,10719
57883,115,102,2020,68,28,40
57884,115,111,2020,140,64,76
57885,115,112,2020,243,101,142
57886,115,33,2020,11900,5413,6487
57887,115,61,2020,11861,5880,5981
57888,115,35,2020,1948,948,1000
57889,115,36,2020,4090,1957,2133
57890,115,126,2020,5690,3100,2590
57891,115,90,2020,29,9,20
57892,115,23,2020,744,314,430
57893,115,164,2020,3325,269,3056
57894,115,63,2020,4670,2127,2543
57895,115,127,2020,804,444,360
57896,115,165,2020,595,186,409
57897,115,37,2020,507,125,382
57898,115,128,2020,58491,28537,29954
57899,115,65,2020,1767,782,985
57900,115,10,2020,1186,522,664
57901,115,145,2020,3651,1548,2103
57902,115,148,2020,45435,23361,22074
57903,115,49,2020,287,117,170
57904,115,74,2020,2365,1176,1189
57905,115,25,2020,138,64,74
57906,115,60,2020,143,28,115
57907,115,93,2020,29,12,17
57908,115,146,2020,140,56,84
57909,115,26,2020,1359,441,918
57910,115,130,2020,5852,2190,3662
57911,115,38,2020,4588,2316,2272
57912,115,27,2020,214,99,115
57913,115,50,2020,67382,35163,32219
57914,115,131,2020,11544,3726,7818
57915,115,114,2020,135,32,103
57916,115,1,2020,192,103,89
57917,115,28,2020,96,42,54
57918,115,132,2020,22901,11927,10974
57919,115,133,2020,690243,310278,379965
57920,129,136,2020,5315,2115,3200
57921,129,137,2020,93982,43232,50750
57922,129,142,2020,5275,2098,3177
57923,129,119,2020,3402,1353,2049
57924,129,120,2020,13110,6157,6953
57925,129,5,2020,1449,576,873
57926,129,121,2020,9800,3899,5901
57927,129,143,2020,156,68,88
57928,129,160,2020,208,83,125
57929,129,162,2020,3626,1442,2184
57930,129,145,2020,587668,301724,285944
57931,129,130,2020,151003,73100,77903
57932,65,2,2020,615,150,465
57933,65,51,2020,2615,1220,1395
57934,65,141,2020,61611,24694,36917
57935,65,52,2020,7964,4181,3783
57936,65,134,2020,4795,2182,2613
57937,65,103,2020,284921,141308,143613
57938,65,11,2020,12845,6655,6190
57939,65,66,2020,11936,6577,5359
57940,65,12,2020,831,457,374
57941,65,78,2020,77,40,37
57942,65,13,2020,74,29,45
57943,65,3,2020,14594,4450,10144
57944,65,79,2020,56,28,28
57945,65,29,2020,5245,3685,1560
57946,65,67,2020,51896,25507,26389
57947,65,95,2020,44,27,17
57948,65,151,2020,536,170,366
57949,65,53,2020,2858,1499,1359
57950,65,105,2020,133244,83318,49926
57951,65,30,2020,119741,60315,59426
57952,65,152,2020,1547,442,1105
57953,65,116,2020,141,78,63
57954,65,153,2020,5999,3603,2396
57955,65,135,2020,6990,2819,4171
57956,65,136,2020,163,42,121
57957,65,106,2020,61798,32677,29121
57958,65,172,2020,179104,98488,80616
57959,65,107,2020,450377,264676,185701
57960,65,137,2020,2840,1172,1668
57961,65,96,2020,4505,2530,1975
57962,65,54,2020,2272,1199,1073
57963,65,81,2020,162368,89340,73028
57964,65,14,2020,493,237,256
57965,65,31,2020,11539,7087,4452
57966,65,176,2020,153,85,68
57967,65,137,2020,1980,814,1166
57968,65,39,2020,11659,5797,5862
57969,65,118,2020,26,7,19
57970,65,82,2020,1302,885,417
57971,65,83,2020,184832,111964,72868
57972,65,108,2020,430275,230437,199838
57973,65,142,2020,5571,1870,3701
57974,65,97,2020,12408,8104,4304
57975,65,138,2020,22528,14060,8468
57976,65,119,2020,183,76,107
57977,65,40,2020,2529,1617,912
57978,65,120,2020,5012,2343,2669
57979,65,42,2020,13200,7415,5785
57980,65,68,2020,221373,114097,107276
57981,65,139,2020,374,195,179
57982,65,155,2020,19489,4531,14958
57983,65,15,2020,11824,6526,5298
57984,65,69,2020,200659,102903,97756
57985,65,156,2020,13778,4327,9451
57986,65,56,2020,5373,2303,3070
57987,65,84,2020,839,430,409
57988,65,98,2020,10002,6300,3702
57989,65,157,2020,10911,3786,7125
57990,65,158,2020,7246,1675,5571
57991,65,110,2020,148,80,68
57992,65,85,2020,976,448,528
57993,65,99,2020,99418,72762,26656
57994,65,32,2020,12548,6949,5599
57995,65,43,2020,1513,829,684
57996,65,5,2020,47114,18605,28509
57997,65,6,2020,7947,3372,4575
57998,65,16,2020,2467,944,1523
57999,65,44,2020,16100,7787,8313
58000,65,17,2020,3856,1496,2360
58001,65,57,2020,153583,63449,90134
58002,65,86,2020,379,203,176
58003,65,177,2020,8271,5277,2994
58004,65,18,2020,3050,858,2192
58005,65,167,2020,2424,1479,945
58006,65,121,2020,2098,1496,602
58007,65,19,2020,650,221,429
58008,65,168,2020,448,317,131
58009,65,46,2020,5381,3376,2005
58010,65,20,2020,4508,1544,2964
58011,65,159,2020,1104,368,736
58012,65,143,2020,1302,508,794
58013,65,70,2020,153,84,69
58014,65,47,2020,16492,9446,7046
58015,65,71,2020,1921,989,932
58016,65,122,2020,620,425,195
58017,65,123,2020,86,46,40
58018,65,160,2020,18734,3194,15540
58019,65,58,2020,420,216,204
58020,65,161,2020,8879,2745,6134
58021,65,124,2020,324,152,172
58022,65,100,2020,60854,35795,25059
58023,65,72,2020,315,169,146
58024,65,59,2020,225,97,128
58025,65,144,2020,785884,355176,430708
58026,65,125,2020,1615,828,787
58027,65,150,2020,168,94,74
58028,65,8,2020,4232,1679,2553
58029,65,73,2020,51778,24925,26853
58030,65,101,2020,42784,31221,11563
58031,65,162,2020,29016,12889,16127
58032,65,60,2020,845,424,421
58033,65,48,2020,15024,7567,7457
58034,65,21,2020,66,24,42
58035,65,9,2020,63819,22745,41074
58036,65,102,2020,5730,3386,2344
58037,65,111,2020,77926,54147,23779
58038,65,112,2020,226473,128061,98412
58039,65,33,2020,63466,35600,27866
58040,65,61,2020,108063,47803,60260
58041,65,22,2020,121,41,80
58042,65,35,2020,613336,313051,300285
58043,65,36,2020,96126,61777,34349
58044,65,126,2020,381,176,205
58045,65,91,2020,59,27,32
58046,65,62,2020,48,24,24
58047,65,140,2020,252,129,123
58048,65,23,2020,1140,426,714
58049,65,164,2020,59549,14477,45072
58050,65,63,2020,5264,2760,2504
58051,65,127,2020,52,28,24
58052,65,165,2020,1382,452,930
58053,65,37,2020,9849,5795,4054
58054,65,64,2020,1382,750,632
58055,65,128,2020,366,142,224
58056,65,115,2020,3817,1836,1981
58057,65,10,2020,846,328,518
58058,65,145,2020,524,161,363
58059,65,113,2020,291,176,115
58060,65,49,2020,21562,11666,9896
58061,65,74,2020,65924,33308,32616
58062,65,25,2020,16938,5855,11083
58063,65,169,2020,112,54,58
58064,65,166,2020,684,222,462
58065,65,93,2020,276,181,95
58066,65,146,2020,3688,1223,2465
58067,65,26,2020,5356,2065,3291
58068,65,170,2020,79,54,25
58069,65,130,2020,282,138,144
58070,65,38,2020,106373,61744,44629
58071,65,27,2020,438,191,247
58072,65,50,2020,303193,152269,150924
58073,65,131,2020,486,254,232
58074,65,114,2020,81427,40659,40768
58075,65,171,2020,865,570,295
58076,65,1,2020,2205,1211,994
58077,65,28,2020,187,51,136
58078,65,132,2020,198,107,91
58079,65,133,2020,451,226,225
58080,10,2,2020,132,61,71
58081,10,13,2020,402,192,210
58082,10,3,2020,673,173,500
58083,10,4,2020,233,101,132
58084,10,172,2020,2481,300,2181
58085,10,14,2020,251,121,130
58086,10,42,2020,60,40,20
58087,10,68,2020,300,141,159
58088,10,69,2020,560,251,309
58089,10,56,2020,89,39,50
58090,10,85,2020,36,20,16
58091,10,5,2020,10837,5234,5603
58092,10,6,2020,104,38,66
58093,10,16,2020,39,17,22
58094,10,17,2020,54,17,37
58095,10,57,2020,5168,2660,2508
58096,10,177,2020,848,448,400
58097,10,18,2020,276,148,128
58098,10,19,2020,1753,919,834
58099,10,20,2020,741,388,353
58100,10,143,2020,39,14,25
58101,10,7,2020,1408,848,560
58102,10,21,2020,331,174,157
58103,10,8,2020,343,114,229
58104,10,48,2020,117,57,60
58105,10,9,2020,1083,483,600
58106,10,61,2020,32,16,16
58107,10,22,2020,275,123,152
58108,10,36,2020,150,91,59
58109,10,23,2020,1416,661,755
58110,10,127,2020,24,11,13
58111,10,115,2020,262,156,106
58112,10,65,2020,34,19,15
58113,10,49,2020,130,49,81
58114,10,74,2020,290,137,153
58115,10,25,2020,72,37,35
58116,10,27,2020,1688,840,848
58117,10,26,2020,44,20,24
58118,10,142,2020,131,42,89
58119,10,50,2020,1192,592,600
58120,145,136,2020,103065,51770,51295
58121,145,172,2020,1536,754,782
58122,145,137,2020,10297,4064,6233
58123,145,120,2020,70173,37199,32974
58124,145,119,2020,220960,109150,111810
58125,145,5,2020,1764,865,899
58126,145,121,2020,3561,1750,1811
58127,145,143,2020,2153,1057,1096
58128,145,160,2020,938,463,475
58129,145,162,2020,20508,10068,10440
58130,145,128,2020,179,91,88
58131,145,129,2020,867593,439105,428488
58132,145,130,2020,1728,863,865
58133,145,142,2020,18566,9114,9452
58134,113,105,2020,5566,2505,3061
58135,113,172,2020,5446,2453,2993
58136,113,110,2020,13557,6105,7452
58137,113,73,2020,3476,1566,1910
58138,49,2,2020,53306,18827,34479
58139,49,51,2020,5724,2448,3276
58140,49,141,2020,3451,1271,2180
58141,49,52,2020,4,3,1
58142,49,134,2020,812,421,391
58143,49,76,2020,5,1,4
58144,49,103,2020,3503,1667,1836
58145,49,11,2020,3233,1685,1548
58146,49,66,2020,5901,2743,3158
58147,49,12,2020,3534,1816,1718
58148,49,78,2020,35,11,24
58149,49,13,2020,113,41,72
58150,49,3,2020,10263,4274,5989
58151,49,79,2020,119,37,82
58152,49,29,2020,3407,2059,1348
58153,49,67,2020,3073,1389,1684
58154,49,95,2020,13,7,6
58155,49,151,2020,114,34,80
58156,49,4,2020,36,11,25
58157,49,53,2020,60912,30657,30255
58158,49,147,2020,134,76,58
58159,49,105,2020,9533,5823,3710
58160,49,30,2020,9869,4827,5042
58161,49,152,2020,89,37,52
58162,49,116,2020,3351,1784,1567
58163,49,153,2020,419,212,207
58164,49,135,2020,1703,720,983
58165,49,136,2020,136,52,84
58166,49,106,2020,28709,14214,14495
58167,49,172,2020,34767,20655,14112
58168,49,173,2020,0,0,0
58169,49,107,2020,12894,6412,6482
58170,49,117,2020,2,0,2
58171,49,137,2020,894,449,445
58172,49,96,2020,483,251,232
58173,49,54,2020,11446,5346,6100
58174,49,81,2020,2992,1406,1586
58175,49,14,2020,871,390,481
58176,49,31,2020,2309,1230,1079
58177,49,176,2020,86,39,47
58178,49,137,2020,4895,2490,2405
58179,49,39,2020,41033,19252,21781
58180,49,118,2020,457,257,200
58181,49,82,2020,46,20,26
58182,49,83,2020,883,457,426
58183,49,108,2020,2643,1308,1335
58184,49,142,2020,8361,3122,5239
58185,49,97,2020,3200,1594,1606
58186,49,138,2020,54,31,23
58187,49,119,2020,43380,19293,24087
58188,49,40,2020,10351,5768,4583
58189,49,148,2020,30,16,14
58190,49,120,2020,21223,10471,10752
58191,49,42,2020,151661,91833,59828
58192,49,68,2020,11443,4826,6617
58193,49,139,2020,33,15,18
58194,49,155,2020,5501,2241,3260
58195,49,15,2020,1975,1000,975
58196,49,69,2020,52446,27509,24937
58197,49,156,2020,3271,1366,1905
58198,49,55,2020,4,4,0
58199,49,56,2020,19399,8399,11000
58200,49,84,2020,39,10,29
58201,49,98,2020,875,417,458
58202,49,157,2020,655,250,405
58203,49,158,2020,155,62,93
58204,49,110,2020,132,85,47
58205,49,85,2020,154,75,79
58206,49,99,2020,410,206,204
58207,49,32,2020,17227,8790,8437
58208,49,43,2020,6144,3129,3015
58209,49,5,2020,36133,16827,19306
58210,49,6,2020,79363,37418,41945
58211,49,16,2020,147715,68078,79637
58212,49,44,2020,2914,939,1975
58213,49,17,2020,2803,1164,1639
58214,49,57,2020,13527,5244,8283
58215,49,86,2020,420,161,259
58216,49,177,2020,3617,2536,1081
58217,49,18,2020,5001,2194,2807
58218,49,167,2020,2391,1387,1004
58219,49,121,2020,4616,2668,1948
58220,49,19,2020,3618,1530,2088
58221,49,168,2020,1245,721,524
58222,49,46,2020,8434,4354,4080
58223,49,20,2020,28836,12910,15926
58224,49,149,2020,69,35,34
58225,49,159,2020,1006,502,504
58226,49,143,2020,3790,1380,2410
58227,49,70,2020,4,3,1
58228,49,47,2020,15107,7050,8057
58229,49,71,2020,386,202,184
58230,49,122,2020,137,90,47
58231,49,123,2020,104,54,50
58232,49,7,2020,24,11,13
58233,49,160,2020,187,82,105
58234,49,58,2020,203,95,108
58235,49,161,2020,75,17,58
58236,49,124,2020,208,125,83
58237,49,100,2020,3099,1701,1398
58238,49,72,2020,47,20,27
58239,49,59,2020,1254,591,663
58240,49,144,2020,11306,5625,5681
58241,49,125,2020,338,194,144
58242,49,150,2020,158,72,86
58243,49,8,2020,1080,450,630
58244,49,73,2020,12402,5373,7029
58245,49,101,2020,929,512,417
58246,49,162,2020,6096,2267,3829
58247,49,60,2020,8571,4105,4466
58248,49,48,2020,42813,23513,19300
58249,49,21,2020,80,41,39
58250,49,9,2020,16597,6706,9891
58251,49,102,2020,319,179,140
58252,49,111,2020,216,135,81
58253,49,112,2020,8093,4369,3724
58254,49,33,2020,95128,50398,44730
58255,49,61,2020,4253,1957,2296
58256,49,22,2020,315,158,157
58257,49,35,2020,31831,15785,16046
58258,49,36,2020,22166,14485,7681
58259,49,126,2020,748,379,369
58260,49,90,2020,0,0,0
58261,49,91,2020,40,16,24
58262,49,92,2020,18,5,13
58263,49,62,2020,4,3,1
58264,49,140,2020,12,5,7
58265,49,23,2020,6316,2879,3437
58266,49,164,2020,989,346,643
58267,49,63,2020,23696,11358,12338
58268,49,127,2020,70,51,19
58269,49,165,2020,941,437,504
58270,49,37,2020,1907,1025,882
58271,49,64,2020,1411,703,708
58272,49,128,2020,70432,35546,34886
58273,49,115,2020,3208,1385,1823
58274,49,129,2020,91,48,43
58275,49,65,2020,12579,5609,6970
58276,49,10,2020,7487,4177,3310
58277,49,145,2020,6065,2701,3364
58278,49,113,2020,57,28,29
58279,49,74,2020,4123,1939,2184
58280,49,25,2020,190882,83032,107850
58281,49,169,2020,398,205,193
58282,49,166,2020,394,168,226
58283,49,93,2020,306,162,144
58284,49,146,2020,5734,2107,3627
58285,49,26,2020,51223,23022,28201
58286,49,170,2020,258,166,92
58287,49,130,2020,4948,2518,2430
58288,49,38,2020,10176,6568,3608
58289,49,27,2020,3292,1507,1785
58290,49,50,2020,29715,10208,19507
58291,49,131,2020,1945,992,953
58292,49,114,2020,2249,1092,1157
58293,49,171,2020,4343,2138,2205
58294,49,1,2020,20245,10906,9339
58295,49,28,2020,2604,1103,1501
58296,49,132,2020,646,371,275
58297,49,133,2020,690,334,356
58298,74,2,2020,15036,4420,10616
58299,74,51,2020,4323,2273,2050
58300,74,141,2020,10136,4360,5776
58301,74,52,2020,119,56,63
58302,74,134,2020,6936,3527,3409
58303,74,76,2020,67,27,40
58304,74,103,2020,9509,4969,4540
58305,74,11,2020,1133,661,472
58306,74,66,2020,59494,35419,24075
58307,74,12,2020,853,457,396
58308,74,78,2020,144,68,76
58309,74,13,2020,210,102,108
58310,74,3,2020,2761,1079,1682
58311,74,79,2020,90,35,55
58312,74,29,2020,1662,1238,424
58313,74,67,2020,17370,8861,8509
58314,74,95,2020,46,21,25
58315,74,151,2020,672,250,422
58316,74,4,2020,89,47,42
58317,74,53,2020,57678,30277,27401
58318,74,147,2020,83,44,39
58319,74,105,2020,42715,29835,12880
58320,74,30,2020,8600,5579,3021
58321,74,152,2020,731,337,394
58322,74,116,2020,670,384,286
58323,74,153,2020,2806,1438,1368
58324,74,135,2020,8044,5125,2919
58325,74,136,2020,310,170,140
58326,74,106,2020,7622,4055,3567
58327,74,172,2020,25088,14784,10304
58328,74,107,2020,14194,8839,5355
58329,74,117,2020,43,20,23
58330,74,137,2020,1196,576,620
58331,74,96,2020,1097,610,487
58332,74,54,2020,19872,11359,8513
58333,74,81,2020,3574,2009,1565
58334,74,14,2020,535,241,294
58335,74,31,2020,15522,9040,6482
58336,74,176,2020,273,190,83
58337,74,137,2020,7376,3877,3499
58338,74,39,2020,5537,3094,2443
58339,74,118,2020,124,63,61
58340,74,82,2020,399,297,102
58341,74,83,2020,12377,8533,3844
58342,74,108,2020,7615,4446,3169
58343,74,142,2020,6673,2388,4285
58344,74,97,2020,970,550,420
58345,74,138,2020,92,63,29
58346,74,119,2020,37590,15636,21954
58347,74,40,2020,854,590,264
58348,74,148,2020,88,56,32
58349,74,120,2020,8145,4237,3908
58350,74,42,2020,5466,3811,1655
58351,74,68,2020,170155,85927,84228
58352,74,139,2020,320,197,123
58353,74,155,2020,944,172,772
58354,74,15,2020,1098,662,436
58355,74,69,2020,357112,180010,177102
58356,74,156,2020,2867,1446,1421
58357,74,56,2020,14784,6908,7876
58358,74,84,2020,41,22,19
58359,74,98,2020,1144,658,486
58360,74,157,2020,1713,580,1133
58361,74,158,2020,735,238,497
58362,74,110,2020,150,101,49
58363,74,85,2020,1815,1164,651
58364,74,99,2020,740,493,247
58365,74,32,2020,26259,13721,12538
58366,74,43,2020,448,226,222
58367,74,5,2020,22641,10994,11647
58368,74,6,2020,13094,6094,7000
58369,74,16,2020,10567,4167,6400
58370,74,44,2020,4093,1990,2103
58371,74,17,2020,4078,1845,2233
58372,74,57,2020,270077,118251,151826
58373,74,86,2020,844,489,355
58374,74,177,2020,7722,5401,2321
58375,74,18,2020,942,419,523
58376,74,167,2020,3827,2173,1654
58377,74,121,2020,3800,2320,1480
58378,74,19,2020,547,238,309
58379,74,168,2020,686,446,240
58380,74,46,2020,2541,1735,806
58381,74,20,2020,7120,2740,4380
58382,74,149,2020,88,49,39
58383,74,159,2020,422,189,233
58384,74,143,2020,1393,590,803
58385,74,70,2020,2263,1389,874
58386,74,47,2020,2477,1668,809
58387,74,71,2020,2422,1229,1193
58388,74,122,2020,1991,1279,712
58389,74,123,2020,169,83,86
58390,74,7,2020,88,26,62
58391,74,160,2020,521,222,299
58392,74,58,2020,312,172,140
58393,74,161,2020,149,56,93
58394,74,124,2020,2881,2031,850
58395,74,100,2020,7828,4783,3045
58396,74,72,2020,329,186,143
58397,74,59,2020,2932,1548,1384
58398,74,144,2020,18914,10740,8174
58399,74,125,2020,1429,740,689
58400,74,150,2020,321,165,156
58401,74,8,2020,1077,507,570
58402,74,73,2020,23521,12107,11414
58403,74,101,2020,792,494,298
58404,74,162,2020,3832,1360,2472
58405,74,60,2020,69612,33596,36016
58406,74,48,2020,2243,1212,1031
58407,74,21,2020,99,47,52
58408,74,9,2020,5381,2077,3304
58409,74,102,2020,588,329,259
58410,74,111,2020,1267,826,441
58411,74,112,2020,10591,6928,3663
58412,74,33,2020,40957,22206,18751
58413,74,61,2020,218672,100433,118239
58414,74,22,2020,93,40,53
58415,74,35,2020,24386,15249,9137
58416,74,36,2020,24722,16434,8288
58417,74,126,2020,1108,628,480
58418,74,90,2020,9,5,4
58419,74,91,2020,58,25,33
58420,74,92,2020,14,5,9
58421,74,62,2020,26,11,15
58422,74,140,2020,77,39,38
58423,74,23,2020,1336,626,710
58424,74,164,2020,3008,1242,1766
58425,74,63,2020,66207,33976,32231
58426,74,127,2020,235,163,72
58427,74,165,2020,357,140,217
58428,74,37,2020,20099,11143,8956
58429,74,64,2020,6516,3354,3162
58430,74,128,2020,7579,3133,4446
58431,74,115,2020,8324,4417,3907
58432,74,129,2020,32,9,23
58433,74,65,2020,68909,33928,34981
58434,74,10,2020,35755,16666,19089
58435,74,145,2020,2413,1074,1339
58436,74,113,2020,138,90,48
58437,74,49,2020,9520,5302,4218
58438,74,25,2020,19770,8618,11152
58439,74,169,2020,262,160,102
58440,74,166,2020,2194,1003,1191
58441,74,93,2020,346,202,144
58442,74,146,2020,12630,4640,7990
58443,74,26,2020,80729,38315,42414
58444,74,170,2020,153,104,49
58445,74,130,2020,853,498,355
58446,74,38,2020,10631,7952,2679
58447,74,27,2020,826,422,404
58448,74,50,2020,45951,21374,24577
58449,74,131,2020,898,498,400
58450,74,114,2020,1645,880,765
58451,74,171,2020,1035,678,357
58452,74,1,2020,12263,7252,5011
58453,74,28,2020,690,310,380
58454,74,132,2020,424,243,181
58455,74,133,2020,1027,543,484
58456,25,2,2020,1143,558,585
58457,25,16,2020,203003,102165,100838
58458,25,128,2020,1079,527,552
58459,25,145,2020,209,101,108
58460,169,2,2020,12433,6867,5566
58461,169,141,2020,128,69,59
58462,169,12,2020,168,103,65
58463,169,66,2020,61,32,29
58464,169,11,2020,193,117,76
58465,169,29,2020,680,403,277
58466,169,172,2020,46,15,31
58467,169,39,2020,129,49,80
58468,169,15,2020,664,322,342
58469,169,69,2020,132,57,75
58470,169,5,2020,618,230,388
58471,169,6,2020,1200,567,633
58472,169,16,2020,60,26,34
58473,169,167,2020,840,439,401
58474,169,176,2020,154,60,94
58475,169,168,2020,11351,5571,5780
58476,169,21,2020,34,16,18
58477,169,73,2020,48,30,18
58478,169,9,2020,103,49,54
58479,169,33,2020,35,16,19
58480,169,36,2020,234998,135842,99156
58481,169,74,2020,50,21,29
58482,169,26,2020,777,360,417
58483,169,170,2020,446,228,218
58484,169,38,2020,1212,472,740
58485,169,50,2020,313,80,233
58486,169,171,2020,7563,3904,3659
58487,169,132,2020,21,9,12
58488,131,134,2020,1115,446,669
58489,131,147,2020,125,36,89
58490,131,116,2020,222115,108812,113303
58491,131,117,2020,533,211,322
58492,131,137,2020,22287,11304,10983
58493,131,137,2020,70736,37099,33637
58494,131,69,2020,861,442,419
58495,131,5,2020,7135,3070,4065
58496,131,57,2020,511,216,295
58497,131,121,2020,24274,13898,10376
58498,131,149,2020,132,66,66
58499,131,123,2020,6153,2827,3326
58500,131,124,2020,170,78,92
58501,131,125,2020,13052,6529,6523
58502,131,150,2020,573,224,349
58503,131,9,2020,595,240,355
58504,131,126,2020,517,182,335
58505,131,127,2020,332,112,220
58506,131,128,2020,2642,1267,1375
58507,131,115,2020,633,249,384
58508,131,148,2020,77,23,54
58509,131,130,2020,4326,2073,2253
58510,131,50,2020,944,548,396
58511,131,132,2020,7637,3862,3775
58512,131,133,2020,759,455,304
58513,166,67,2020,64,20,44
58514,166,135,2020,702,250,452
58515,166,153,2020,39,17,22
58516,166,136,2020,718,230,488
58517,166,172,2020,521,94,427
58518,166,137,2020,258,100,158
58519,166,137,2020,656,331,325
58520,166,151,2020,72330,37481,34849
58521,166,138,2020,107,39,68
58522,166,68,2020,798,353,445
58523,166,139,2020,903,397,506
58524,166,155,2020,1071,460,611
58525,166,69,2020,201,106,95
58526,166,156,2020,47232,27624,19608
58527,166,157,2020,3367,1512,1855
58528,166,159,2020,168,82,86
58529,166,160,2020,8196,3562,4634
58530,166,161,2020,144,79,65
58531,166,162,2020,32266,13955,18311
58532,166,158,2020,130,72,58
58533,166,126,2020,669,344,325
58534,166,140,2020,40,19,21
58535,166,164,2020,1016,440,576
58536,166,165,2020,105,55,50
58537,166,152,2020,13765,6209,7556
58538,93,79,2020,1184,524,660
58539,93,172,2020,961,365,596
58540,93,81,2020,2412,1118,1294
58541,93,69,2020,280,115,165
58542,93,84,2020,8913,4237,4676
58543,93,110,2020,10923,4921,6002
58544,93,5,2020,1064,375,689
58545,93,86,2020,1661,672,989
58546,93,162,2020,557,169,388
58547,93,91,2020,977,430,547
58548,93,92,2020,7141,3367,3774
58549,93,50,2020,2629,1036,1593
58550,146,141,2020,11060,5282,5778
58551,146,135,2020,758,362,396
58552,146,68,2020,9151,4370,4781
58553,146,69,2020,1537,734,803
58554,146,16,2020,675,318,357
58555,146,57,2020,2345,1117,1228
58556,146,143,2020,9688,4625,5063
58557,146,160,2020,1058,512,546
58558,146,161,2020,560,267,293
58559,146,144,2020,6146,2937,3209
58560,146,162,2020,575,275,300
58561,146,164,2020,433,207,226
58562,146,25,2020,1382,646,736
58563,146,142,2020,1206,576,630
58564,26,2,2020,117595,57012,60583
58565,26,51,2020,4554,2582,1972
58566,26,141,2020,887,275,612
58567,26,12,2020,23090,12804,10286
58568,26,103,2020,190,106,84
58569,26,66,2020,19717,11380,8337
58570,26,3,2020,450,40,410
58571,26,11,2020,1090,782,308
58572,26,67,2020,12035,7259,4776
58573,26,53,2020,3253,1885,1368
58574,26,105,2020,471,330,141
58575,26,30,2020,661438,456887,204551
58576,26,29,2020,410,359,51
58577,26,10,2020,70,17,53
58578,26,106,2020,58,44,14
58579,26,172,2020,2415,1398,1017
58580,26,107,2020,61,46,15
58581,26,137,2020,99,39,60
58582,26,96,2020,72,37,35
58583,26,54,2020,303,195,108
58584,26,81,2020,56,30,26
58585,26,14,2020,14291,8812,5479
58586,26,31,2020,1557,889,668
58587,26,39,2020,4627,2747,1880
58588,26,120,2020,204,113,91
58589,26,40,2020,153,109,44
58590,26,42,2020,2295,1414,881
58591,26,68,2020,21973,12861,9112
58592,26,15,2020,8952,5918,3034
58593,26,69,2020,376288,251097,125191
58594,26,156,2020,196,23,173
58595,26,56,2020,81457,50836,30621
58596,26,173,2020,76,45,31
58597,26,32,2020,713,475,238
58598,26,43,2020,56,33,23
58599,26,5,2020,713,304,409
58600,26,6,2020,84270,39667,44603
58601,26,16,2020,233288,193875,39413
58602,26,44,2020,737,427,310
58603,26,17,2020,3738,2065,1673
58604,26,57,2020,3908,1962,1946
58605,26,177,2020,2750,1737,1013
58606,26,167,2020,6869,4349,2520
58607,26,18,2020,1257,519,738
58608,26,121,2020,236,96,140
58609,26,176,2020,37,18,19
58610,26,19,2020,391,155,236
58611,26,168,2020,2697,1333,1364
58612,26,20,2020,1554,893,661
58613,26,46,2020,86,65,21
58614,26,143,2020,4220,2084,2136
58615,26,47,2020,355,245,110
58616,26,71,2020,59,36,23
58617,26,58,2020,56,41,15
58618,26,100,2020,208,122,86
58619,26,144,2020,659,300,359
58620,26,21,2020,32,19,13
58621,26,73,2020,30017,17421,12596
58622,26,162,2020,1204,432,772
58623,26,48,2020,4886,2859,2027
58624,26,9,2020,1599,731,868
58625,26,112,2020,70,48,22
58626,26,33,2020,4695,2833,1862
58627,26,61,2020,305,180,125
58628,26,22,2020,40,15,25
58629,26,35,2020,28522,19474,9048
58630,26,36,2020,27319,19060,8259
58631,26,23,2020,6049,3283,2766
58632,26,164,2020,88,37,51
58633,26,37,2020,428,259,169
58634,26,1,2020,39,24,15
58635,26,64,2020,199,120,79
58636,26,128,2020,2980,1370,1610
58637,26,115,2020,403,222,181
58638,26,65,2020,1661,997,664
58639,26,145,2020,546,195,351
58640,26,148,2020,103,74,29
58641,26,49,2020,7335,4500,2835
58642,26,74,2020,14260,8560,5700
58643,26,25,2020,3792505,1491235,2301270
58644,26,169,2020,378,106,272
58645,26,27,2020,58,22,36
58646,26,146,2020,708,314,394
58647,26,170,2020,2793,893,1900
58648,26,38,2020,5745,4607,1138
58649,26,60,2020,198004,91604,106400
58650,26,142,2020,1079,507,572
58651,26,50,2020,26016,15928,10088
58652,26,131,2020,303,35,268
58653,26,114,2020,58,30,28
58654,26,171,2020,10954,6492,4462
58655,26,28,2020,136,61,75
58656,170,2,2020,198,99,99
58657,170,12,2020,7596,3834,3762
58658,170,11,2020,7058,3593,3465
58659,170,29,2020,2042,719,1323
58660,170,69,2020,1029,591,438
58661,170,6,2020,1887,951,936
58662,170,167,2020,19994,10190,9804
58663,170,36,2020,74600,40717,33883
58664,170,169,2020,1465,733,732
58665,170,38,2020,7952,3893,4059
58666,170,171,2020,67003,35362,31641
58667,94,78,2020,307,147,160
58668,94,83,2020,1989,991,998
58669,94,85,2020,15787,7891,7896
58670,94,50,2020,471,208,263
58671,130,141,2020,0,0,0
58672,130,3,2020,117,101,16
58673,130,67,2020,35,17,18
58674,130,116,2020,50652,24977,25675
58675,130,172,2020,341,126,215
58676,130,137,2020,397638,209646,187992
58677,130,81,2020,15,0,15
58678,130,39,2020,143,74,69
58679,130,120,2020,3009,1551,1458
58680,130,119,2020,14499,7489,7010
58681,130,68,2020,207,80,127
58682,130,155,2020,0,0,0
58683,130,69,2020,194,95,99
58684,130,156,2020,0,0,0
58685,130,56,2020,32,17,15
58686,130,32,2020,7,7,0
58687,130,5,2020,3277,1234,2043
58688,130,57,2020,337,30,307
58689,130,177,2020,170,59,111
58690,130,121,2020,34241,19865,14376
58691,130,176,2020,121,29,92
58692,130,143,2020,0,0,0
58693,130,123,2020,5,0,5
58694,130,161,2020,0,0,0
58695,130,125,2020,24,11,13
58696,130,73,2020,178,92,86
58697,130,162,2020,2,0,2
58698,130,48,2020,6,0,6
58699,130,9,2020,995,361,634
58700,130,36,2020,253,151,102
58701,130,126,2020,65676,33731,31945
58702,130,164,2020,0,0,0
58703,130,128,2020,37960,19604,18356
58704,130,133,2020,1,0,1
58705,130,65,2020,49,33,16
58706,130,129,2020,1022433,525858,496575
58707,130,145,2020,62670,34577,28093
58708,130,49,2020,23,0,23
58709,130,166,2020,2,0,2
58710,130,142,2020,0,0,0
58711,130,50,2020,998,473,525
58712,130,131,2020,20438,10600,9838
58713,130,132,2020,5,1,4
58714,38,2,2020,4891,1092,3799
58715,38,12,2020,83674,37023,46651
58716,38,11,2020,48097,20222,27875
58717,38,30,2020,1760,568,1192
58718,38,29,2020,249641,146962,102679
58719,38,172,2020,6668,2395,4273
58720,38,40,2020,10392,5179,5213
58721,38,15,2020,65475,29899,35576
58722,38,69,2020,1099,505,594
58723,38,5,2020,3879,756,3123
58724,38,6,2020,2170,399,1771
58725,38,17,2020,3813,1851,1962
58726,38,167,2020,225962,124091,101871
58727,38,18,2020,3775,82,3693
58728,38,168,2020,27175,14683,12492
58729,38,20,2020,1792,96,1696
58730,38,46,2020,19821,9880,9941
58731,38,47,2020,24825,12375,12450
58732,38,144,2020,1765,494,1271
58733,38,33,2020,3128,1687,1441
58734,38,36,2020,3330586,1960865,1369721
58735,38,1,2020,12596,5347,7249
58736,38,25,2020,3781,145,3636
58737,38,169,2020,29857,15021,14836
58738,38,26,2020,1376,192,1184
58739,38,170,2020,22979,12213,10766
58740,38,171,2020,223491,112364,111127
58741,27,2,2020,8191,2551,5640
58742,27,13,2020,1998,1140,858
58743,27,3,2020,1095231,143154,952077
58744,27,10,2020,120491,53652,66839
58745,27,136,2020,5350,1661,3689
58746,27,120,2020,11049,3440,7609
58747,27,119,2020,19334,6025,13309
58748,27,68,2020,18141,6690,11451
58749,27,5,2020,3471300,805271,2666029
58750,27,18,2020,168968,58739,110229
58751,27,19,2020,67525,21213,46312
58752,27,20,2020,41913,13066,28847
58753,27,144,2020,8942,2785,6157
58754,27,8,2020,27886,8690,19196
58755,27,73,2020,3155,1216,1939
58756,27,162,2020,15697,4893,10804
58757,27,9,2020,996288,221558,774730
58758,27,22,2020,2671,1694,977
58759,27,23,2020,6579,1995,4584
58760,27,128,2020,9734,3032,6702
58761,27,129,2020,15922,5557,10365
58762,27,145,2020,133226,46509,86717
58763,27,25,2020,52925,16569,36356
58764,27,146,2020,5874,1828,4046
58765,27,26,2020,38186,11902,26284
58766,27,142,2020,899612,298315,601297
58767,27,50,2020,29191,9942,19249
58768,27,28,2020,205618,64107,141511
58769,50,2,2020,51376,19894,31482
58770,50,51,2020,10458,3905,6553
58771,50,141,2020,23380,7713,15667
58772,50,52,2020,53,23,30
58773,50,134,2020,13471,7264,6207
58774,50,75,2020,807,426,381
58775,50,76,2020,5005,2805,2200
58776,50,103,2020,11385,6566,4819
58777,50,11,2020,1477,820,657
58778,50,77,2020,936,537,399
58779,50,66,2020,21163,11670,9493
58780,50,12,2020,2271,1237,1034
58781,50,78,2020,2442,1326,1116
58782,50,13,2020,6575,3286,3289
58783,50,3,2020,241799,118012,123787
58784,50,79,2020,26622,14031,12591
58785,50,29,2020,3635,2426,1209
58786,50,67,2020,31425,16871,14554
58787,50,95,2020,1694,1191,503
58788,50,151,2020,563,269,294
58789,50,4,2020,336,118,218
58790,50,53,2020,9576,5427,4149
58791,50,147,2020,3485,1813,1672
58792,50,105,2020,44175,25451,18724
58793,50,30,2020,103196,54554,48642
58794,50,152,2020,205,92,113
58795,50,116,2020,4265,2421,1844
58796,50,153,2020,993,574,419
58797,50,135,2020,8834,4597,4237
58798,50,80,2020,1266,730,536
58799,50,136,2020,345,123,222
58800,50,106,2020,8063,4500,3563
58801,50,172,2020,208229,114687,93542
58802,50,173,2020,124122,61688,62434
58803,50,107,2020,25001,15101,9900
58804,50,117,2020,133,75,58
58805,50,137,2020,7978,4602,3376
58806,50,96,2020,712,394,318
58807,50,54,2020,8610,4927,3683
58808,50,81,2020,2333,1242,1091
58809,50,14,2020,61053,33790,27263
58810,50,31,2020,45578,30870,14708
58811,50,176,2020,11385,6711,4674
58812,50,137,2020,18423,10067,8356
58813,50,39,2020,26960,15987,10973
58814,50,118,2020,451,257,194
58815,50,82,2020,8625,4677,3948
58816,50,83,2020,1246,610,636
58817,50,108,2020,7739,4290,3449
58818,50,142,2020,36831,16531,20300
58819,50,97,2020,1284,791,493
58820,50,138,2020,222,147,75
58821,50,119,2020,15911,8405,7506
58822,50,40,2020,12967,9696,3271
58823,50,148,2020,1534,852,682
58824,50,120,2020,15278,8469,6809
58825,50,41,2020,437,270,167
58826,50,42,2020,20999,13343,7656
58827,50,68,2020,170270,96949,73321
58828,50,139,2020,322,186,136
58829,50,155,2020,10015,4682,5333
58830,50,15,2020,2427,1289,1138
58831,50,69,2020,310043,173170,136873
58832,50,156,2020,131095,64653,66442
58833,50,55,2020,12401,6462,5939
58834,50,56,2020,75441,27938,47503
58835,50,84,2020,12556,6899,5657
58836,50,98,2020,963,592,371
58837,50,157,2020,1710,795,915
58838,50,158,2020,1817,945,872
58839,50,110,2020,28074,16740,11334
58840,50,85,2020,309,177,132
58841,50,99,2020,694,439,255
58842,50,32,2020,82667,42586,40081
58843,50,43,2020,2370,1334,1036
58844,50,5,2020,835359,415220,420139
58845,50,6,2020,83531,35129,48402
58846,50,16,2020,70569,27016,43553
58847,50,44,2020,370151,205017,165134
58848,50,45,2020,10983,5715,5268
58849,50,17,2020,19797,9662,10135
58850,50,57,2020,254054,114415,139639
58851,50,86,2020,128772,80925,47847
58852,50,177,2020,49238,31566,17672
58853,50,18,2020,5897,2299,3598
58854,50,167,2020,3882,2481,1401
58855,50,121,2020,139352,74653,64699
58856,50,19,2020,12436,5441,6995
58857,50,168,2020,775,517,258
58858,50,46,2020,86007,45349,40658
58859,50,20,2020,17333,7493,9840
58860,50,149,2020,732,447,285
58861,50,159,2020,3378,1487,1891
58862,50,143,2020,16803,7373,9430
58863,50,70,2020,33,25,8
58864,50,47,2020,190342,110292,80050
58865,50,71,2020,3314,1633,1681
58866,50,122,2020,1202,811,391
58867,50,123,2020,19035,9990,9045
58868,50,7,2020,372,185,187
58869,50,160,2020,327,141,186
58870,50,58,2020,29600,14523,15077
58871,50,161,2020,157,61,96
58872,50,124,2020,45365,23095,22270
58873,50,100,2020,9726,5492,4234
58874,50,72,2020,406,180,226
58875,50,59,2020,1162,592,570
58876,50,87,2020,10872,6292,4580
58877,50,144,2020,22476,10827,11649
58878,50,125,2020,6092,3341,2751
58879,50,150,2020,2427,1313,1114
58880,50,8,2020,37212,16390,20822
58881,50,73,2020,81375,47466,33909
58882,50,101,2020,393,244,149
58883,50,162,2020,205773,102105,103668
58884,50,60,2020,2776,1649,1127
58885,50,48,2020,20224,12214,8010
58886,50,21,2020,3421,1505,1916
58887,50,9,2020,537047,254402,282645
58888,50,102,2020,789,469,320
58889,50,111,2020,826,464,362
58890,50,112,2020,7426,4758,2668
58891,50,33,2020,835975,440693,395282
58892,50,61,2020,141916,68095,73821
58893,50,22,2020,2347,964,1383
58894,50,35,2020,393569,186369,207200
58895,50,36,2020,36203,24223,11980
58896,50,126,2020,4476,2537,1939
58897,50,90,2020,7998,4375,3623
58898,50,91,2020,11448,6415,5033
58899,50,92,2020,9558,5067,4491
58900,50,140,2020,681,439,242
58901,50,23,2020,27808,12169,15639
58902,50,164,2020,1775,788,987
58903,50,63,2020,9343,5157,4186
58904,50,127,2020,4278,2636,1642
58905,50,165,2020,26657,14814,11843
58906,50,37,2020,72209,38357,33852
58907,50,64,2020,3668,2324,1344
58908,50,128,2020,150448,96531,53917
58909,50,115,2020,247336,122594,124742
58910,50,65,2020,150892,80385,70507
58911,50,10,2020,128207,60079,68128
58912,50,145,2020,19078,8391,10687
58913,50,113,2020,460,284,176
58914,50,49,2020,35824,22718,13106
58915,50,74,2020,23649,14479,9170
58916,50,25,2020,11457,4566,6891
58917,50,169,2020,338,189,149
58918,50,166,2020,1420,619,801
58919,50,93,2020,29508,18528,10980
58920,50,146,2020,6048,1982,4066
58921,50,26,2020,97205,44458,52747
58922,50,170,2020,538,334,204
58923,50,94,2020,149,78,71
58924,50,130,2020,76333,39569,36764
58925,50,38,2020,22119,12164,9955
58926,50,27,2020,11065,4894,6171
58927,50,131,2020,45122,23083,22039
58928,50,114,2020,1532,841,691
58929,50,171,2020,2087,1119,968
58930,50,1,2020,35168,19519,15649
58931,50,28,2020,20071,9135,10936
58932,50,132,2020,33040,18256,14784
58933,50,133,2020,170350,96458,73892
58934,114,103,2020,33022,18166,14856
58935,114,105,2020,14762,8625,6137
58936,114,106,2020,1536,784,752
58937,114,68,2020,560,285,275
58938,114,69,2020,1651,878,773
58939,114,57,2020,8744,3890,4854
58940,114,100,2020,635,345,290
58941,114,111,2020,1225,816,409
58942,114,112,2020,106,31,75
58943,114,33,2020,1390,765,625
58944,114,61,2020,668,314,354
58945,114,35,2020,728,372,356
58946,114,65,2020,19374,10344,9030
58947,114,50,2020,541,306,235
58948,171,12,2020,20201,9511,10690
58949,171,11,2020,5824,2775,3049
58950,171,29,2020,26330,13508,12822
58951,171,69,2020,8543,4492,4051
58952,171,167,2020,13092,7149,5943
58953,171,168,2020,4856,2644,2212
58954,171,36,2020,871047,469260,401787
58955,171,169,2020,11408,5378,6030
58956,171,170,2020,756,307,449
58957,171,38,2020,123658,65360,58298
58958,1,3,2020,8325,3783,4542
58959,1,10,2020,82,32,50
58960,1,172,2020,3167,1319,1848
58961,1,68,2020,215,60,155
58962,1,5,2020,2043,838,1205
58963,1,177,2020,1942,701,1241
58964,1,176,2020,1584,690,894
58965,1,8,2020,2440,1119,1321
58966,1,9,2020,622,281,341
58967,1,50,2020,1178,543,635
58968,28,120,2020,16039,5969,10070
58969,28,119,2020,1937,649,1288
58970,28,6,2020,6,2,4
58971,28,16,2020,9987,4289,5698
58972,28,1,2020,14,6,8
58973,28,128,2020,280940,118223,162717
58974,28,129,2020,551,234,317
58975,28,145,2020,27044,11519,15525
58976,28,25,2020,4013,1715,2298
58977,28,142,2020,7739,3310,4429
58978,132,134,2020,31424,15341,16083
58979,132,147,2020,1130,593,537
58980,132,116,2020,7018,3284,3734
58981,132,135,2020,299,135,164
58982,132,172,2020,1241,367,874
58983,132,137,2020,10460,5070,5390
58984,132,137,2020,50661,24161,26500
58985,132,68,2020,84,48,36
58986,132,69,2020,341,153,188
58987,132,156,2020,214,64,150
58988,132,5,2020,5709,2538,3171
58989,132,177,2020,123,59,64
58990,132,121,2020,660,288,372
58991,132,123,2020,13422,6605,6817
58992,132,160,2020,267,88,179
58993,132,125,2020,1603,761,842
58994,132,150,2020,774,417,357
58995,132,162,2020,625,267,358
58996,132,126,2020,9202,4330,4872
58997,132,164,2020,175,40,135
58998,132,115,2020,3788,1813,1975
58999,132,133,2020,16816,9079,7737
59000,132,130,2020,559,210,349
59001,132,142,2020,200,71,129
59002,132,50,2020,1584,726,858
59003,132,131,2020,6617,3466,3151
59004,133,147,2020,3865,1672,2193
59005,133,123,2020,108491,46661,61830
59006,133,125,2020,122923,53086,69837
59007,133,115,2020,19731,8521,11210
59008,133,50,2020,12705,5502,7203
59009,133,132,2020,31692,13723,17969
