,pais,year,origen,destino,total
1686,united states of america,2020,2996223,50632836,47636613
1441,united states of america,2015,2717761,48178877,45461116
1196,united states of america,2010,2670652,44183643,41512991
951,united states of america,2005,2296999,39258293,36961294
706,united states of america,2000,1979327,34814053,32834726
461,united states of america,1995,1827431,28451053,26623622
216,united states of america,1990,1726213,23251026,21524813
1577,saudi arabia,2020,299268,13454842,13155574
1625,germany,2020,3855268,15762457,11907189
1332,saudi arabia,2015,282906,10771366,10488460
1581,united arab emirates,2020,203214,8716332,8513118
1087,saudi arabia,2010,215338,8429956,8214618
1336,united arab emirates,2015,178324,7995126,7816802
1688,australia and new zealand,2020,1404924,9067584,7662660
1687,oceania,2020,1970205,9380653,7410448
1091,united arab emirates,2010,155609,7316697,7161088
1689,australia,2020,598765,7685860,7087095
1683,canada,2020,1292329,8049323,6756994
1380,germany,2015,3630278,10220418,6590140
1443,australia and new zealand,2015,1256202,7769466,6513264
842,saudi arabia,2005,178744,6501819,6323075
1442,oceania,2015,1751422,8072276,6320854
1444,australia,2015,518158,6729730,6211572
1624,france,2020,2341908,8524876,6182968
1438,canada,2015,1263552,7428657,6165105
1135,germany,2010,3696638,9812263,6115625
890,germany,2005,3442933,9402447,5959514
1379,france,2015,2119266,7878338,5759072
645,germany,2000,3235247,8992631,5757384
1198,australia and new zealand,2010,1149265,6830423,5681158
1197,oceania,2010,1591168,7128598,5537430
1193,canada,2010,1268057,6761226,5493169
1199,australia,2010,486949,5882980,5396031
1134,france,2010,1956818,7309986,5353168
1621,spain,2020,1489823,6842202,5352379
1131,spain,2010,1087071,6280062,5192991
597,saudi arabia,2000,153614,5263387,5109773
889,france,2005,1725216,6737600,5012384
352,saudi arabia,1995,130911,5122702,4991791
948,canada,2005,1185156,6078985,4893829
107,saudi arabia,1990,107045,4998445,4891400
399,france,1995,1353297,6087993,4734696
953,australia and new zealand,2005,984280,5717982,4733702
644,france,2000,1555391,6278718,4723327
154,france,1990,1215837,5897267,4681430
952,oceania,2005,1391418,6024021,4632603
1605,united kingdom,2020,4732510,9359587,4627077
1376,spain,2015,1269283,5891208,4621925
954,australia,2005,428769,4878030,4449261
400,germany,1995,3045354,7464406,4419052
703,canada,2000,1142641,5511914,4369273
708,australia and new zealand,2000,871660,5065063,4193403
707,oceania,2000,1246836,5361681,4114845
1360,united kingdom,2015,4379366,8406996,4027630
709,australia,2000,381836,4386250,4004414
463,australia and new zealand,1995,758234,4741947,3983713
462,oceania,1995,1071295,5022527,3951232
464,australia,1995,341312,4153330,3812018
458,canada,1995,1064305,4864778,3800473
218,australia and new zealand,1990,689030,4473260,3784230
217,oceania,1990,961547,4731938,3770391
90,iran islamic republic of,1990,631196,4291601,3660405
219,australia,1990,301013,3955213,3654200
213,canada,1990,994254,4333318,3339064
1123,italy,2010,2559233,5787893,3228660
846,united arab emirates,2005,125618,3281115,3155497
1368,italy,2015,2662661,5805328,3142667
1613,italy,2020,3258831,6386998,3128167
155,germany,1990,2929448,5936181,3006733
886,spain,2005,1114465,4107226,2992761
1573,kuwait,2020,212271,3110159,2897888
93,pakistan,1990,3341086,6208204,2867118
1115,united kingdom,2010,4432928,7119664,2686736
1328,kuwait,2015,195034,2866136,2671102
1572,jordan,2020,814909,3457691,2642782
1580,turkey,2020,3411408,6052652,2641244
1308,thailand,2015,921690,3470220,2548530
1553,thailand,2020,1086985,3632496,2545511
1063,thailand,2010,769257,3234381,2465124
1327,jordan,2015,706832,3166961,2460129
1269,south africa,2015,786554,3231728,2445174
1264,southern africa,2015,1129951,3477903,2347952
1575,oman,2020,25099,2372836,2347737
601,united arab emirates,2000,111082,2447010,2335928
1576,qatar,2020,25705,2226192,2200487
335,iran islamic republic of,1995,746739,2937668,2190929
1082,jordan,2010,602099,2786853,2184754
1552,singapore,2020,348464,2523648,2175184
1307,singapore,2015,324639,2483405,2158766
558,china hong kong sar,2000,685913,2669122,1983209
803,china hong kong sar,2005,752476,2721235,1968759
1542,japan,2020,808825,2770996,1962171
1538,china hong kong sar,2020,1007788,2962492,1954704
1514,south africa,2020,914901,2860495,1945594
1048,china hong kong sar,2010,862070,2779950,1917880
1293,china hong kong sar,2015,957289,2841113,1883824
1062,singapore,2010,282421,2164794,1882373
1509,southern africa,2020,1278435,3125072,1846637
1330,oman,2015,22797,1856226,1833429
313,china hong kong sar,1995,617237,2443798,1826561
870,united kingdom,2005,4145206,5926156,1780950
1630,switzerland,2020,713623,2491249,1777626
837,jordan,2005,440788,2198740,1757952
1070,iran islamic republic of,2010,985691,2722397,1736706
356,united arab emirates,1995,97928,1824118,1726190
271,democratic republic of the congo,1995,115677,1816963,1701286
1083,kuwait,2010,177816,1874812,1696996
1326,israel,2015,331326,2011727,1680401
1604,sweden,2020,327581,2003908,1676327
68,china hong kong sar,1990,549125,2218473,1669348
1331,qatar,2015,23574,1687640,1664066
825,iran islamic republic of,2005,889502,2552206,1662704
580,iran islamic republic of,2000,831205,2476469,1645264
293,cote divoire,1995,449498,2076394,1626896
538,cote divoire,2000,539234,2163644,1624410
1081,israel,2010,333968,1956190,1622222
1549,malaysia,2020,1860037,3476560,1616523
1385,switzerland,2015,644855,2258196,1613341
1571,israel,2020,358691,1953575,1594884
1315,iran islamic republic of,2015,1155617,2729939,1574322
836,israel,2005,317009,1889503,1572494
818,thailand,2005,631678,2195610,1563932
592,jordan,2000,368299,1927845,1559546
591,israel,2000,303860,1851309,1547449
783,cote divoire,2005,731962,2265090,1533128
346,israel,1995,290365,1792185,1501820
1304,malaysia,2015,1781038,3280681,1499643
817,singapore,2005,235683,1710594,1474911
1560,iran islamic republic of,2020,1325113,2797235,1472122
1297,japan,2015,764408,2232189,1467781
1345,russian federation,2015,10179999,11643276,1463277
1140,switzerland,2010,624385,2075182,1450797
48,cote divoire,1990,366336,1816426,1450090
1086,qatar,2010,20674,1456413,1435739
1623,belgium,2020,577463,2005479,1428016
1028,cote divoire,2010,939795,2366537,1426742
1518,cote divoire,2020,1149298,2564857,1415559
1273,cote divoire,2015,1056380,2470613,1414233
1629,netherlands,2020,970403,2358333,1387930
1052,japan,2010,756792,2134151,1377359
1024,south africa,2010,743807,2114801,1370994
855,russian federation,2005,10302948,11667588,1364640
101,israel,1990,279625,1632704,1353079
122,ukraine,1990,5545517,6892920,1347403
895,switzerland,2005,502289,1805437,1303148
1359,sweden,2015,302408,1602522,1300114
807,japan,2005,718466,2011555,1293089
1335,turkey,2015,3073534,4346197,1272663
1378,belgium,2015,515793,1783488,1267695
273,democratic republic of the congo,1995,559824,1816963,1257139
878,italy,2005,2698486,3954790,1256304
610,russian federation,2000,10664764,11900297,1235533
111,united arab emirates,1990,79499,1306574,1227075
198,argentina,1990,430155,1649919,1219764
1668,argentina,2020,1076148,2281728,1205580
838,kuwait,2005,129005,1333530,1204525
650,switzerland,2000,370442,1570756,1200314
347,jordan,1995,339026,1537097,1198071
1329,lebanon,2015,757183,1916259,1159076
572,singapore,2000,192930,1351691,1158761
1019,southern africa,2010,1199813,2352541,1152728
1423,argentina,2015,943843,2086301,1142458
405,switzerland,1995,339249,1478829,1139580
1622,austria,2020,600740,1738183,1137443
1384,netherlands,2015,867093,1996318,1129225
443,argentina,1995,481968,1595069,1113101
1100,russian federation,2010,10118680,11194710,1076030
160,switzerland,1990,325580,1392282,1066702
1114,sweden,2010,291904,1337214,1045310
1133,belgium,2010,484032,1503806,1019774
593,kuwait,2000,113415,1127640,1014225
1671,chile,2020,643800,1645015,1001215
103,kuwait,1990,81583,1074391,992808
688,argentina,2000,555542,1540219,984677
7,malawi,1990,143436,1127724,984288
1139,netherlands,2010,854388,1832510,978122
562,japan,2000,708933,1686444,977511
89,india,1990,6619431,7594801,975370
1377,austria,2015,515234,1483123,967889
894,netherlands,2005,790554,1736127,945573
1486,uganda,2020,781440,1720313,938873
153,belgium,1990,363970,1280583,916613
398,belgium,1995,374734,1288003,913269
1590,russian federation,2020,10756697,11636911,880214
1567,bahrain,2020,58270,936094,877824
262,united republic of tanzania,1995,229151,1106043,876892
625,united kingdom,2000,3860006,4730165,870159
643,belgium,2000,398864,1268368,869504
933,argentina,2005,805291,1674163,868872
1178,argentina,2010,938639,1805957,867318
869,sweden,2005,267953,1125790,857837
1574,lebanon,2020,856814,1712762,855948
44,south africa,1990,308120,1163883,855763
211,venezuela bolivarian republic of,1990,185492,1025009,839517
102,jordan,1990,313621,1146349,832728
348,kuwait,1995,97009,921954,824945
327,singapore,1995,168100,991492,823392
39,southern africa,1990,576752,1395265,818513
1059,malaysia,2010,1599061,2417395,818334
36,sudan,1990,584935,1402896,817961
888,belgium,2005,437701,1248733,811032
649,netherlands,2000,747631,1556337,808706
265,middle africa,1995,1857602,2662490,804888
1085,oman,2010,20752,816234,795482
1191,venezuela bolivarian republic of,2010,560528,1347347,786819
456,venezuela bolivarian republic of,1995,241864,1019996,778132
583,pakistan,2000,3406434,4181912,775478
1132,austria,2010,517401,1274901,757500
779,south africa,2005,601803,1351031,749228
624,sweden,2000,256610,1003798,747188
507,united republic of tanzania,2000,215460,949600,734140
1496,democratic republic of the congo,2020,223767,952871,729104
573,thailand,2000,531028,1257821,726793
1089,syrian arab republic,2010,1057322,1783595,726273
379,sweden,1995,225655,936022,710367
317,japan,1995,653293,1362371,709078
701,venezuela bolivarian republic of,2000,317753,1013738,695985
1436,venezuela bolivarian republic of,2015,709140,1404448,695308
774,southern africa,2005,904614,1582721,678107
1322,bahrain,2015,56721,722487,665766
1603,norway,2020,191392,852238,660846
26,democratic republic of the congo,1990,96370,754194,657824
62,kazakhstan,1990,2971634,3619200,647566
840,oman,2005,18824,666164,647340
1230,kenya,2015,480647,1126886,646239
1504,libya,2020,185518,826537,641019
946,venezuela bolivarian republic of,2005,437087,1076474,639387
887,austria,2005,493349,1127164,633815
841,qatar,2005,17131,646026,628895
404,netherlands,1995,726856,1346164,619308
1259,libya,2015,152544,771146,618602
289,south africa,1995,385988,1003807,617819
1077,bahrain,2010,52235,666406,614171
516,democratic republic of the congo,2000,135235,744387,609152
595,oman,2000,15623,623608,607985
1251,democratic republic of the congo,2015,204829,810018,605189
284,southern africa,1995,604456,1201708,597252
134,sweden,1990,205942,788767,582825
1690,new zealand,2020,806159,1381724,575565
82,singapore,1990,156444,727262,570818
367,ukraine,1995,5606133,6172338,566205
1358,norway,2015,185578,746375,560797
1014,libya,2010,127399,687192,559793
814,malaysia,2005,1379305,1918504,539199
752,united republic of tanzania,2005,234918,771153,536235
529,southern africa,2000,732312,1267695,535383
1121,greece,2010,789457,1321149,531692
350,oman,1995,13844,539643,525799
769,libya,2005,100248,625412,525164
642,austria,2000,478091,996547,518456
534,south africa,2000,501600,1016963,515363
1475,kenya,2020,535348,1050147,514799
985,kenya,2010,442632,954925,512293
524,libya,2000,80014,567436,487422
72,japan,1990,604803,1075317,470514
159,netherlands,1990,716471,1182263,465792
1594,denmark,2020,257025,717574,460549
761,democratic republic of the congo,2005,172610,623009,450399
380,united kingdom,1995,3708650,4155293,446643
131,latvia,1990,215070,646007,430937
279,libya,1995,77398,508041,430643
19,zimbabwe,1990,204363,634621,430258
1366,greece,2015,820119,1242924,422805
1006,democratic republic of the congo,2010,178111,589882,411771
740,kenya,2005,362031,773354,411323
296,guinea,1995,365862,774505,408643
397,austria,1995,490045,894893,404848
328,thailand,1995,411878,809720,397842
495,kenya,2000,317434,707852,390418
34,libya,1990,76239,457075,380836
17,united republic of tanzania,1990,203043,574025,370982
1661,costa rica,2020,150241,520729,370488
1500,gabon,2020,48392,416651,368259
641,spain,2000,1290614,1657285,366671
1349,denmark,2015,236832,595876,359044
832,bahrain,2005,51835,404018,352183
351,qatar,1995,13302,361673,348371
191,costa rica,1990,69283,417628,348345
596,qatar,2000,14680,359697,345017
1113,norway,2010,179971,524601,344630
250,kenya,1995,277647,618745,341098
365,russian federation,1995,11587959,11928927,340968
1255,gabon,2015,43075,378686,335611
338,pakistan,1995,3340157,3669308,329151
1494,chad,2020,222303,547494,325191
876,greece,2005,867619,1190707,323088
1229,ethiopia,2015,842496,1161642,319146
28,democratic republic of the congo,1990,436513,754194,317681
376,latvia,1995,228958,538093,309135
200,brazil,1990,491359,798517,307158
1445,new zealand,2015,738044,1039736,301692
106,qatar,1990,12175,309753,297578
105,oman,1990,12504,304000,291496
152,austria,1990,505214,793239,288025
1200,new zealand,2010,662316,947443,285127
955,new zealand,2005,555511,839952,284441
436,costa rica,1995,84980,364287,279307
281,sudan,1995,775375,1053396,278021
1249,chad,2015,191269,466968,275699
1171,costa rica,2010,132317,405779,273462
1416,costa rica,2015,138237,411697,273460
125,estonia,1990,113860,381997,268137
1104,denmark,2010,233531,500772,267241
569,malaysia,2000,1201135,1463598,262463
1539,china macao sar,2020,145192,403490,258298
1611,greece,2020,1088507,1340456,251949
1005,democratic republic of the congo,2010,178111,425173,247062
261,uganda,1995,361969,606987,245018
1294,china macao sar,2015,133296,376066,242770
926,costa rica,2005,117618,358398,240780
1010,gabon,2010,36933,270829,233896
16,uganda,1990,311591,544273,232682
66,uzbekistan,1990,1427980,1653000,225020
83,thailand,1990,306924,528693,221769
1627,luxembourg,2020,81757,298062,216305
859,denmark,2005,224462,440383,215921
1004,chad,2010,202423,417034,214611
681,costa rica,2000,105227,310946,205719
520,gabon,2000,18041,214431,196390
1049,china macao sar,2010,123599,318506,194907
18,zambia,1990,85201,279463,194262
765,gabon,2005,41357,233824,192467
587,bahrain,2000,47736,239361,191625
621,latvia,2000,238641,430178,191537
710,new zealand,2000,489824,678813,188989
868,norway,2005,174063,361144,187081
370,estonia,1995,129586,315755,186169
1250,democratic republic of the congo,2015,204829,390142,185313
508,zambia,2000,160201,343703,183502
541,guinea,2000,377019,560075,183056
342,bahrain,1995,26014,205979,179965
1382,luxembourg,2015,69366,248888,179522
1667,panama,2020,139520,313165,173645
465,new zealand,1995,416922,588617,171695
804,china macao sar,2005,108191,279308,171117
515,democratic republic of the congo,2000,135235,305880,170645
354,syrian arab republic,1995,661278,830610,169332
494,ethiopia,2000,445886,611384,165498
1495,democratic republic of the congo,2020,223767,387606,163839
97,bahrain,1990,12817,173212,160395
60,sierra leone,1990,61853,222148,160295
1247,cameroon,2015,348974,508346,159372
275,gabon,1995,16610,171427,154817
614,denmark,2000,217761,371026,153265
792,nigeria,2005,817392,969714,152322
22,cameroon,1990,115835,265967,150132
559,china macao sar,2000,94517,240791,146274
760,democratic republic of the congo,2005,172610,318724,146114
264,zimbabwe,1995,287995,431226,143231
759,chad,2005,210661,352130,141469
1474,ethiopia,2020,946129,1085517,139388
1492,cameroon,2020,441015,579209,138194
539,gambia,2000,45427,182514,137087
1599,ireland,2020,734317,871256,136939
79,malaysia,1990,560353,695920,135567
314,china macao sar,1995,90097,224929,134832
747,rwanda,2005,289100,423187,134087
594,lebanon,2000,558891,692913,134022
839,lebanon,2005,608856,742243,133387
1130,slovenia,2010,122948,253786,130838
220,new zealand,1990,388017,518047,130030
631,greece,2000,982685,1111665,128980
1481,runion,2020,3064,131769,128705
623,norway,2000,163834,292440,128606
599,syrian arab republic,2000,707070,834916,127846
1236,runion,2015,2907,127209,124302
784,gambia,2005,61209,181839,120630
991,runion,2010,2749,123029,120280
69,china macao sar,1990,86460,205047,118587
1620,slovenia,2020,160197,277964,117767
2,djibouti,1990,5308,122221,116913
1675,french guiana,2020,4595,119249,114654
194,honduras,1990,156379,270423,114044
30,gabon,1990,15347,128188,112841
746,runion,2005,2556,115076,112520
294,gambia,1995,38384,150890,112506
1029,gambia,2010,77440,185837,108397
615,estonia,2000,141821,249512,107691
267,cameroon,1995,138936,244791,105855
866,latvia,2005,270982,376725,105743
1479,mayotte,2020,6767,111540,104773
43,namibia,1990,16077,120641,104564
263,zambia,1995,140895,244338,103443
1499,equatorial guinea,2020,128774,230618,101844
1430,french guiana,2015,4517,106108,101591
1472,djibouti,2020,18365,119738,101373
1137,luxembourg,2010,62048,163142,101094
1375,slovenia,2015,136538,237616,101078
63,kyrgyzstan,1990,522574,623083,100509
647,luxembourg,2000,39762,139750,99988
501,runion,2000,2360,100678,98318
1487,united republic of tanzania,2020,327863,426017,98154
885,slovenia,2005,119399,217218,97819
892,luxembourg,2005,52806,150618,97812
640,slovenia,2000,118659,214508,95849
1274,gambia,2015,96963,192540,95577
369,denmark,1995,207707,303108,95401
1227,djibouti,2015,16969,112351,95382
109,syrian arab republic,1990,620285,714140,93855
1084,lebanon,2010,699704,793191,93487
247,djibouti,1995,6964,99774,92810
1254,equatorial guinea,2015,116947,209611,92664
992,rwanda,2010,334244,426901,92657
1185,french guiana,2010,3940,96288,92348
492,djibouti,2000,9055,100507,91452
717,micronesia,2000,39034,130186,91152
252,malawi,1995,150825,241624,90799
1242,united republic of tanzania,2015,294102,384567,90465
472,micronesia,1995,29154,118687,89533
982,djibouti,2010,13797,102307,88510
962,micronesia,2005,39932,128390,88458
402,luxembourg,1995,37875,126106,88231
227,micronesia,1990,21460,108969,87509
288,namibia,1995,28220,115372,87152
150,slovenia,1990,91447,178077,86630
533,namibia,2000,49348,135547,86199
1155,guadeloupe,2010,10779,94942,84163
860,estonia,2005,150101,233701,83600
940,french guiana,2005,3800,86468,82668
378,norway,1995,151041,233302,82261
49,gambia,1990,36280,118123,81843
910,guadeloupe,2005,8911,89065,80154
737,djibouti,2005,11987,92110,80123
1400,guadeloupe,2015,11993,90956,78963
1698,guam,2020,2213,80472,78259
157,luxembourg,1990,36108,113795,77687
1645,guadeloupe,2020,12542,90206,77664
349,lebanon,1995,531538,608303,76765
1519,gambia,2020,139210,215659,76449
324,malaysia,1995,861208,937368,76160
270,democratic republic of the congo,1995,115677,191635,75958
1207,micronesia,2010,39030,114743,75713
665,guadeloupe,2000,7750,83188,75438
1234,mayotte,2015,6545,81386,74841
256,runion,1995,2623,77159,74536
1597,finland,2020,311889,386052,74163
1453,guam,2015,2132,76089,73957
1208,guam,2010,2209,75416,73207
695,french guiana,2000,3640,76649,73009
963,guam,2005,2535,74743,72208
1452,micronesia,2015,41950,113466,71516
753,zambia,2005,181499,252895,71396
718,guam,2000,2797,74070,71273
473,guam,1995,1614,71912,70298
844,syrian arab republic,2005,813361,882398,69037
228,guam,1990,1375,69755,68380
513,central african republic,2000,55416,123529,68113
1697,micronesia,2020,50998,118860,67862
420,guadeloupe,1995,6748,74566,67818
1693,new caledonia,2020,5839,73141,67302
1593,channel islands,2020,17158,84087,66929
450,french guiana,1995,3221,70131,66910
1545,brunei darussalam,2020,45340,111959,66619
506,uganda,2000,517776,584280,66504
989,mayotte,2010,6342,72757,66415
1561,maldives,2020,3715,70079,66364
1348,channel islands,2015,16469,82307,65838
395,slovenia,1995,108611,174419,65808
1241,uganda,2015,786229,851175,64946
1105,estonia,2010,153633,217890,64257
1448,new caledonia,2015,5584,68881,63297
512,cameroon,2000,164296,227242,62946
1103,channel islands,2010,15699,77581,61882
1513,namibia,2020,47770,109391,61621
205,french guiana,1990,2840,63612,60772
1316,maldives,2015,3606,64273,60667
175,guadeloupe,1990,5765,65944,60179
509,zimbabwe,2000,351985,410109,58124
1300,brunei darussalam,2015,45110,102733,57623
744,mayotte,2005,6468,63176,56708
1403,martinique,2015,12675,69174,56499
858,channel islands,2005,14815,70941,56126
1055,brunei darussalam,2010,44541,100587,56046
1203,new caledonia,2010,5377,61158,55781
1648,martinique,2020,12963,68624,55661
133,norway,1990,138289,192587,54298
11,runion,1990,3087,57210,54123
810,brunei darussalam,2005,45314,98441,53127
924,united states virgin islands,2005,3638,56647,53009
1169,united states virgin islands,2010,3711,56684,52973
1659,united states virgin islands,2020,3908,56753,52845
679,united states virgin islands,2000,3814,56611,52797
1414,united states virgin islands,2015,3953,56721,52768
1525,mauritania,2020,130226,182286,52060
1280,mauritania,2015,114630,166552,51922
613,channel islands,2000,12825,64301,51476
775,botswana,2005,33281,84661,51380
434,united states virgin islands,1995,3030,54241,51211
1268,namibia,2015,50410,101618,51208
1071,maldives,2010,3543,54659,51116
565,brunei darussalam,2000,45242,96296,51054
51,guinea,1990,352763,403621,50858
1020,botswana,2010,44249,94863,50614
268,central african republic,1995,49205,99712,50507
958,new caledonia,2005,5219,55405,50186
139,croatia,1990,425544,475438,49894
320,brunei darussalam,1995,35052,84748,49696
189,united states virgin islands,1990,2309,51970,49661
1641,curaao,2020,7611,57210,49599
530,botswana,2000,26683,74934,48251
1265,botswana,2015,55294,103053,47759
5,kenya,1990,250332,298089,47757
997,united republic of tanzania,2010,262172,309847,47675
75,brunei darussalam,1990,26323,73200,46877
1510,botswana,2020,63561,110268,46707
65,turkmenistan,1990,260005,306500,46495
497,malawi,2000,186229,232620,46391
1158,martinique,2010,14637,59575,44938
368,channel islands,1995,15626,60519,44893
713,new caledonia,2000,4941,49651,44710
872,andorra,2005,5727,50298,44571
757,cameroon,2005,221232,265503,44271
1117,andorra,2010,7909,52053,44144
123,channel islands,1990,18726,61660,42934
826,maldives,2005,2212,45045,42833
913,martinique,2005,14340,57034,42694
778,namibia,2005,65598,107347,41749
668,martinique,2000,14019,54492,40473
382,andorra,1995,4142,44206,40064
41,eswatini,1990,35179,74991,39812
499,mayotte,2000,6214,45474,39260
468,new caledonia,1995,4600,43662,39062
723,northern mariana islands,2000,2765,40122,37357
627,andorra,2000,5575,42147,36572
1111,latvia,2010,278168,313786,35618
137,andorra,1990,3740,38891,35151
968,northern mariana islands,2005,2725,37542,34817
1422,panama,2015,150210,184710,34500
1607,andorra,2020,11132,45574,34442
1110,isle of man,2010,9033,43447,34414
423,martinique,1995,12501,46599,34098
124,denmark,1990,201514,235189,33675
223,new caledonia,1990,4148,37673,33525
1362,andorra,2015,8740,42264,33524
25,democratic republic of the congo,1990,96370,129391,33021
865,isle of man,2005,8484,41475,32991
1352,finland,2015,282223,314856,32633
1634,aruba,2020,21456,53593,32137
1355,isle of man,2015,10580,42238,31658
620,isle of man,2000,7377,39002,31625
1396,curaao,2015,6239,37611,31372
1600,isle of man,2020,12032,43040,31008
224,papua new guinea,1990,3107,33710,30603
1218,french polynesia,2010,1550,31640,30090
310,turkmenistan,1995,243523,273565,30042
478,northern mariana islands,1995,2647,32376,29729
973,french polynesia,2005,2717,32286,29569
469,papua new guinea,1995,4059,33526,29467
502,rwanda,2000,318198,347076,28878
1463,french polynesia,2015,1978,30058,28080
1708,french polynesia,2020,2157,30081,27924
375,isle of man,1995,9003,36886,27883
178,martinique,1990,11036,38705,27669
1639,cayman islands,2020,1908,29242,27334
1656,sint maarten dutch part,2020,2191,28845,26654
1694,papua new guinea,2020,4810,31068,26258
1204,papua new guinea,2010,4231,30425,26194
728,french polynesia,2000,4300,30329,26029
1449,papua new guinea,2015,4980,30940,25960
581,maldives,2000,1216,27092,25876
959,papua new guinea,2005,4493,29971,25478
1411,sint maarten dutch part,2015,1929,27295,25366
1078,cyprus,2010,163471,188472,25001
483,french polynesia,1995,3738,28360,24622
1394,cayman islands,2015,1709,26193,24484
233,northern mariana islands,1990,2517,26593,24076
130,isle of man,1990,10735,34769,24034
1658,turks and caicos islands,2020,2689,25748,23059
899,aruba,2005,9482,32540,23058
1166,sint maarten dutch part,2010,3303,26203,22900
238,french polynesia,1990,3132,25830,22698
1149,cayman islands,2010,1404,24062,22658
1354,ireland,2015,736639,759256,22617
654,aruba,2000,7662,30104,22442
254,mayotte,1995,3937,26316,22379
1598,iceland,2020,43251,65424,22173
1626,liechtenstein,2020,3706,25877,22171
1706,american samoa,2020,1832,23608,21776
714,papua new guinea,2000,4552,26304,21752
726,american samoa,2000,3186,24912,21726
1426,chile,2015,618015,639724,21709
971,american samoa,2005,2588,24233,21645
1213,northern mariana islands,2010,2611,24168,21557
1461,american samoa,2015,1961,23513,21552
1482,rwanda,2020,492489,513907,21418
1216,american samoa,2010,2157,23555,21398
23,central african republic,1990,46354,67234,20880
1144,aruba,2010,13524,34328,20804
481,american samoa,1995,2638,23098,20460
1413,turks and caicos islands,2015,2454,22723,20269
1381,liechtenstein,2015,3536,23799,20263
1389,aruba,2015,16621,36114,19493
904,cayman islands,2005,1290,20679,19389
236,american samoa,1990,2041,21283,19242
1703,northern mariana islands,2020,2741,21843,19102
1458,northern mariana islands,2015,2607,21648,19041
1145,bahamas,2010,35990,54745,18755
1136,liechtenstein,2010,3590,22342,18752
1637,bonaire sint eustatius and saba,2020,8148,26221,18073
1177,panama,2010,139844,157788,17944
659,cayman islands,2000,1278,19176,17898
1392,bonaire sint eustatius and saba,2015,7295,24571,17276
1568,cyprus,2020,173210,190366,17156
285,botswana,1995,23315,40168,16853
336,maldives,1995,1687,18510,16823
1638,british virgin islands,2020,5355,22164,16809
648,monaco,2000,5124,21787,16663
1390,bahamas,2015,42965,59241,16276
403,monaco,1995,4784,21060,16276
104,lebanon,1990,507722,523693,15971
891,liechtenstein,2005,2935,18898,15963
158,monaco,1990,4475,20359,15884
409,aruba,1995,6705,22274,15569
1168,turks and caicos islands,2010,2197,17216,15019
412,bonaire sint eustatius and saba,1995,540,15101,14561
1393,british virgin islands,2015,5118,19535,14417
1246,angola,2015,618288,632178,13890
1147,bonaire sint eustatius and saba,2010,7065,20941,13876
657,bonaire sint eustatius and saba,2000,647,14387,13740
902,bonaire sint eustatius and saba,2005,753,14399,13646
9,mayotte,1990,1835,15229,13394
646,liechtenstein,2000,2688,15483,12795
1002,cameroon,2010,278898,291474,12576
167,bonaire sint eustatius and saba,1990,445,13010,12565
1148,british virgin islands,2010,4921,17076,12155
1614,malta,2020,102793,114760,11967
923,turks and caicos islands,2005,1190,13115,11925
414,cayman islands,1995,794,12666,11872
921,sint maarten dutch part,2005,1246,13099,11853
445,brazil,1995,730491,741557,11066
903,british virgin islands,2005,4008,15016,11008
1237,rwanda,2015,503667,514647,10980
900,bahamas,2005,34715,45531,10816
401,liechtenstein,1995,3018,13311,10293
1323,cyprus,2015,166585,176693,10108
57,nigeria,1990,446753,456621,9868
1635,bahamas,2020,53793,63583,9790
1660,belize,2020,52756,62043,9287
658,british virgin islands,2000,3683,12958,9275
169,cayman islands,1990,356,9315,8959
164,aruba,1990,5887,14444,8557
132,lithuania,1990,340973,349258,8285
678,turks and caicos islands,2000,740,9015,8275
156,liechtenstein,1990,3425,10906,7481
751,uganda,2005,586602,593308,6706
413,british virgin islands,1995,3368,10046,6678
91,maldives,1990,2192,8689,6497
1350,estonia,2015,189109,194664,5555
433,turks and caicos islands,1995,1533,7039,5506
168,british virgin islands,1990,3094,8035,4941
286,eswatini,1995,30340,35157,4817
1023,namibia,2010,99599,103826,4227
702,bermuda,2000,14079,17684,3605
1192,bermuda,2010,15313,18547,3234
1632,anguilla,2020,2505,5715,3210
947,bermuda,2005,14907,18108,3201
1618,san marino,2020,2407,5543,3136
1437,bermuda,2015,16225,19212,2987
1387,anguilla,2015,2553,5471,2918
1214,palau,2010,2619,5490,2871
1142,anguilla,2010,2273,5103,2830
188,turks and caicos islands,1990,2308,5062,2754
1108,iceland,2010,32454,35091,2637
1128,san marino,2010,2266,4880,2614
1704,palau,2020,2656,5088,2432
1459,palau,2015,2559,4937,2378
724,palau,2000,3998,6310,2312
969,palau,2005,3782,6043,2261
897,anguilla,2005,2425,4684,2259
893,monaco,2005,19103,21312,2209
655,bahamas,2000,34301,36454,2153
1353,iceland,2015,37006,39072,2066
410,bahamas,1995,29594,31654,2060
225,solomon islands,1990,2212,4226,2014
479,palau,1995,2844,4749,1905
148,san marino,1990,1413,3310,1897
165,bahamas,1990,25137,26855,1718
470,solomon islands,1995,2542,4178,1636
1558,bhutan,2020,51998,53612,1614
652,anguilla,2000,2508,4063,1555
1373,san marino,2015,3688,5195,1507
40,botswana,1990,26048,27510,1462
232,nauru,1990,1419,2815,1396
883,san marino,2005,2907,4218,1311
715,solomon islands,2000,2728,3981,1253
393,san marino,1995,2456,3659,1203
407,anguilla,1995,2166,3317,1151
477,nauru,1995,1511,2605,1094
1109,ireland,2010,729466,730542,1076
705,saint pierre and miquelon,2000,484,1458,974
460,saint pierre and miquelon,1995,477,1320,843
722,nauru,2000,1593,2394,801
142,holy see,1990,10,762,752
387,holy see,1995,26,778,752
632,holy see,2000,41,790,749
162,anguilla,1990,1832,2570,738
950,saint pierre and miquelon,2005,426,1147,721
877,holy see,2005,110,798,688
1612,holy see,2020,174,809,635
1195,saint pierre and miquelon,2010,390,1017,627
215,saint pierre and miquelon,1990,483,1099,616
1122,holy see,2010,175,783,608
204,falkland islands malvinas,1990,255,855,600
1440,saint pierre and miquelon,2015,400,986,586
1685,saint pierre and miquelon,2020,433,998,565
638,san marino,2000,3494,4045,551
1367,holy see,2015,310,790,480
1674,falkland islands malvinas,2020,1518,1957,439
967,nauru,2005,1869,2253,384
960,solomon islands,2005,2999,3271,272
1184,falkland islands malvinas,2010,1174,1436,262
1429,falkland islands malvinas,2015,1370,1571,201
1120,gibraltar,2010,10197,10369,172
449,falkland islands malvinas,1995,760,868,108
939,falkland islands malvinas,2005,1095,1166,71
1409,saint martin french part,2015,0,0,0
315,china taiwan province of china,1995,0,0,0
916,saint barthlemy,2005,0,0,0
1050,china taiwan province of china,2010,0,0,0
1540,china taiwan province of china,2020,0,0,0
1161,saint barthlemy,2010,0,0,0
919,saint martin french part,2005,0,0,0
1164,saint martin french part,2010,0,0,0
1654,saint martin french part,2020,0,0,0
1651,saint barthlemy,2020,0,0,0
426,saint barthlemy,1995,0,0,0
429,saint martin french part,1995,0,0,0
1295,china taiwan province of china,2015,0,0,0
560,china taiwan province of china,2000,0,0,0
1406,saint barthlemy,2015,0,0,0
184,saint martin french part,1990,0,0,0
671,saint barthlemy,2000,0,0,0
181,saint barthlemy,1990,0,0,0
805,china taiwan province of china,2005,0,0,0
674,saint martin french part,2000,0,0,0
70,china taiwan province of china,1990,0,0,0
531,eswatini,2000,34116,34084,-32
234,palau,1990,2957,2801,-156
694,falkland islands malvinas,2000,1262,1067,-195
214,greenland,1990,9504,9282,-222
1702,nauru,2020,2454,2201,-253
230,marshall islands,1990,1426,1158,-268
1313,bhutan,2015,51391,51106,-285
742,malawi,2005,222023,221661,-362
630,gibraltar,2000,8451,8054,-397
875,gibraltar,2005,9643,9211,-432
1457,nauru,2015,2267,1833,-434
1205,solomon islands,2010,3371,2760,-611
1209,kiribati,2010,3565,2868,-697
58,saint helena,1990,884,178,-706
186,sint maarten dutch part,1990,707,0,-707
1365,gibraltar,2015,11916,11065,-851
1711,tokelau,2020,2112,1238,-874
431,sint maarten dutch part,1995,914,0,-914
1466,tokelau,2015,2171,1185,-986
1221,tokelau,2010,2168,1128,-1040
976,tokelau,2005,2090,1003,-1087
676,sint maarten dutch part,2000,1186,0,-1186
1454,kiribati,2015,4127,2919,-1208
1212,nauru,2010,2130,906,-1224
1450,solomon islands,2015,3886,2585,-1301
486,tokelau,1995,1810,506,-1304
241,tokelau,1990,1684,360,-1324
731,tokelau,2000,2061,712,-1349
1682,bermuda,2020,21107,19739,-1368
964,kiribati,2005,4021,2487,-1534
719,kiribati,2000,3991,2283,-1708
385,gibraltar,1995,10130,8381,-1749
1695,solomon islands,2020,4270,2520,-1750
229,kiribati,1990,4053,2162,-1891
1699,kiribati,2020,5103,3126,-1977
474,kiribati,1995,4246,2223,-2023
243,tuvalu,1990,2350,318,-2032
303,saint helena,1995,2207,117,-2090
171,curaao,1990,2104,0,-2104
1610,gibraltar,2020,13389,11190,-2199
84,timorleste,1990,11261,8954,-2307
733,tuvalu,2000,2611,218,-2393
488,tuvalu,1995,2738,263,-2475
226,vanuatu,1990,4869,2308,-2561
475,marshall islands,1995,4154,1480,-2674
978,tuvalu,2005,2917,209,-2708
1223,tuvalu,2010,3011,220,-2791
416,curaao,1995,2849,0,-2849
1468,tuvalu,2015,3203,230,-2973
793,saint helena,2005,3268,163,-3105
471,vanuatu,1995,5611,2461,-3150
311,uzbekistan,1995,1515731,1512577,-3154
863,iceland,2005,28669,25492,-3177
126,faroe islands,1990,7518,4285,-3233
140,gibraltar,1990,11989,8709,-3280
1383,monaco,2015,29317,25983,-3334
1038,saint helena,2010,3607,248,-3359
1210,marshall islands,2010,6492,3089,-3403
1713,tuvalu,2020,3670,239,-3431
1451,vanuatu,2015,6751,3186,-3565
548,saint helena,2000,3715,108,-3607
716,vanuatu,2000,6242,2626,-3616
661,curaao,2000,3779,0,-3779
1283,saint helena,2015,4285,377,-3908
1696,vanuatu,2020,7246,3257,-3989
0,burundi,1990,337100,333110,-3990
231,micronesia fed states of,1990,7713,3685,-4028
965,marshall islands,2005,6654,2417,-4237
459,greenland,1995,11361,7121,-4240
1455,marshall islands,2015,7625,3284,-4341
1528,saint helena,2020,4885,437,-4448
961,vanuatu,2005,7264,2800,-4464
1709,niue,2020,5186,588,-4598
906,curaao,2005,4618,0,-4618
88,bhutan,1990,28461,23807,-4654
1206,vanuatu,2010,7692,2991,-4701
1219,niue,2010,5347,589,-4758
1464,niue,2015,5348,588,-4760
974,niue,2005,5291,522,-4769
244,wallis and futuna islands,1990,6484,1402,-5082
720,marshall islands,2000,6976,1891,-5085
484,niue,1995,5571,480,-5091
179,montserrat,1990,7178,2013,-5165
489,wallis and futuna islands,1995,6943,1704,-5239
979,wallis and futuna islands,2005,7436,2191,-5245
729,niue,2000,5749,498,-5251
71,dem peoples republic of korea,1990,39383,34103,-5280
555,turkmenistan,2000,224398,219067,-5331
1224,wallis and futuna islands,2010,7465,2111,-5354
734,wallis and futuna islands,2000,7401,2015,-5386
239,niue,1990,5858,461,-5397
795,sierra leone,2005,151886,146227,-5659
190,belize,1990,36101,30404,-5697
1138,monaco,2010,26954,21132,-5822
1628,monaco,2020,32552,26601,-5951
1596,faroe islands,2020,12927,6812,-6115
1037,nigeria,2010,996914,990494,-6420
704,greenland,2000,13388,6601,-6787
371,faroe islands,1995,10003,2900,-7103
1106,faroe islands,2010,12364,5096,-7268
1595,estonia,2020,206631,199277,-7354
1700,marshall islands,2020,10886,3298,-7588
861,faroe islands,2005,12484,4583,-7901
1351,faroe islands,2015,13407,5485,-7922
128,iceland,1990,17597,9584,-8013
949,greenland,2005,14618,6556,-8062
31,sao tome and principe,1990,13965,5582,-8383
1415,belize,2015,63099,54615,-8484
435,belize,1995,41950,33446,-8504
373,iceland,1995,21433,12738,-8695
476,micronesia fed states of,1995,12138,3342,-8796
616,faroe islands,2000,12410,3593,-8817
1469,wallis and futuna islands,2015,11227,2050,-9177
1194,greenland,2010,15391,6091,-9300
163,antigua and barbuda,1990,21382,12029,-9353
408,antigua and barbuda,1995,26965,17550,-9415
249,ethiopia,1995,816420,806904,-9516
739,ethiopia,2005,524038,514451,-9587
653,antigua and barbuda,2000,32782,23071,-9711
1714,wallis and futuna islands,2020,11917,2040,-9877
424,montserrat,1995,11586,1612,-9974
618,iceland,2000,26173,15892,-10281
925,belize,2005,51883,41438,-10445
1151,curaao,2010,45248,34630,-10618
1439,greenland,2015,16711,6009,-10702
1170,belize,2010,57371,46390,-10981
776,eswatini,2005,44861,33392,-11469
1491,angola,2020,668066,656434,-11632
898,antigua and barbuda,2005,36398,24741,-11657
680,belize,2000,48211,36488,-11723
1684,greenland,2020,17866,5899,-11967
503,seychelles,2000,19244,6574,-12670
1488,zambia,2020,200700,187955,-12745
221,melanesia,1990,104497,91200,-13297
721,micronesia fed states of,2000,16914,3116,-13798
1266,eswatini,2015,46236,32352,-13884
482,cook islands,1995,17009,2686,-14323
276,sao tome and principe,1995,19261,4936,-14325
748,seychelles,2005,23487,8997,-14490
993,seychelles,2010,25932,11420,-14512
914,montserrat,2005,15810,1244,-14566
1238,seychelles,2015,27483,12791,-14692
237,cook islands,1990,17485,2587,-14898
669,montserrat,2000,16132,1211,-14921
1143,antigua and barbuda,2010,41347,26412,-14935
182,saint kitts and nevis,1990,18618,3210,-15408
966,micronesia fed states of,2005,18346,2905,-15441
1159,montserrat,2010,17378,1291,-16087
1483,seychelles,2020,29258,13050,-16208
972,cook islands,2005,19580,3277,-16303
1707,cook islands,2020,21106,4579,-16527
1211,micronesia fed states of,2010,19404,2806,-16598
727,cook islands,2000,19478,2785,-16693
183,saint lucia,1990,21999,5305,-16694
1217,cook islands,2010,20556,3769,-16787
1511,eswatini,2020,50039,32858,-17181
1462,cook islands,2015,21555,4168,-17387
73,mongolia,1990,24466,6718,-17748
1456,micronesia fed states of,2015,20633,2756,-17877
316,dem peoples republic of korea,1995,53797,35143,-18654
1404,montserrat,2015,20136,1351,-18785
800,turkmenistan,2005,231939,213053,-18886
1374,serbia,2015,826891,807441,-19450
318,mongolia,1995,27694,7424,-20270
427,saint kitts and nevis,1995,24662,4248,-20414
521,sao tome and principe,2000,25145,4365,-20780
932,panama,2005,131417,109461,-21956
1701,micronesia fed states of,2020,24945,2832,-22113
563,mongolia,2000,30648,8206,-22442
258,seychelles,1995,27798,5148,-22650
55,mauritania,1990,134478,111650,-22828
1649,montserrat,2020,24582,1379,-23203
1064,timorleste,2010,35037,11540,-23497
428,saint lucia,1995,30672,7155,-23517
1388,antigua and barbuda,2015,52189,28082,-24107
672,saint kitts and nevis,2000,30867,5871,-24996
457,bermuda,1995,42587,16676,-25911
1,comoros,1990,40079,14079,-26000
766,sao tome and principe,2005,29859,3433,-26426
466,melanesia,1995,123300,96828,-26472
917,saint kitts and nevis,2005,33317,6682,-26635
1011,sao tome and principe,2010,30928,2700,-28228
1162,saint kitts and nevis,2010,35795,7245,-28550
1309,timorleste,2015,37325,8520,-28805
1035,mauritania,2010,114192,84920,-29272
673,saint lucia,2000,39556,9871,-29685
242,tonga,1990,32665,2911,-29754
808,mongolia,2005,42354,11477,-30877
301,niger,1995,177067,145999,-31068
833,cyprus,2005,153973,122849,-31124
1554,timorleste,2020,39588,8399,-31189
308,kyrgyzstan,1995,550022,518338,-31684
13,seychelles,1990,35633,3721,-31912
1407,saint kitts and nevis,2015,40211,7443,-32768
1256,sao tome and principe,2015,35162,2394,-32768
998,zambia,2010,182766,149962,-32804
185,saint vincent and the grenadines,1990,37010,3970,-33040
29,equatorial guinea,1990,36175,2740,-33435
56,niger,1990,149777,115464,-34313
487,tonga,1995,38208,3274,-34934
758,central african republic,2005,131410,96409,-35001
6,madagascar,1990,59415,23917,-35498
561,dem peoples republic of korea,2000,72350,36183,-36167
1021,eswatini,2010,69030,32637,-36393
1045,turkmenistan,2010,234635,197979,-36656
980,burundi,2010,284078,247321,-36757
918,saint lucia,2005,46897,9839,-37058
1633,antigua and barbuda,2020,66561,29386,-37175
246,comoros,1995,51290,13939,-37351
1501,sao tome and principe,2020,39608,2139,-37469
172,dominica,1990,40563,2519,-38044
174,grenada,1990,43237,4263,-38974
297,guineabissau,1995,67149,27961,-39188
52,guineabissau,1990,55406,15368,-40038
1369,malta,2015,93554,52642,-40912
417,dominica,1995,44210,3121,-41089
1163,saint lucia,2010,50318,9050,-41268
1053,mongolia,2010,57405,16062,-41343
430,saint vincent and the grenadines,1995,45669,4135,-41534
1290,turkmenistan,2015,238531,196376,-42155
1652,saint kitts and nevis,2020,50285,7725,-42560
732,tonga,2000,46444,3684,-42760
274,equatorial guinea,1995,46412,3629,-42783
987,malawi,2010,260531,217722,-42809
394,serbia,1995,914112,870980,-43132
307,kazakhstan,1995,3295157,3251968,-43189
1068,bhutan,2010,91934,48420,-43514
977,tonga,2005,48337,4301,-44036
116,hungary,1990,391583,347510,-44073
662,dominica,2000,48275,3723,-44552
790,mauritania,2005,103107,58211,-44896
1298,mongolia,2015,65485,19886,-45599
251,madagascar,1995,67324,21177,-46147
806,dem peoples republic of korea,2005,86763,40097,-46666
1222,tonga,2010,51521,4607,-46914
1040,sierra leone,2010,126730,79265,-47465
1535,turkmenistan,2020,242554,194920,-47634
419,grenada,1995,54075,5544,-48531
675,saint vincent and the grenadines,2000,53543,4307,-49236
1408,saint lucia,2015,57939,8673,-49266
545,mauritania,2000,107607,57366,-50241
1655,saint vincent and the grenadines,2020,55525,4738,-50787
1165,saint vincent and the grenadines,2010,55435,4569,-50866
920,saint vincent and the grenadines,2005,55611,4436,-51175
1526,niger,2020,399707,348056,-51651
1243,zambia,2015,184371,132107,-52264
1051,dem peoples republic of korea,2010,96459,44010,-52449
687,panama,2000,136929,83410,-53519
496,madagascar,2000,77089,23541,-53548
1644,grenada,2020,62204,7213,-54991
711,melanesia,2000,150371,95281,-55090
1467,tonga,2015,59203,3954,-55249
519,equatorial guinea,2000,59930,4517,-55413
1296,dem peoples republic of korea,2015,103898,48458,-55440
212,bermuda,1990,71681,15683,-55998
491,comoros,2000,70502,13799,-56703
1154,grenada,2010,63930,6980,-56950
664,grenada,2000,63791,6825,-56966
542,guineabissau,2000,77664,20450,-57214
1410,saint vincent and the grenadines,2015,62292,4637,-57655
909,grenada,2005,64646,6902,-57744
907,dominica,2005,64037,4744,-59293
166,barbados,1990,84766,24024,-60742
1543,mongolia,2020,82098,21345,-60753
1541,dem peoples republic of korea,2020,110377,49549,-60828
384,croatia,1995,735213,674085,-61128
302,nigeria,1995,524535,462999,-61536
787,guineabissau,2005,82846,20902,-61944
1615,montenegro,2020,132965,70999,-61966
1399,grenada,2015,69055,7057,-61998
442,panama,1995,132978,70848,-62130
300,mauritania,1995,151710,89562,-62148
1370,montenegro,2015,134028,71719,-62309
901,barbados,2005,92975,30624,-62351
1653,saint lucia,2020,71227,8338,-62889
1146,barbados,2010,96193,32825,-63368
411,barbados,1995,89612,26224,-63388
1107,finland,2010,291883,228481,-63402
1397,dominica,2015,72585,8093,-64492
1636,barbados,2020,99611,34869,-64742
764,equatorial guinea,2005,71789,6588,-65201
1152,dominica,2010,73583,8110,-65473
1124,malta,2010,99294,33008,-66286
656,barbados,2000,94998,28424,-66574
1391,barbados,2015,101879,34475,-67404
377,lithuania,1995,342389,273587,-68802
329,timorleste,1995,79050,9743,-69307
612,ukraine,2000,5596518,5527087,-69431
1642,dominica,2020,78191,8284,-69907
1032,guineabissau,2010,91546,21391,-70155
1125,montenegro,2010,148754,78512,-70242
1712,tonga,2020,74550,3742,-70808
304,senegal,1995,359061,287654,-71407
240,samoa,1990,74861,3357,-71504
197,panama,1990,134392,62744,-71648
956,melanesia,2005,177020,103881,-73139
588,cyprus,2000,153561,80076,-73485
1096,hungary,2010,511199,436616,-74583
879,malta,2005,100245,24560,-75685
1009,equatorial guinea,2010,84390,8658,-75732
1277,guineabissau,2015,98151,22333,-75818
222,fiji,1990,90161,13283,-76878
485,samoa,1995,81952,4694,-77258
145,montenegro,1990,77384,0,-77384
823,bhutan,2005,120319,40279,-80040
1285,sierra leone,2015,139296,58830,-80466
526,sudan,2000,885660,805086,-80574
118,republic of moldova,1990,625680,544162,-81518
361,hungary,1995,404141,322234,-81907
47,cabo verde,1990,91363,8931,-82432
736,comoros,2005,96143,13209,-82934
546,niger,2000,205236,122260,-82976
634,malta,2000,104869,21521,-83348
819,timorleste,2005,94961,11286,-83675
193,guatemala,1990,348189,264257,-83932
578,bhutan,2000,120183,32137,-88046
235,polynesia,1990,146560,58509,-88051
730,samoa,2000,94541,5998,-88543
333,bhutan,1995,117967,27972,-89995
121,slovakia,1990,132977,41295,-91682
389,malta,1995,109839,17740,-92099
975,samoa,2005,99230,5746,-93484
467,fiji,1995,106488,13001,-93487
1201,melanesia,2010,204278,110691,-93587
1278,liberia,2015,205741,112111,-93630
1522,guineabissau,2020,111790,17945,-93845
480,polynesia,1995,160607,65065,-95542
144,malta,1990,110738,15077,-95661
981,comoros,2010,109125,12618,-96507
543,liberia,2000,248412,151868,-96544
292,cabo verde,1995,106954,9979,-96975
439,honduras,1995,246575,149442,-97133
754,zimbabwe,2005,500773,402226,-98547
1530,sierra leone,2020,152486,53746,-98740
1220,samoa,2010,104820,5122,-99698
851,hungary,2005,466530,366787,-99743
59,senegal,1990,370243,270410,-99833
1232,malawi,2015,297471,197328,-100143
514,chad,2000,206052,104825,-101227
343,cyprus,1995,163275,61941,-101334
207,paraguay,1990,297742,195884,-101858
498,mauritius,2000,119003,15543,-103460
1356,latvia,2015,369238,265418,-103820
884,serbia,2005,960621,854848,-105773
253,mauritius,1995,114073,7493,-106580
8,mauritius,1990,110707,3613,-107094
1282,nigeria,2015,1306526,1199115,-107411
862,finland,2005,300562,192169,-108393
64,tajikistan,1990,537699,428900,-108799
61,togo,1990,193827,84844,-108983
1226,comoros,2015,121749,12555,-109194
1129,serbia,2010,936001,826275,-109726
1446,melanesia,2015,229769,119343,-110426
743,mauritius,2005,130649,19647,-111002
984,ethiopia,2010,680290,568748,-111542
1465,samoa,2015,116855,4255,-112600
537,cabo verde,2000,124823,11027,-113796
136,albania,1990,180204,66013,-114191
1101,slovakia,2010,260656,146319,-114337
532,lesotho,2000,120565,6167,-114398
725,polynesia,2000,185771,71151,-114620
970,polynesia,2005,190186,73768,-116418
518,democratic republic of the congo,2000,862039,744387,-117652
712,fiji,2000,131908,12719,-119189
1477,malawi,2020,311052,191362,-119690
1033,liberia,2010,219139,99165,-119974
1281,niger,2015,374993,252998,-121995
547,nigeria,2000,610130,487882,-122248
366,slovakia,1995,191610,69323,-122287
741,madagascar,2005,148805,26058,-122747
988,mauritius,2010,148186,24836,-123350
606,hungary,2000,420959,296957,-124002
1341,hungary,2015,600887,475508,-125379
1215,polynesia,2010,198595,72741,-125854
773,western sahara,2005,131288,3891,-127397
551,togo,2000,267164,137968,-129196
782,cabo verde,2005,141984,12700,-129284
287,lesotho,1995,136593,7204,-129389
1586,hungary,2020,714420,584567,-129853
98,cyprus,1990,174370,43805,-130565
1710,samoa,2020,135732,4021,-131711
986,madagascar,2010,160819,28905,-131914
1691,melanesia,2020,256021,124073,-131948
269,chad,1995,223096,89584,-133512
622,lithuania,2000,348564,214311,-134253
611,slovakia,2000,251533,116376,-135157
203,ecuador,1990,214008,78663,-135345
1233,mauritius,2015,165869,28585,-137284
574,timorleste,2000,148339,10602,-137737
1471,comoros,2020,150823,12496,-138327
1027,cabo verde,2010,152863,14373,-138490
135,united kingdom,1990,3789316,3650286,-139030
210,uruguay,1990,237486,98116,-139370
455,uruguay,1995,233993,93428,-140565
1601,latvia,2020,380010,239422,-140588
856,slovakia,2005,271828,130491,-141337
1231,madagascar,2015,175868,32075,-143793
957,fiji,2005,157045,12434,-144611
390,montenegro,1995,144640,0,-144640
1523,liberia,2020,233564,87947,-145617
386,greece,1995,1004201,857850,-146351
700,uruguay,2000,235641,88874,-146767
187,trinidad and tobago,1990,197440,50666,-146774
880,montenegro,2005,148013,0,-148013
452,paraguay,1995,335845,186570,-149275
199,bolivia plurinational state of,1990,224693,73758,-150935
1003,central african republic,2010,245933,94685,-151248
777,lesotho,2005,159071,6290,-152781
1460,polynesia,2015,223501,70001,-153500
639,serbia,2000,1131919,977873,-154046
1478,mauritius,2020,182973,28893,-154080
1272,cabo verde,2015,171429,14924,-156505
45,benin,1990,234314,76751,-157563
1476,madagascar,2020,193526,35563,-157963
3,eritrea,1990,170603,11848,-158755
209,suriname,1990,177857,18083,-159774
1041,togo,2010,417178,255564,-161614
1225,burundi,2015,459979,298299,-161680
549,senegal,2000,394608,231901,-162707
528,western sahara,2000,166060,3289,-162771
283,western sahara,1995,167146,2989,-164157
38,western sahara,1990,168238,2688,-165550
1018,western sahara,2010,170195,4493,-165702
337,nepal,1995,856028,690225,-165803
173,dominican republic,1990,458021,291151,-166870
454,suriname,1995,191535,22320,-169215
556,uzbekistan,2000,1575965,1406498,-169467
1346,slovakia,2015,347385,177624,-169761
290,benin,1995,275696,105703,-169993
1202,fiji,2010,183607,13357,-170250
786,guinea,2005,404677,233419,-171258
1517,cabo verde,2020,187558,15788,-171770
995,south sudan,2010,402616,230732,-171884
295,ghana,1995,428051,252879,-175172
553,kyrgyzstan,2000,566315,389824,-176491
791,niger,2005,304086,124509,-179577
617,finland,2000,315861,136203,-179658
1263,western sahara,2015,185885,5179,-180706
864,ireland,2005,769942,589046,-180896
1619,serbia,2020,1003962,823011,-180951
1267,lesotho,2015,191457,9152,-182305
42,lesotho,1990,191328,8240,-183088
635,montenegro,2000,183451,0,-183451
699,suriname,2000,211219,27506,-183713
127,finland,1990,250610,63255,-187355
1705,polynesia,2020,258262,70136,-188126
372,finland,1995,288655,99729,-188926
1508,western sahara,2020,194932,5424,-189508
1512,lesotho,2020,202164,12060,-190104
535,benin,2000,328046,134655,-193391
1447,fiji,2015,208568,13751,-194817
1181,chile,2010,571842,375388,-196454
697,paraguay,2000,374675,176608,-198067
444,bolivia plurinational state of,1995,283540,83598,-199942
334,india,1995,7153439,6952238,-201201
796,togo,2005,405803,204219,-201584
432,trinidad and tobago,1995,251142,45994,-205148
50,ghana,1990,371157,164851,-206306
1470,burundi,2020,551105,344767,-206338
309,tajikistan,1995,555426,348347,-207079
340,armenia,1995,901859,693999,-207860
306,togo,1995,309616,101583,-208033
1036,niger,2010,335897,126482,-209415
448,ecuador,1995,326230,115093,-211137
867,lithuania,2005,412371,201209,-211162
1434,suriname,2015,254612,43127,-211485
944,suriname,2005,248782,33662,-215120
1240,south sudan,2015,1060678,844112,-216566
945,uruguay,2005,298986,82317,-216669
1286,togo,2015,495380,277384,-217996
1189,suriname,2010,258715,39713,-219002
585,armenia,2000,877148,657900,-219248
1692,fiji,2020,233856,14087,-219769
1591,slovakia,2020,419651,197161,-222490
1679,suriname,2020,273209,47801,-225408
750,south sudan,2005,228537,0,-228537
206,guyana,1990,233318,4095,-229223
1025,benin,2010,541152,309225,-231927
794,senegal,2005,470508,238298,-232210
1022,lesotho,2010,243128,6414,-236714
996,uganda,2010,731768,492930,-238838
95,armenia,1990,899678,658789,-240889
554,tajikistan,2000,541183,299499,-241684
1364,croatia,2015,806242,561093,-245149
1119,croatia,2010,820407,573248,-247159
1657,trinidad and tobago,2020,330519,78849,-251670
689,bolivia plurinational state of,2000,344702,92658,-252044
363,republic of moldova,1995,620030,367231,-252799
780,benin,2005,504165,248320,-255845
690,brazil,2000,940458,684596,-255862
208,peru,1990,313209,56688,-256521
1680,uruguay,2020,367060,108267,-258793
582,nepal,2000,977396,717900,-259496
874,croatia,2005,839084,579273,-259811
1190,uruguay,2010,338438,76303,-262135
24,chad,1990,336798,74342,-262456
936,chile,2005,541745,276360,-265385
1531,togo,2020,545409,279936,-265473
677,trinidad and tobago,2000,307795,41753,-266042
788,liberia,2005,354792,87217,-267575
1270,benin,2015,634923,366284,-268639
1435,uruguay,2015,353225,78799,-274426
1235,mozambique,2015,596949,321794,-275155
1031,guinea,2010,455866,178762,-277104
922,trinidad and tobago,2005,322906,44812,-278094
738,eritrea,2005,299311,15905,-283406
245,burundi,1995,540558,254853,-285705
1515,benin,2020,681827,394276,-287551
451,guyana,1995,295292,6352,-288940
1039,senegal,2010,547495,256092,-291403
693,ecuador,2000,446380,151523,-294857
1678,peru,2020,1519635,1224519,-295116
1480,mozambique,2020,640160,338850,-301310
1167,trinidad and tobago,2010,350517,48226,-302291
540,ghana,2000,495887,191601,-304286
1044,tajikistan,2010,584647,279808,-304839
438,guatemala,1995,461891,156188,-305703
799,tajikistan,2005,586235,280466,-305769
27,democratic republic of the congo,1990,436513,129391,-307122
1289,tajikistan,2015,585060,275101,-309959
1534,tajikistan,2020,586851,276031,-310820
983,eritrea,2010,328366,15813,-312553
566,cambodia,2000,459621,146085,-313536
684,honduras,2000,342103,28461,-313642
1001,angola,2010,651383,336367,-315016
76,cambodia,1990,355428,38375,-317053
92,nepal,1990,748053,429974,-318079
1412,trinidad and tobago,2015,368633,50021,-318612
629,croatia,2000,907031,585298,-321733
321,cambodia,1995,418213,92230,-325983
1284,senegal,2015,594507,266496,-328011
881,north macedonia,2005,458822,127667,-331155
298,liberia,1995,542295,208563,-333732
691,chile,2000,511997,177332,-334665
112,yemen,1990,455492,118863,-336629
146,north macedonia,1990,432070,95142,-336928
1245,middle africa,2015,3816990,3479911,-337079
1287,kazakhstan,2015,3885576,3546060,-339516
396,spain,1995,1362409,1020067,-342342
505,south sudan,2000,342628,0,-342628
1673,ecuador,2020,1127891,784787,-343104
798,kyrgyzstan,2005,652852,309399,-343453
418,dominican republic,1995,667015,323381,-343634
357,yemen,1995,486249,136515,-349734
696,guyana,2000,362157,8610,-353547
608,republic of moldova,2000,602773,247828,-354945
785,ghana,2005,665731,309932,-355799
999,zimbabwe,2010,754643,398307,-356336
446,chile,1995,499207,142417,-356790
1112,lithuania,2010,517746,160772,-356974
305,sierra leone,1995,457827,98516,-359311
1527,nigeria,2020,1670455,1308568,-361887
248,eritrea,1995,375257,12400,-362857
1276,guinea,2015,493411,126657,-366754
272,democratic republic of the congo,1995,559824,191635,-368189
14,somalia,1990,848055,478294,-369761
1093,belarus,2010,1464702,1090378,-374324
942,paraguay,2005,545698,168243,-377455
1095,czechia,2010,779438,398493,-380945
941,guyana,2005,392555,10868,-381687
391,north macedonia,1995,491992,109343,-382649
602,yemen,2000,529396,144940,-384456
201,chile,1990,493026,107501,-385525
1338,belarus,2015,1469882,1082905,-386977
12,rwanda,1990,547717,160024,-387693
745,mozambique,2005,662951,268694,-394257
1126,north macedonia,2010,526151,129701,-396450
196,nicaragua,1990,441488,41421,-400067
801,uzbekistan,2005,1730224,1329932,-400292
1340,czechia,2015,819776,416454,-403322
141,greece,1990,1022125,618139,-403986
636,north macedonia,2000,532132,125665,-406467
1676,guyana,2020,438413,31169,-407244
441,nicaragua,1995,437711,26619,-411092
550,sierra leone,2000,509098,97974,-411124
1583,belarus,2020,1483626,1067090,-416536
1529,senegal,2020,693765,274929,-418836
1357,lithuania,2015,556292,136021,-420271
929,honduras,2005,448882,27934,-420948
53,liberia,1990,516878,94964,-421914
1030,ghana,2010,762002,337766,-424236
735,burundi,2005,619916,192774,-427142
37,tunisia,1990,465549,37984,-427565
1521,guinea,2020,550790,121437,-429353
850,czechia,2005,752058,322540,-429518
381,albania,1995,501066,71354,-429712
1186,guyana,2010,439233,8182,-431051
830,armenia,2005,900648,469189,-431459
1371,north macedonia,2015,563354,130730,-432624
934,bolivia plurinational state of,2005,543766,107745,-436021
260,south sudan,1995,438044,0,-438044
282,tunisia,1995,476933,37867,-439066
500,mozambique,2000,644421,195702,-448719
453,peru,1995,505474,56732,-448742
527,tunisia,2000,486964,36719,-450245
115,czechia,1990,564746,110394,-454352
360,czechia,1995,620286,165592,-454694
847,yemen,2005,628869,171871,-456998
78,lao peoples democratic republic,1990,483008,22866,-460142
20,middle africa,1990,1922243,1461155,-461088
1042,kazakhstan,2010,3797527,3334937,-462590
619,ireland,2000,820657,350552,-470105
686,nicaragua,2000,501517,30389,-471128
1532,kazakhstan,2020,4203899,3732073,-471826
1431,guyana,2015,481258,8661,-472597
848,belarus,2005,1581160,1106982,-474178
1544,republic of korea,2020,2204554,1728182,-476372
1275,ghana,2015,892253,414744,-477509
1585,czechia,2020,1026108,540921,-485187
54,mali,1990,647426,160736,-486690
990,mozambique,2010,797808,306471,-491337
1043,kyrgyzstan,2010,726544,232065,-494479
493,eritrea,2000,511506,12952,-498554
605,czechia,2000,723333,220789,-502544
176,haiti,1990,524711,19084,-505627
763,democratic republic of the congo,2005,1130872,623009,-507863
1609,croatia,2020,1039526,528056,-511470
1602,lithuania,2020,658057,145184,-512873
15,south sudan,1990,514943,0,-514943
857,ukraine,2005,5566382,5050302,-516080
113,belarus,1990,1767600,1248977,-518623
931,nicaragua,2005,555532,34919,-520613
323,lao peoples democratic republic,1995,547786,23526,-524260
1520,ghana,2020,1004324,476412,-527912
663,dominican republic,2000,889451,355611,-533840
4,ethiopia,1990,1689941,1155390,-534551
683,guatemala,2000,582796,48119,-534677
1288,kyrgyzstan,2015,742841,204382,-538459
772,tunisia,2005,579009,35040,-543969
853,republic of moldova,2005,715496,171122,-544374
117,poland,1990,1673426,1127771,-545655
358,belarus,1995,1736493,1186282,-550211
80,myanmar,1990,685308,133545,-551763
345,iraq,1995,752604,199460,-553144
935,brazil,2005,1194575,638582,-555993
517,democratic republic of the congo,2000,862039,305880,-556159
1490,middle africa,2020,4420662,3861568,-559094
100,iraq,1990,642933,83638,-559295
1174,honduras,2010,587503,27288,-560215
811,cambodia,2005,674436,114096,-560340
603,belarus,2000,1685646,1123586,-562060
1616,north macedonia,2020,693896,131311,-562585
177,jamaica,1990,588450,20475,-567975
1000,middle africa,2010,3007543,2436802,-570741
1017,tunisia,2010,615732,43172,-572560
1176,nicaragua,2010,610211,37345,-572866
1533,kyrgyzstan,2020,774377,199011,-575366
544,mali,2000,772866,189475,-583391
1092,yemen,2010,876383,288394,-587989
114,bulgaria,1990,612960,21510,-591450
828,pakistan,2005,3777830,3174558,-603272
1248,central african republic,2015,686224,81568,-604656
1187,paraguay,2010,765811,160299,-605512
1228,eritrea,2015,624757,15941,-608816
827,nepal,2005,1289629,680729,-608900
1102,ukraine,2010,5429876,4818767,-611109
797,kazakhstan,2005,3717649,3103027,-614622
99,georgia,1990,919438,304470,-614968
1421,nicaragua,2015,655577,40261,-615316
1016,sudan,2010,1235193,618709,-616484
359,bulgaria,1995,649430,32435,-616995
151,spain,1990,1439004,821605,-617399
590,iraq,2000,828414,210525,-617889
568,lao peoples democratic republic,2000,649287,21948,-627339
698,peru,2000,694144,66300,-627844
490,burundi,2000,758673,125628,-633045
374,ireland,1995,863541,226892,-636649
789,mali,2005,895360,258630,-636730
908,dominican republic,2005,1014070,375417,-638653
421,haiti,1995,661354,18129,-643225
149,serbia,1990,742547,99269,-643278
299,mali,1995,820564,176187,-644377
255,mozambique,1995,812685,168256,-644429
604,bulgaria,2000,688682,43360,-645322
32,algeria,1990,921665,273954,-647711
266,angola,1995,688581,39813,-648768
1034,mali,2010,994832,341078,-653754
756,angola,2005,716766,62331,-654435
1179,bolivia plurinational state of,2010,779961,122846,-657115
510,middle africa,2000,2439360,1775284,-664076
1046,uzbekistan,2010,1888942,1220149,-668793
46,burkina faso,1990,1021331,349652,-671679
1666,nicaragua,2020,718154,42167,-675987
119,romania,1990,811853,135825,-676028
928,guatemala,2005,736715,57214,-679501
552,kazakhstan,2000,3554484,2874194,-680290
1424,bolivia plurinational state of,2015,824008,143008,-681000
1432,paraguay,2015,845591,156462,-689129
129,ireland,1990,917101,227961,-689140
1419,honduras,2015,729855,38330,-691525
422,jamaica,1995,718362,22713,-695649
1098,republic of moldova,2010,827409,129488,-697921
1075,armenia,2010,917043,211147,-705896
1008,democratic republic of the congo,2010,1298544,589882,-708662
1337,yemen,2015,1095240,379882,-715358
277,algeria,1995,979641,262032,-717609
1262,tunisia,2015,774376,56532,-717844
1506,sudan,2020,2104887,1379147,-725740
1677,paraguay,2020,896484,169567,-726917
1493,central african republic,2020,816668,88546,-728122
771,sudan,2005,1277632,546419,-731213
1079,georgia,2010,805539,73078,-732461
1428,ecuador,2015,1130774,387513,-743261
626,albania,2000,824442,76695,-747747
291,burkina faso,1995,1215665,464104,-751561
1324,georgia,2015,828931,76685,-752246
1320,armenia,2015,944520,191199,-753321
781,burkina faso,2005,1352292,597658,-754634
536,burkina faso,2000,1279414,520363,-759051
1026,burkina faso,2010,1434528,674438,-760090
1253,democratic republic of the congo,2015,1572222,810018,-762204
1669,bolivia plurinational state of,2020,927244,164121,-763123
755,middle africa,2005,2726556,1961951,-764605
1244,zimbabwe,2015,1167064,400482,-766582
1565,armenia,2020,958190,190349,-767841
1183,ecuador,2010,1152897,375253,-777644
1299,republic of korea,2015,2152532,1370905,-781627
1569,georgia,2020,861077,79368,-781709
666,haiti,2000,802218,17222,-784996
522,algeria,2000,1037985,250110,-787875
1473,eritrea,2020,802822,13934,-788888
1153,dominican republic,2010,1184417,395479,-788938
21,angola,1990,824886,33517,-791369
1425,brazil,2015,1504231,710304,-793927
938,ecuador,2005,986599,189893,-796706
325,myanmar,1995,911445,113663,-797782
170,cuba,1990,835175,34555,-800620
344,georgia,1995,953280,152235,-801045
1291,uzbekistan,2015,1976024,1170873,-805151
138,bosnia and herzegovina,1990,861760,56000,-805760
1279,mali,2015,1228544,420504,-808040
362,poland,1995,1775774,964725,-811049
762,democratic republic of the congo,2005,1130872,318724,-812148
1271,burkina faso,2015,1518568,704676,-813892
834,georgia,2005,885523,71296,-814227
1670,brazil,2020,1897128,1079708,-817420
1524,mali,2020,1303511,485829,-817682
1343,republic of moldova,2015,929759,106374,-823385
1489,zimbabwe,2020,1243314,416141,-827173
667,jamaica,2000,857865,24952,-832913
364,romania,1995,976732,135037,-841695
94,sri lanka,1990,883684,41561,-842123
1507,tunisia,2020,902268,60145,-842123
849,bulgaria,2005,907821,61074,-846747
1073,pakistan,2010,4790584,3943681,-846903
1173,guatemala,2010,924898,66386,-858512
1536,uzbekistan,2020,2027823,1162007,-865816
1321,azerbaijan,2015,1130348,264359,-865989
511,angola,2000,913206,46108,-867098
1056,cambodia,2010,953059,82028,-871031
1007,democratic republic of the congo,2010,1298544,425173,-873371
1516,burkina faso,2020,1599347,723989,-875358
813,lao peoples democratic republic,2005,897002,20371,-876631
180,puerto rico,1990,1200245,321909,-878336
1498,democratic republic of the congo,2020,1832069,952871,-879198
912,jamaica,2005,905170,24284,-880886
1347,ukraine,2015,5797550,4915142,-882408
339,sri lanka,1995,923530,40841,-882689
1076,azerbaijan,2010,1160863,276901,-883962
589,georgia,2000,967022,76117,-890905
943,peru,2005,969002,77877,-891125
437,el salvador,1995,933103,39537,-893566
871,albania,2005,966032,64739,-901293
1180,brazil,2010,1495404,592640,-902764
202,colombia,1990,1009148,104277,-904871
1398,dominican republic,2015,1454602,549289,-905313
415,cuba,1995,934168,26187,-907981
1566,azerbaijan,2020,1163922,252228,-911694
1582,yemen,2020,1301166,387113,-914053
682,el salvador,2000,949042,31713,-917329
584,sri lanka,2000,979093,40132,-938961
633,italy,2000,3067498,2121688,-945810
1664,honduras,2020,985077,39195,-945882
259,somalia,1995,968956,19527,-949429
911,haiti,2005,967894,16360,-951534
1157,jamaica,2010,989790,23677,-966113
882,portugal,2005,1743009,771184,-971825
504,somalia,2000,1006128,20097,-986031
1301,cambodia,2015,1074572,73962,-1000610
609,romania,2000,1138825,134254,-1004571
1643,dominican republic,2020,1608567,603794,-1004773
1402,jamaica,2015,1031596,23165,-1008431
1546,cambodia,2020,1104819,79341,-1025478
660,cuba,2000,1047789,18545,-1029244
1094,bulgaria,2010,1106483,76287,-1030196
749,somalia,2005,1060953,20768,-1040185
1418,guatemala,2015,1118115,74852,-1043263
1588,republic of moldova,2020,1159443,104438,-1055005
1339,bulgaria,2015,1179625,123803,-1055822
1116,albania,2010,1117940,52784,-1065156
425,puerto rico,1995,1405619,338067,-1067552
1617,portugal,2020,2081419,1001963,-1079456
927,el salvador,2005,1118793,36029,-1082764
1361,albania,2015,1142844,52031,-1090813
1647,jamaica,2020,1118931,23629,-1095302
1156,haiti,2010,1123190,17182,-1106008
1372,portugal,2015,1971655,864814,-1106841
447,colombia,1995,1215967,106943,-1109024
829,sri lanka,2005,1151553,39526,-1112027
1672,colombia,2020,3024273,1905393,-1118880
570,myanmar,2000,1224310,98011,-1126299
120,russian federation,1990,12653331,11524948,-1128383
1072,nepal,2010,1712697,581889,-1130808
1592,ukraine,2020,6139144,4997387,-1141757
33,egypt,1990,1321915,173833,-1148082
905,cuba,2005,1160309,11693,-1148616
831,azerbaijan,2005,1455180,301834,-1153346
77,indonesia,1990,1622259,465612,-1156647
1127,portugal,2010,1927397,762825,-1164572
1058,lao peoples democratic republic,2010,1198862,32955,-1165907
1252,democratic republic of the congo,2015,1572222,390142,-1182080
1188,peru,2010,1299095,104706,-1194389
192,el salvador,1990,1241849,47360,-1194489
1606,albania,2020,1250451,48810,-1201641
835,iraq,2005,1340599,134863,-1205736
1261,sudan,2015,1842602,620523,-1222079
607,poland,2000,2047626,825251,-1222375
1303,lao peoples democratic republic,2015,1288179,45538,-1242641
670,puerto rico,2000,1600058,355038,-1245020
1548,lao peoples democratic republic,2020,1296051,48731,-1247320
845,turkey,2005,2577305,1324108,-1253197
1433,peru,2015,1410199,154774,-1255425
96,azerbaijan,1990,1634157,360600,-1273557
1663,guatemala,2020,1368431,84311,-1284120
915,puerto rico,2005,1640015,352144,-1287871
1172,el salvador,2010,1337085,40342,-1296743
586,azerbaijan,2000,1630589,327540,-1303049
383,bosnia and herzegovina,1995,1372526,69476,-1303050
1150,cuba,2010,1314739,7373,-1307366
1325,iraq,2015,1675613,359352,-1316261
692,colombia,2000,1433940,109609,-1324331
278,egypt,1995,1492004,166955,-1325049
1054,republic of korea,2010,2252321,919987,-1332334
1090,turkey,2010,2708930,1373749,-1335181
637,portugal,2000,1993793,651472,-1342321
110,turkey,1990,2512944,1163686,-1349258
341,azerbaijan,1995,1712214,344070,-1368144
392,portugal,1995,1920865,532822,-1388043
767,algeria,2005,1599647,197728,-1401919
628,bosnia and herzegovina,2000,1496691,82952,-1413739
1074,sri lanka,2010,1454292,38959,-1415333
1160,puerto rico,2010,1731818,304969,-1426849
388,italy,1995,3207728,1774954,-1432774
1405,puerto rico,2015,1715817,280494,-1435323
147,portugal,1990,1871869,435782,-1436087
1012,algeria,2010,1655264,217268,-1437996
1497,democratic republic of the congo,2020,1832069,387606,-1444463
1401,haiti,2015,1467042,18047,-1448995
873,bosnia and herzegovina,2005,1501036,47287,-1453749
74,republic of korea,1990,1513162,43247,-1469915
1417,el salvador,2015,1512895,42059,-1470836
85,viet nam,1990,1505588,28118,-1477470
809,republic of korea,2005,1974513,486065,-1488448
1584,bulgaria,2020,1683074,184363,-1498711
1395,cuba,2015,1505827,4649,-1501178
579,india,2000,7928051,6411331,-1516720
768,egypt,2005,1807941,285006,-1522935
523,egypt,2000,1708296,184774,-1523522
108,state of palestine,1990,1812673,288332,-1524341
1118,bosnia and herzegovina,2010,1572925,38945,-1533980
994,somalia,2010,1595328,48106,-1547222
1363,bosnia and herzegovina,2015,1593430,38597,-1554833
355,turkey,1995,2771731,1216173,-1555558
1662,el salvador,2020,1599058,42767,-1556291
322,indonesia,1995,1937233,378960,-1558273
600,turkey,2000,2847334,1280963,-1566371
319,republic of korea,1995,1694236,123886,-1570350
1257,algeria,2015,1836502,239473,-1597029
1650,puerto rico,2020,1850529,247132,-1603397
1319,sri lanka,2015,1656253,39706,-1616547
564,republic of korea,2000,1875408,244224,-1631184
1608,bosnia and herzegovina,2020,1687639,36042,-1651597
815,myanmar,2005,1736590,83025,-1653565
35,morocco,1990,1748116,54895,-1693221
1485,south sudan,2020,2575870,882252,-1693618
1570,iraq,2020,2077976,365766,-1712210
1646,haiti,2020,1769671,18884,-1750787
1640,cuba,2020,1757300,3024,-1754276
1317,nepal,2015,2270166,509471,-1760695
1502,algeria,2020,2022337,250378,-1771959
937,colombia,2005,1883904,106523,-1777381
330,viet nam,1995,1842320,51262,-1791058
280,morocco,1995,1883924,50360,-1833564
257,rwanda,1995,2060363,215735,-1844628
81,philippines,1990,2012499,154071,-1858428
1564,sri lanka,2020,1960025,40254,-1919771
143,italy,1990,3350982,1428219,-1922763
854,romania,2005,2105906,145162,-1960744
1239,somalia,2015,2008490,40990,-1967500
1484,somalia,2020,2034221,58590,-1975631
353,state of palestine,1995,2274589,281767,-1992822
525,morocco,2000,2077010,53034,-2023976
10,mozambique,1990,2222354,122332,-2100022
575,viet nam,2000,2158532,56754,-2101778
1562,nepal,2020,2599701,487564,-2112137
567,indonesia,2000,2415077,292307,-2122770
852,poland,2005,2884657,722509,-2162148
326,philippines,1995,2481963,207345,-2274618
1013,egypt,2010,2586643,310017,-2276626
1318,pakistan,2015,5798210,3506520,-2291690
820,viet nam,2005,2376225,51768,-2324457
770,morocco,2005,2470656,56222,-2414434
1060,myanmar,2010,2492274,76414,-2415860
1182,colombia,2010,2554020,130309,-2423711
1080,iraq,2010,2554929,120466,-2434463
812,indonesia,2005,2781287,289310,-2491977
598,state of palestine,2000,2767331,275202,-2492129
1427,colombia,2015,2698688,159407,-2539281
1065,viet nam,2010,2630742,61756,-2568986
571,philippines,2000,3062665,318095,-2744570
1305,myanmar,2015,2842494,73309,-2769185
1015,morocco,2010,2860702,71189,-2789513
1258,egypt,2015,3151069,353641,-2797428
1310,viet nam,2015,2909491,72793,-2836698
1260,morocco,2015,2971770,92424,-2879346
843,state of palestine,2005,3258102,274520,-2983582
1563,pakistan,2020,6328400,3276580,-3051820
1503,egypt,2020,3610461,543937,-3066524
1097,poland,2010,3716338,642417,-3073921
1057,indonesia,2010,3415963,307487,-3108476
161,caribbean,1990,4139775,1031083,-3108692
1344,romania,2015,3420714,281048,-3139666
1505,morocco,2020,3262222,102358,-3159864
1099,romania,2010,3363361,177211,-3186150
1088,state of palestine,2010,3539908,273840,-3266068
1589,romania,2020,3987093,705310,-3281783
1555,viet nam,2020,3392025,76767,-3315258
816,philippines,2005,3684528,257468,-3427060
1342,poland,2015,4077038,611855,-3465183
1333,state of palestine,2015,3773988,273163,-3500825
1550,myanmar,2020,3711751,76446,-3635305
824,india,2005,9588533,5936740,-3651793
195,mexico,1990,4395355,695674,-3699681
1302,indonesia,2015,4065095,338124,-3726971
1578,state of palestine,2020,4022791,272784,-3750007
67,china,1990,4231625,376361,-3855264
406,caribbean,1995,5035853,1121563,-3914290
1587,poland,2020,4825096,817254,-4007842
821,afghanistan,2005,4116739,87314,-4029425
1681,venezuela bolivarian republic of,2020,5415337,1324193,-4091144
1547,indonesia,2020,4601369,355505,-4245864
331,afghanistan,1995,4347049,71522,-4275527
822,bangladesh,2005,5492474,1062270,-4430204
577,bangladesh,2000,5441094,987853,-4453241
1061,philippines,2010,4692695,208599,-4484096
332,bangladesh,1995,5423528,934735,-4488793
87,bangladesh,1990,5450443,881617,-4568826
312,china,1995,5030321,442198,-4588123
576,afghanistan,2000,4750677,75917,-4674760
651,caribbean,2000,5966487,1216872,-4749615
1067,bangladesh,2010,6319871,1345546,-4974325
1311,afghanistan,2015,5400916,339432,-5061484
1066,afghanistan,2010,5269518,102276,-5167242
896,caribbean,2005,6506671,1275731,-5230940
1557,bangladesh,2020,7401763,2115408,-5286355
1306,philippines,2015,5498232,211862,-5286370
557,china,2000,5884919,508034,-5376885
1312,bangladesh,2015,6831282,1422179,-5409103
1334,syrian arab republic,2015,6447843,835716,-5612127
1556,afghanistan,2020,5853838,144098,-5709740
1551,philippines,2020,6094307,225525,-5868782
1141,caribbean,2010,7273502,1338893,-5934609
440,mexico,1995,6949276,458549,-6490727
1386,caribbean,2015,8135307,1501081,-6634226
802,china,2005,7337211,678947,-6658264
1631,caribbean,2020,9078772,1605148,-7473624
1579,syrian arab republic,2020,8457214,868711,-7588503
86,afghanistan,1990,7679582,57686,-7621896
1069,india,2010,13221963,5574018,-7647945
1047,china,2010,8714648,849861,-7864787
685,mexico,2000,9562878,538051,-9024827
1292,china,2015,10240817,978046,-9262771
1537,china,2020,10461170,1039675,-9421495
1665,mexico,2020,11185737,1197624,-9988113
930,mexico,2005,10817810,712648,-10105162
1314,india,2015,15885657,5210847,-10674810
1420,mexico,2015,11923234,1013691,-10909543
1175,mexico,2010,12415222,969710,-11445512
1559,india,2020,17869492,4878704,-12990788
